FamilyID	wild_yak	takin	water_buffalo	mean	std	cv	max	min	range
fam1	50	12	2	21.333333333333332	25.32455988429677	1.1870887445764113	50	2	48
fam2	21	23	16	20.0	3.605551275463989	0.18027756377319945	23	16	7
fam3	4	19	36	19.666666666666668	16.010413278030438	0.8140888107473103	36	4	32
fam4	2	25	31	19.333333333333332	15.30795000427338	0.7917905174624162	31	2	29
fam5	16	25	16	19.0	5.196152422706632	0.27348170645824377	25	16	9
fam6	13	24	16	17.666666666666668	5.686240703077327	0.3218626813062638	24	13	11
fam7	3	25	24	17.333333333333332	12.423096769056148	0.7167171212917008	25	3	22
fam8	13	21	17	17.0	4.0	0.23529411764705882	21	13	8
fam9	2	25	25	17.333333333333332	13.279056191361391	0.7660993956554649	25	2	23
fam10	7	25	17	16.333333333333332	9.018499505645789	0.5521530309579055	25	7	18
fam11	2	25	22	16.333333333333332	12.503332889007368	0.7655101768780022	25	2	23
fam12	16	16	16	16.0	0.0	0.0	16	16	0
fam13	14	20	13	15.666666666666666	3.7859388972001824	0.24165567428937335	20	13	7
fam14	7	17	22	15.333333333333334	7.637626158259733	0.4981060537995478	22	7	15
fam15	12	18	15	15.0	3.0	0.2	18	12	6
fam16	18	25	2	15.0	11.789826122551595	0.7859884081701064	25	2	23
fam17	2	24	17	14.333333333333334	11.239810200058244	0.7841728046552263	24	2	22
fam18	7	19	15	13.666666666666666	6.110100926607787	0.44708055560544785	19	7	12
fam19	4	17	19	13.333333333333334	8.144527815247079	0.6108395861435308	19	4	15
fam20	9	16	15	13.333333333333334	3.7859388972001824	0.28394541729001366	16	9	7
fam21	2	28	10	13.333333333333334	13.316656236958785	0.9987492177719088	28	2	26
fam22	7	22	11	13.333333333333334	7.767453465154029	0.5825590098865522	22	7	15
fam23	12	20	7	13.0	6.557438524302	0.5044183480232308	20	7	13
fam24	2	25	13	13.333333333333334	11.50362261782493	0.8627716963368698	25	2	23
fam25	8	17	13	12.666666666666666	4.509249752822894	0.35599340153864956	17	8	9
fam26	12	15	10	12.333333333333334	2.5166114784235836	0.2040495793316419	15	10	5
fam27	5	19	13	12.333333333333334	7.023769168568493	0.5694947974514994	19	5	14
fam28	2	17	18	12.333333333333334	8.962886439832502	0.7267205221485812	18	2	16
fam29	10	14	13	12.333333333333334	2.0816659994661326	0.16878372968644317	14	10	4
fam30	2	23	12	12.333333333333334	10.503967504392486	0.851673040896688	23	2	21
fam31	2	21	15	12.666666666666666	9.71253485622231	0.7667790675964983	21	2	19
fam32	7	7	23	12.333333333333334	9.237604307034013	0.7489949438135686	23	7	16
fam33	2	18	17	12.333333333333334	8.962886439832502	0.7267205221485812	18	2	16
fam34	13	12	11	12.0	1.0	0.08333333333333333	13	11	2
fam35	5	25	6	12.0	11.269427669584644	0.939118972465387	25	5	20
fam36	2	16	17	11.666666666666666	8.386497083606082	0.7188426071662357	17	2	15
fam37	2	16	18	12.0	8.717797887081348	0.726483157256779	18	2	16
fam38	6	17	12	11.666666666666666	5.507570547286102	0.4720774754816659	17	6	11
fam39	2	10	23	11.666666666666666	10.598742063723098	0.9084636054619798	23	2	21
fam40	10	11	13	11.333333333333334	1.5275252316519468	0.13478163808693647	13	10	3
fam41	2	17	16	11.666666666666666	8.386497083606082	0.7188426071662357	17	2	15
fam42	2	21	12	11.666666666666666	9.504384952922168	0.8146615673933287	21	2	19
fam43	11	11	12	11.333333333333334	0.5773502691896257	0.05094267081084933	12	11	1
fam44	2	17	15	11.333333333333334	8.144527815247077	0.7186348072276832	17	2	15
fam45	2	19	11	10.666666666666666	8.504900548115382	0.7973344263858171	19	2	17
fam46	9	11	12	10.666666666666666	1.5275252316519468	0.14320549046737002	12	9	3
fam47	2	13	18	11.0	8.18535277187245	0.7441229792611318	18	2	16
fam48	5	14	13	10.666666666666666	4.932882862316248	0.46245776834214825	14	5	9
fam49	2	15	14	10.333333333333334	7.234178138070235	0.7000817552971195	15	2	13
fam50	9	15	7	10.333333333333334	4.163331998932265	0.4029030966708644	15	7	8
fam51	9	12	10	10.333333333333334	1.5275252316519468	0.14782502241793033	12	9	3
fam52	7	14	10	10.333333333333334	3.511884584284246	0.33985979847912057	14	7	7
fam53	8	14	9	10.333333333333334	3.214550253664318	0.3110855084191275	14	8	6
fam54	2	15	15	10.666666666666666	7.505553499465135	0.7036456405748565	15	2	13
fam55	7	16	8	10.333333333333334	4.932882862316248	0.47737576086931427	16	7	9
fam56	4	17	10	10.333333333333334	6.506407098647712	0.6296522998691333	17	4	13
fam57	11	10	9	10.0	1.0	0.1	11	9	2
fam58	7	12	11	10.0	2.6457513110645907	0.2645751311064591	12	7	5
fam59	5	12	13	10.0	4.358898943540674	0.4358898943540674	13	5	8
fam60	17	5	8	10.0	6.244997998398398	0.6244997998398398	17	5	12
fam61	2	19	10	10.333333333333334	8.504900548115382	0.8230548917531014	19	2	17
fam62	9	20	2	10.333333333333334	9.073771725877467	0.8781069412139484	20	2	18
fam63	2	13	16	10.333333333333334	7.3711147958319945	0.7133336899192252	16	2	14
fam64	4	14	12	10.0	5.291502622129181	0.5291502622129182	14	4	10
fam65	5	9	16	10.0	5.5677643628300215	0.5567764362830021	16	5	11
fam66	2	17	12	10.333333333333334	7.637626158259733	0.7391251120896516	17	2	15
fam67	7	11	11	9.666666666666666	2.3094010767585034	0.23890355966467278	11	7	4
fam68	6	10	13	9.666666666666666	3.511884584284246	0.3632984052707841	13	6	7
fam69	2	15	13	10.0	7.0	0.7	15	2	13
fam70	2	19	9	10.0	8.54400374531753	0.854400374531753	19	2	17
fam71	3	16	10	9.666666666666666	6.506407098647712	0.6730765964118323	16	3	13
fam72	7	10	12	9.666666666666666	2.5166114784235836	0.2603391184576121	12	7	5
fam73	9	10	9	9.333333333333334	0.5773502691896257	0.06185895741317418	10	9	1
fam74	7	11	10	9.333333333333334	2.0816659994661326	0.22303564279994276	11	7	4
fam75	6	14	8	9.333333333333334	4.163331998932265	0.4460712855998855	14	6	8
fam76	2	20	7	9.666666666666666	9.291573243177568	0.961197232052852	20	2	18
fam77	7	20	2	9.666666666666666	9.29157324317757	0.9611972320528521	20	2	18
fam78	8	19	2	9.666666666666666	8.621678104251709	0.8918977349225906	19	2	17
fam79	2	15	12	9.666666666666666	6.8068592855540455	0.7041578571262807	15	2	13
fam80	4	10	14	9.333333333333334	5.033222956847166	0.5392738882336249	14	4	10
fam81	6	13	9	9.333333333333334	3.511884584284246	0.3762733483161692	13	6	7
fam82	10	5	12	9.0	3.605551275463989	0.40061680838488767	12	5	7
fam83	5	13	9	9.0	4.0	0.4444444444444444	13	5	8
fam84	2	13	13	9.333333333333334	6.3508529610858835	0.680448531544916	13	2	11
fam85	9	10	8	9.0	1.0	0.1111111111111111	10	8	2
fam86	2	17	9	9.333333333333334	7.505553499465135	0.8041664463712644	17	2	15
fam87	2	17	9	9.333333333333334	7.505553499465135	0.8041664463712644	17	2	15
fam88	3	11	13	9.0	5.291502622129181	0.5879447357921312	13	3	10
fam89	2	3	23	9.333333333333334	11.846237095944574	1.2692396888512043	23	2	21
fam90	9	10	8	9.0	1.0	0.1111111111111111	10	8	2
fam91	24	2	2	9.333333333333334	12.701705922171765	1.3608970630898318	24	2	22
fam92	5	11	10	8.666666666666666	3.214550253664318	0.3709096446535752	11	5	6
fam93	11	9	6	8.666666666666666	2.5166114784235836	0.2903782475104135	11	6	5
fam94	3	12	11	8.666666666666666	4.932882862316248	0.569178791805721	12	3	9
fam95	4	10	12	8.666666666666666	4.163331998932265	0.4803844614152614	12	4	8
fam96	3	13	10	8.666666666666666	5.131601439446884	0.5921078583977174	13	3	10
fam97	2	12	13	9.0	6.082762530298219	0.6758625033664688	13	2	11
fam98	2	14	11	9.0	6.244997998398398	0.693888666488711	14	2	12
fam99	2	14	11	9.0	6.244997998398398	0.693888666488711	14	2	12
fam100	2	11	14	9.0	6.244997998398398	0.693888666488711	14	2	12
fam101	2	10	15	9.0	6.557438524302	0.7286042804780001	15	2	13
fam102	2	16	9	9.0	7.0	0.7777777777777778	16	2	14
fam103	7	18	2	9.0	8.18535277187245	0.9094836413191612	18	2	16
fam104	3	12	11	8.666666666666666	4.932882862316248	0.569178791805721	12	3	9
fam105	3	14	9	8.666666666666666	5.507570547286102	0.6354889093022426	14	3	11
fam106	3	15	8	8.666666666666666	6.027713773341708	0.6955054353855817	15	3	12
fam107	5	16	5	8.666666666666666	6.3508529610858835	0.7327907262791404	16	5	11
fam108	6	11	9	8.666666666666666	2.516611478423583	0.29037824751041347	11	6	5
fam109	9	9	7	8.333333333333334	1.1547005383792517	0.13856406460551018	9	7	2
fam110	9	8	8	8.333333333333334	0.5773502691896257	0.06928203230275508	9	8	1
fam111	3	11	11	8.333333333333334	4.618802153517006	0.5542562584220406	11	3	8
fam112	4	11	10	8.333333333333334	3.7859388972001824	0.45431266766402184	11	4	7
fam113	9	6	10	8.333333333333334	2.081665999466133	0.24979991993593595	10	6	4
fam114	3	10	12	8.333333333333334	4.725815626252608	0.567097875150313	12	3	9
fam115	3	16	6	8.333333333333334	6.8068592855540455	0.8168231142664854	16	3	13
fam116	2	9	15	8.666666666666666	6.506407098647712	0.7507392806131975	15	2	13
fam117	2	7	17	8.666666666666666	7.637626158259733	0.881264556722277	17	2	15
fam118	2	17	6	8.333333333333334	7.767453465154029	0.9320944158184834	17	2	15
fam119	2	17	7	8.666666666666666	7.637626158259733	0.881264556722277	17	2	15
fam120	2	17	7	8.666666666666666	7.637626158259733	0.881264556722277	17	2	15
fam121	2	14	10	8.666666666666666	6.110100926607787	0.7050116453778217	14	2	12
fam122	6	9	10	8.333333333333334	2.081665999466133	0.24979991993593595	10	6	4
fam123	2	13	11	8.666666666666666	5.859465277082315	0.6760921473556517	13	2	11
fam124	5	11	9	8.333333333333334	3.055050463303893	0.36660605559646714	11	5	6
fam125	7	11	7	8.333333333333334	2.3094010767585034	0.27712812921102037	11	7	4
fam126	8	10	7	8.333333333333334	1.5275252316519468	0.1833030277982336	10	7	3
fam127	2	10	14	8.666666666666666	6.110100926607786	0.7050116453778216	14	2	12
fam128	2	15	9	8.666666666666666	6.506407098647712	0.7507392806131975	15	2	13
fam129	8	9	7	8.0	1.0	0.125	9	7	2
fam130	5	9	10	8.0	2.6457513110645907	0.33071891388307384	10	5	5
fam131	7	8	9	8.0	1.0	0.125	9	7	2
fam132	3	8	13	8.0	5.0	0.625	13	3	10
fam133	2	10	13	8.333333333333334	5.686240703077327	0.6823488843692792	13	2	11
fam134	13	5	6	8.0	4.358898943540674	0.5448623679425842	13	5	8
fam135	4	14	6	8.0	5.291502622129181	0.6614378277661477	14	4	10
fam136	2	6	17	8.333333333333334	7.767453465154029	0.9320944158184834	17	2	15
fam137	5	13	6	8.0	4.358898943540674	0.5448623679425842	13	5	8
fam138	3	18	3	8.0	8.660254037844387	1.0825317547305484	18	3	15
fam139	3	17	4	8.0	7.810249675906654	0.9762812094883317	17	3	14
fam140	4	8	12	8.0	4.0	0.5	12	4	8
fam141	2	13	10	8.333333333333334	5.686240703077327	0.6823488843692792	13	2	11
fam142	2	11	12	8.333333333333334	5.507570547286102	0.6609084656743321	12	2	10
fam143	2	11	12	8.333333333333334	5.507570547286102	0.6609084656743321	12	2	10
fam144	7	8	8	7.666666666666667	0.5773502691896258	0.07530655685082076	8	7	1
fam145	9	5	9	7.666666666666667	2.309401076758503	0.301226227403283	9	5	4
fam146	2	11	11	8.0	5.196152422706632	0.649519052838329	11	2	9
fam147	2	11	11	8.0	5.196152422706632	0.649519052838329	11	2	9
fam148	10	12	2	8.0	5.291502622129181	0.6614378277661477	12	2	10
fam149	2	12	10	8.0	5.291502622129181	0.6614378277661477	12	2	10
fam150	2	13	8	7.666666666666667	5.507570547286102	0.7183787670373176	13	2	11
fam151	2	10	12	8.0	5.291502622129181	0.6614378277661477	12	2	10
fam152	2	14	8	8.0	6.0	0.75	14	2	12
fam153	4	15	4	7.666666666666667	6.350852961085883	0.8283721253590282	15	4	11
fam154	3	9	11	7.666666666666667	4.163331998932266	0.5430433042085564	11	3	8
fam155	2	15	7	8.0	6.557438524302	0.81967981553775	15	2	13
fam156	6	10	7	7.666666666666667	2.0816659994661326	0.27152165210427814	10	6	4
fam157	5	2	17	8.0	7.937253933193772	0.9921567416492215	17	2	15
fam158	2	11	11	8.0	5.196152422706632	0.649519052838329	11	2	9
fam159	5	9	9	7.666666666666667	2.309401076758503	0.301226227403283	9	5	4
fam160	16	5	2	7.666666666666667	7.371114795831994	0.9614497559780861	16	2	14
fam161	2	20	2	8.0	10.392304845413264	1.299038105676658	20	2	18
fam162	2	11	11	8.0	5.196152422706632	0.649519052838329	11	2	9
fam163	6	8	8	7.333333333333333	1.1547005383792517	0.15745916432444343	8	6	2
fam164	7	7	8	7.333333333333333	0.5773502691896258	0.07872958216222171	8	7	1
fam165	7	9	6	7.333333333333333	1.5275252316519465	0.20829889522526546	9	6	3
fam166	3	10	9	7.333333333333333	3.7859388972001824	0.5162643950727521	10	3	7
fam167	4	10	8	7.333333333333333	3.0550504633038935	0.41659779045053097	10	4	6
fam168	10	7	5	7.333333333333333	2.516611478423583	0.3431742925123068	10	5	5
fam169	2	11	10	7.666666666666667	4.932882862316247	0.64341950378038	11	2	9
fam170	2	11	10	7.666666666666667	4.932882862316247	0.64341950378038	11	2	9
fam171	2	12	9	7.666666666666667	5.131601439446884	0.6693393181887239	12	2	10
fam172	2	12	9	7.666666666666667	5.131601439446884	0.6693393181887239	12	2	10
fam173	3	7	12	7.333333333333333	4.509249752822894	0.6148976935667584	12	3	9
fam174	2	7	13	7.333333333333333	5.507570547286102	0.7510323473571958	13	2	11
fam175	2	13	8	7.666666666666667	5.507570547286102	0.7183787670373176	13	2	11
fam176	2	14	7	7.666666666666667	6.027713773341708	0.7862235356532663	14	2	12
fam177	4	4	14	7.333333333333333	5.773502691896258	0.787295821622217	14	4	10
fam178	2	5	16	7.666666666666667	7.371114795831994	0.9614497559780861	16	2	14
fam179	2	6	14	7.333333333333333	6.110100926607787	0.8331955809010619	14	2	12
fam180	7	10	5	7.333333333333333	2.516611478423583	0.3431742925123068	10	5	5
fam181	2	10	10	7.333333333333333	4.618802153517007	0.6298366572977737	10	2	8
fam182	2	10	11	7.666666666666667	4.932882862316247	0.64341950378038	11	2	9
fam183	4	11	7	7.333333333333333	3.5118845842842465	0.4788933524023973	11	4	7
fam184	6	9	6	7.0	1.7320508075688772	0.24743582965269675	9	6	3
fam185	2	10	9	7.0	4.358898943540674	0.6226998490772392	10	2	8
fam186	3	10	8	7.0	3.605551275463989	0.5150787536377127	10	3	7
fam187	4	7	10	7.0	3.0	0.42857142857142855	10	4	6
fam188	10	4	7	7.0	3.0	0.42857142857142855	10	4	6
fam189	6	5	10	7.0	2.6457513110645907	0.37796447300922725	10	5	5
fam190	10	8	3	7.0	3.605551275463989	0.5150787536377127	10	3	7
fam191	2	11	9	7.333333333333333	4.725815626252608	0.6444294035799011	11	2	9
fam192	2	8	11	7.0	4.58257569495584	0.6546536707079771	11	2	9
fam193	2	11	9	7.333333333333333	4.725815626252608	0.6444294035799011	11	2	9
fam194	2	9	11	7.333333333333333	4.725815626252609	0.6444294035799012	11	2	9
fam195	2	7	12	7.0	5.0	0.7142857142857143	12	2	10
fam196	5	8	8	7.0	1.7320508075688772	0.24743582965269675	8	5	3
fam197	2	13	7	7.333333333333333	5.507570547286102	0.7510323473571958	13	2	11
fam198	3	13	5	7.0	5.291502622129181	0.7559289460184545	13	3	10
fam199	2	5	15	7.333333333333333	6.8068592855540455	0.9282080843937335	15	2	13
fam200	3	15	3	7.0	6.928203230275509	0.989743318610787	15	3	12
fam201	2	14	5	7.0	6.244997998398398	0.8921425711997711	14	2	12
fam202	6	10	5	7.0	2.6457513110645907	0.37796447300922725	10	5	5
fam203	2	10	10	7.333333333333333	4.618802153517007	0.6298366572977737	10	2	8
fam204	2	14	5	7.0	6.244997998398398	0.8921425711997711	14	2	12
fam205	5	8	8	7.0	1.7320508075688772	0.24743582965269675	8	5	3
fam206	6	14	2	7.333333333333333	6.110100926607787	0.8331955809010619	14	2	12
fam207	8	6	7	7.0	1.0	0.14285714285714285	8	6	2
fam208	3	10	8	7.0	3.605551275463989	0.5150787536377127	10	3	7
fam209	2	12	8	7.333333333333333	5.033222956847167	0.6863485850246137	12	2	10
fam210	4	10	7	7.0	3.0	0.42857142857142855	10	4	6
fam211	2	12	8	7.333333333333333	5.033222956847167	0.6863485850246137	12	2	10
fam212	7	6	7	6.666666666666667	0.5773502691896258	0.08660254037844388	7	6	1
fam213	6	6	8	6.666666666666667	1.1547005383792517	0.17320508075688776	8	6	2
fam214	5	7	8	6.666666666666667	1.5275252316519465	0.22912878474779197	8	5	3
fam215	6	8	6	6.666666666666667	1.1547005383792517	0.17320508075688776	8	6	2
fam216	3	8	9	6.666666666666667	3.214550253664318	0.48218253804964767	9	3	6
fam217	2	9	9	6.666666666666667	4.041451884327381	0.6062177826491071	9	2	7
fam218	5	9	6	6.666666666666667	2.0816659994661326	0.31224989991991986	9	5	4
fam219	9	7	4	6.666666666666667	2.516611478423583	0.37749172176353746	9	4	5
fam220	3	8	9	6.666666666666667	3.214550253664318	0.48218253804964767	9	3	6
fam221	2	10	9	7.0	4.358898943540674	0.6226998490772392	10	2	8
fam222	2	10	9	7.0	4.358898943540674	0.6226998490772392	10	2	8
fam223	2	8	10	6.666666666666667	4.163331998932266	0.6244997998398399	10	2	8
fam224	2	8	10	6.666666666666667	4.163331998932266	0.6244997998398399	10	2	8
fam225	2	10	9	7.0	4.358898943540674	0.6226998490772392	10	2	8
fam226	2	9	10	7.0	4.358898943540674	0.6226998490772392	10	2	8
fam227	2	8	11	7.0	4.58257569495584	0.6546536707079771	11	2	9
fam228	2	11	8	7.0	4.58257569495584	0.6546536707079771	11	2	9
fam229	3	11	6	6.666666666666667	4.041451884327381	0.6062177826491071	11	3	8
fam230	4	11	5	6.666666666666667	3.7859388972001824	0.5678908345800273	11	4	7
fam231	2	8	11	7.0	4.58257569495584	0.6546536707079771	11	2	9
fam232	2	12	7	7.0	5.0	0.7142857142857143	12	2	10
fam233	2	7	12	7.0	5.0	0.7142857142857143	12	2	10
fam234	4	4	12	6.666666666666667	4.618802153517007	0.692820323027551	12	4	8
fam235	2	12	7	7.0	5.0	0.7142857142857143	12	2	10
fam236	2	9	9	6.666666666666667	4.041451884327381	0.6062177826491071	9	2	7
fam237	2	8	11	7.0	4.58257569495584	0.6546536707079771	11	2	9
fam238	2	14	5	7.0	6.244997998398398	0.8921425711997711	14	2	12
fam239	2	14	4	6.666666666666667	6.429100507328637	0.9643650760992954	14	2	12
fam240	2	10	9	7.0	4.358898943540674	0.6226998490772392	10	2	8
fam241	2	15	3	6.666666666666667	7.234178138070234	1.085126720710535	15	2	13
fam242	2	14	5	7.0	6.244997998398398	0.8921425711997711	14	2	12
fam243	5	11	4	6.666666666666667	3.7859388972001824	0.5678908345800273	11	4	7
fam244	2	13	6	7.0	5.5677643628300215	0.7953949089757174	13	2	11
fam245	5	8	7	6.666666666666667	1.5275252316519465	0.22912878474779197	8	5	3
fam246	2	9	9	6.666666666666667	4.041451884327381	0.6062177826491071	9	2	7
fam247	4	8	8	6.666666666666667	2.309401076758503	0.3464101615137754	8	4	4
fam248	2	12	7	7.0	5.0	0.7142857142857143	12	2	10
fam249	6	7	7	6.666666666666667	0.5773502691896258	0.08660254037844388	7	6	1
fam250	2	12	7	7.0	5.0	0.7142857142857143	12	2	10
fam251	2	12	7	7.0	5.0	0.7142857142857143	12	2	10
fam252	4	8	8	6.666666666666667	2.309401076758503	0.3464101615137754	8	4	4
fam253	7	5	8	6.666666666666667	1.5275252316519465	0.22912878474779197	8	5	3
fam254	2	10	9	7.0	4.358898943540674	0.6226998490772392	10	2	8
fam255	4	8	8	6.666666666666667	2.309401076758503	0.3464101615137754	8	4	4
fam256	2	11	7	6.666666666666667	4.509249752822894	0.6763874629234341	11	2	9
fam257	7	5	7	6.333333333333333	1.1547005383792517	0.18232113763882923	7	5	2
fam258	6	6	7	6.333333333333333	0.5773502691896258	0.09116056881941462	7	6	1
fam259	5	7	7	6.333333333333333	1.1547005383792517	0.18232113763882923	7	5	2
fam260	4	8	7	6.333333333333333	2.0816659994661326	0.32868410517886304	8	4	4
fam261	5	8	6	6.333333333333333	1.5275252316519465	0.24118819447136	8	5	3
fam262	8	6	5	6.333333333333333	1.5275252316519465	0.24118819447136	8	5	3
fam263	5	8	6	6.333333333333333	1.5275252316519465	0.24118819447136	8	5	3
fam264	2	9	9	6.666666666666667	4.041451884327381	0.6062177826491071	9	2	7
fam265	2	9	9	6.666666666666667	4.041451884327381	0.6062177826491071	9	2	7
fam266	3	7	9	6.333333333333333	3.055050463303893	0.48237638894272	9	3	6
fam267	3	7	9	6.333333333333333	3.055050463303893	0.48237638894272	9	3	6
fam268	2	8	9	6.333333333333333	3.7859388972001824	0.597779825873713	9	2	7
fam269	2	9	9	6.666666666666667	4.041451884327381	0.6062177826491071	9	2	7
fam270	2	9	9	6.666666666666667	4.041451884327381	0.6062177826491071	9	2	7
fam271	5	8	6	6.333333333333333	1.5275252316519465	0.24118819447136	8	5	3
fam272	5	6	8	6.333333333333333	1.5275252316519465	0.24118819447136	8	5	3
fam273	3	6	10	6.333333333333333	3.511884584284246	0.5545080922554073	10	3	7
fam274	2	10	8	6.666666666666667	4.163331998932266	0.6244997998398399	10	2	8
fam275	4	10	5	6.333333333333333	3.2145502536643185	0.5075605663680504	10	4	6
fam276	2	10	8	6.666666666666667	4.163331998932266	0.6244997998398399	10	2	8
fam277	2	7	10	6.333333333333333	4.041451884327381	0.6381239817359022	10	2	8
fam278	2	10	8	6.666666666666667	4.163331998932266	0.6244997998398399	10	2	8
fam279	2	6	11	6.333333333333333	4.509249752822894	0.7119868030772991	11	2	9
fam280	2	7	11	6.666666666666667	4.509249752822894	0.6763874629234341	11	2	9
fam281	2	6	11	6.333333333333333	4.509249752822894	0.7119868030772991	11	2	9
fam282	2	11	7	6.666666666666667	4.509249752822894	0.6763874629234341	11	2	9
fam283	2	12	6	6.666666666666667	5.033222956847167	0.754983443527075	12	2	10
fam284	12	3	4	6.333333333333333	4.932882862316247	0.7788762414183549	12	3	9
fam285	2	7	11	6.666666666666667	4.509249752822894	0.6763874629234341	11	2	9
fam286	8	6	5	6.333333333333333	1.5275252316519465	0.24118819447136	8	5	3
fam287	2	13	5	6.666666666666667	5.686240703077327	0.8529361054615989	13	2	11
fam288	2	13	5	6.666666666666667	5.686240703077327	0.8529361054615989	13	2	11
fam289	2	12	6	6.666666666666667	5.033222956847167	0.754983443527075	12	2	10
fam290	5	7	7	6.333333333333333	1.1547005383792517	0.18232113763882923	7	5	2
fam291	4	11	4	6.333333333333333	4.041451884327381	0.6381239817359022	11	4	7
fam292	2	15	3	6.666666666666667	7.234178138070234	1.085126720710535	15	2	13
fam293	2	14	4	6.666666666666667	6.429100507328637	0.9643650760992954	14	2	12
fam294	2	9	9	6.666666666666667	4.041451884327381	0.6062177826491071	9	2	7
fam295	2	13	5	6.666666666666667	5.686240703077327	0.8529361054615989	13	2	11
fam296	2	10	8	6.666666666666667	4.163331998932266	0.6244997998398399	10	2	8
fam297	3	9	7	6.333333333333333	3.0550504633038935	0.48237638894272006	9	3	6
fam298	3	8	8	6.333333333333333	2.8867513459481287	0.45580284409707295	8	3	5
fam299	2	17	2	7.0	8.660254037844387	1.237179148263484	17	2	15
fam300	2	10	7	6.333333333333333	4.041451884327381	0.6381239817359022	10	2	8
fam301	2	17	2	7.0	8.660254037844387	1.237179148263484	17	2	15
fam302	6	6	6	6.0	0.0	0.0	6	6	0
fam303	5	7	6	6.0	1.0	0.16666666666666666	7	5	2
fam304	4	7	7	6.0	1.7320508075688772	0.28867513459481287	7	4	3
fam305	5	6	7	6.0	1.0	0.16666666666666666	7	5	2
fam306	6	7	5	6.0	1.0	0.16666666666666666	7	5	2
fam307	7	5	6	6.0	1.0	0.16666666666666666	7	5	2
fam308	7	7	4	6.0	1.7320508075688772	0.28867513459481287	7	4	3
fam309	2	8	8	6.0	3.4641016151377544	0.5773502691896257	8	2	6
fam310	2	8	8	6.0	3.4641016151377544	0.5773502691896257	8	2	6
fam311	3	8	7	6.0	2.6457513110645907	0.44095855184409843	8	3	5
fam312	3	7	8	6.0	2.6457513110645907	0.44095855184409843	8	3	5
fam313	4	9	5	6.0	2.6457513110645907	0.44095855184409843	9	4	5
fam314	3	9	6	6.0	3.0	0.5	9	3	6
fam315	2	9	8	6.333333333333333	3.7859388972001824	0.597779825873713	9	2	7
fam316	4	9	5	6.0	2.6457513110645907	0.44095855184409843	9	4	5
fam317	2	8	9	6.333333333333333	3.7859388972001824	0.597779825873713	9	2	7
fam318	2	9	8	6.333333333333333	3.7859388972001824	0.597779825873713	9	2	7
fam319	3	6	9	6.0	3.0	0.5	9	3	6
fam320	3	6	9	6.0	3.0	0.5	9	3	6
fam321	3	9	6	6.0	3.0	0.5	9	3	6
fam322	2	8	9	6.333333333333333	3.7859388972001824	0.597779825873713	9	2	7
fam323	3	8	7	6.0	2.6457513110645907	0.44095855184409843	8	3	5
fam324	2	10	7	6.333333333333333	4.041451884327381	0.6381239817359022	10	2	8
fam325	2	7	10	6.333333333333333	4.041451884327381	0.6381239817359022	10	2	8
fam326	2	10	7	6.333333333333333	4.041451884327381	0.6381239817359022	10	2	8
fam327	2	10	7	6.333333333333333	4.041451884327381	0.6381239817359022	10	2	8
fam328	2	10	7	6.333333333333333	4.041451884327381	0.6381239817359022	10	2	8
fam329	2	10	7	6.333333333333333	4.041451884327381	0.6381239817359022	10	2	8
fam330	2	9	7	6.0	3.605551275463989	0.6009252125773316	9	2	7
fam331	4	7	7	6.0	1.7320508075688772	0.28867513459481287	7	4	3
fam332	2	11	6	6.333333333333333	4.509249752822894	0.7119868030772991	11	2	9
fam333	2	6	11	6.333333333333333	4.509249752822894	0.7119868030772991	11	2	9
fam334	3	11	4	6.0	4.358898943540674	0.726483157256779	11	3	8
fam335	7	5	6	6.0	1.0	0.16666666666666666	7	5	2
fam336	5	12	2	6.333333333333333	5.131601439446884	0.8102528588600344	12	2	10
fam337	3	3	12	6.0	5.196152422706632	0.8660254037844387	12	3	9
fam338	2	12	5	6.333333333333333	5.131601439446884	0.8102528588600344	12	2	10
fam339	2	12	5	6.333333333333333	5.131601439446884	0.8102528588600344	12	2	10
fam340	2	9	7	6.0	3.605551275463989	0.6009252125773316	9	2	7
fam341	2	10	7	6.333333333333333	4.041451884327381	0.6381239817359022	10	2	8
fam342	2	12	5	6.333333333333333	5.131601439446884	0.8102528588600344	12	2	10
fam343	2	13	4	6.333333333333333	5.8594652770823155	0.9251787279603656	13	2	11
fam344	2	10	7	6.333333333333333	4.041451884327381	0.6381239817359022	10	2	8
fam345	5	9	4	6.0	2.6457513110645907	0.44095855184409843	9	4	5
fam346	2	14	2	6.0	6.928203230275509	1.1547005383792515	14	2	12
fam347	4	8	6	6.0	2.0	0.3333333333333333	8	4	4
fam348	4	11	3	6.0	4.358898943540674	0.726483157256779	11	3	8
fam349	2	11	5	6.0	4.58257569495584	0.7637626158259733	11	2	9
fam350	3	7	8	6.0	2.6457513110645907	0.44095855184409843	8	3	5
fam351	2	15	2	6.333333333333333	7.505553499465135	1.1850873946523899	15	2	13
fam352	2	5	12	6.333333333333333	5.131601439446884	0.8102528588600344	12	2	10
fam353	5	9	4	6.0	2.6457513110645907	0.44095855184409843	9	4	5
fam354	2	7	10	6.333333333333333	4.041451884327381	0.6381239817359022	10	2	8
fam355	2	16	2	6.666666666666667	8.082903768654761	1.2124355652982142	16	2	14
fam356	2	16	2	6.666666666666667	8.082903768654761	1.2124355652982142	16	2	14
fam357	2	8	8	6.0	3.4641016151377544	0.5773502691896257	8	2	6
fam358	2	16	2	6.666666666666667	8.082903768654761	1.2124355652982142	16	2	14
fam359	2	16	2	6.666666666666667	8.082903768654761	1.2124355652982142	16	2	14
fam360	2	16	2	6.666666666666667	8.082903768654761	1.2124355652982142	16	2	14
fam361	2	8	9	6.333333333333333	3.7859388972001824	0.597779825873713	9	2	7
fam362	6	11	2	6.333333333333333	4.509249752822894	0.7119868030772991	11	2	9
fam363	6	6	5	5.666666666666667	0.5773502691896258	0.10188534162169867	6	5	1
fam364	5	6	6	5.666666666666667	0.5773502691896258	0.10188534162169867	6	5	1
fam365	6	6	5	5.666666666666667	0.5773502691896258	0.10188534162169867	6	5	1
fam366	6	6	5	5.666666666666667	0.5773502691896258	0.10188534162169867	6	5	1
fam367	7	7	3	5.666666666666667	2.309401076758503	0.4075413664867946	7	3	4
fam368	4	7	6	5.666666666666667	1.5275252316519465	0.2695632761738729	7	4	3
fam369	3	7	7	5.666666666666667	2.309401076758503	0.4075413664867946	7	3	4
fam370	6	4	7	5.666666666666667	1.5275252316519465	0.2695632761738729	7	4	3
fam371	7	7	3	5.666666666666667	2.309401076758503	0.4075413664867946	7	3	4
fam372	3	7	7	5.666666666666667	2.309401076758503	0.4075413664867946	7	3	4
fam373	4	6	7	5.666666666666667	1.5275252316519465	0.2695632761738729	7	4	3
fam374	7	6	4	5.666666666666667	1.5275252316519465	0.2695632761738729	7	4	3
fam375	4	8	5	5.666666666666667	2.0816659994661326	0.36735282343519987	8	4	4
fam376	2	7	8	5.666666666666667	3.214550253664318	0.5672735741760561	8	2	6
fam377	2	8	8	6.0	3.4641016151377544	0.5773502691896257	8	2	6
fam378	8	5	4	5.666666666666667	2.0816659994661326	0.36735282343519987	8	4	4
fam379	5	8	4	5.666666666666667	2.0816659994661326	0.36735282343519987	8	4	4
fam380	5	4	8	5.666666666666667	2.0816659994661326	0.36735282343519987	8	4	4
fam381	8	6	3	5.666666666666667	2.516611478423583	0.44410790795710287	8	3	5
fam382	3	8	6	5.666666666666667	2.516611478423583	0.44410790795710287	8	3	5
fam383	3	8	6	5.666666666666667	2.516611478423583	0.44410790795710287	8	3	5
fam384	3	5	9	5.666666666666667	3.055050463303893	0.5391265523477458	9	3	6
fam385	2	9	7	6.0	3.605551275463989	0.6009252125773316	9	2	7
fam386	2	9	7	6.0	3.605551275463989	0.6009252125773316	9	2	7
fam387	2	7	9	6.0	3.605551275463989	0.6009252125773316	9	2	7
fam388	2	7	9	6.0	3.605551275463989	0.6009252125773316	9	2	7
fam389	8	5	4	5.666666666666667	2.0816659994661326	0.36735282343519987	8	4	4
fam390	2	9	6	5.666666666666667	3.5118845842842465	0.6197443384031023	9	2	7
fam391	6	9	2	5.666666666666667	3.511884584284246	0.6197443384031022	9	2	7
fam392	4	7	6	5.666666666666667	1.5275252316519465	0.2695632761738729	7	4	3
fam393	2	10	6	6.0	4.0	0.6666666666666666	10	2	8
fam394	2	6	10	6.0	4.0	0.6666666666666666	10	2	8
fam395	2	10	6	6.0	4.0	0.6666666666666666	10	2	8
fam396	2	10	6	6.0	4.0	0.6666666666666666	10	2	8
fam397	10	4	3	5.666666666666667	3.7859388972001824	0.6681068642117969	10	3	7
fam398	2	7	9	6.0	3.605551275463989	0.6009252125773316	9	2	7
fam399	2	10	6	6.0	4.0	0.6666666666666666	10	2	8
fam400	2	10	6	6.0	4.0	0.6666666666666666	10	2	8
fam401	4	8	5	5.666666666666667	2.0816659994661326	0.36735282343519987	8	4	4
fam402	2	7	9	6.0	3.605551275463989	0.6009252125773316	9	2	7
fam403	5	7	5	5.666666666666667	1.1547005383792517	0.20377068324339734	7	5	2
fam404	2	8	8	6.0	3.4641016151377544	0.5773502691896257	8	2	6
fam405	2	8	8	6.0	3.4641016151377544	0.5773502691896257	8	2	6
fam406	6	6	5	5.666666666666667	0.5773502691896258	0.10188534162169867	6	5	1
fam407	2	6	9	5.666666666666667	3.511884584284246	0.6197443384031022	9	2	7
fam408	2	9	6	5.666666666666667	3.5118845842842465	0.6197443384031023	9	2	7
fam409	2	9	7	6.0	3.605551275463989	0.6009252125773316	9	2	7
fam410	6	7	4	5.666666666666667	1.5275252316519465	0.2695632761738729	7	4	3
fam411	2	12	4	6.0	5.291502622129181	0.8819171036881969	12	2	10
fam412	2	12	3	5.666666666666667	5.507570547286102	0.9719242142269592	12	2	10
fam413	12	2	3	5.666666666666667	5.507570547286102	0.9719242142269592	12	2	10
fam414	5	10	2	5.666666666666667	4.041451884327381	0.7131973913518906	10	2	8
fam415	2	12	4	6.0	5.291502622129181	0.8819171036881969	12	2	10
fam416	5	5	7	5.666666666666667	1.1547005383792517	0.20377068324339734	7	5	2
fam417	2	9	7	6.0	3.605551275463989	0.6009252125773316	9	2	7
fam418	2	8	7	5.666666666666667	3.2145502536643185	0.5672735741760562	8	2	6
fam419	13	2	2	5.666666666666667	6.350852961085883	1.1207387578386852	13	2	11
fam420	3	10	4	5.666666666666667	3.7859388972001824	0.6681068642117969	10	3	7
fam421	4	7	6	5.666666666666667	1.5275252316519465	0.2695632761738729	7	4	3
fam422	5	5	7	5.666666666666667	1.1547005383792517	0.20377068324339734	7	5	2
fam423	2	8	8	6.0	3.4641016151377544	0.5773502691896257	8	2	6
fam424	3	5	9	5.666666666666667	3.055050463303893	0.5391265523477458	9	3	6
fam425	3	13	2	6.0	6.082762530298219	1.0137937550497031	13	2	11
fam426	3	7	7	5.666666666666667	2.309401076758503	0.4075413664867946	7	3	4
fam427	2	8	7	5.666666666666667	3.2145502536643185	0.5672735741760562	8	2	6
fam428	2	9	7	6.0	3.605551275463989	0.6009252125773316	9	2	7
fam429	2	10	6	6.0	4.0	0.6666666666666666	10	2	8
fam430	2	8	8	6.0	3.4641016151377544	0.5773502691896257	8	2	6
fam431	3	6	8	5.666666666666667	2.516611478423583	0.44410790795710287	8	3	5
fam432	2	10	6	6.0	4.0	0.6666666666666666	10	2	8
fam433	2	15	2	6.333333333333333	7.505553499465135	1.1850873946523899	15	2	13
fam434	2	15	2	6.333333333333333	7.505553499465135	1.1850873946523899	15	2	13
fam435	2	10	5	5.666666666666667	4.041451884327381	0.7131973913518906	10	2	8
fam436	2	15	2	6.333333333333333	7.505553499465135	1.1850873946523899	15	2	13
fam437	2	2	15	6.333333333333333	7.505553499465136	1.1850873946523899	15	2	13
fam438	3	13	2	6.0	6.082762530298219	1.0137937550497031	13	2	11
fam439	7	5	5	5.666666666666667	1.1547005383792517	0.20377068324339734	7	5	2
fam440	2	6	10	6.0	4.0	0.6666666666666666	10	2	8
fam441	6	5	5	5.333333333333333	0.5773502691896258	0.10825317547305485	6	5	1
fam442	4	6	6	5.333333333333333	1.1547005383792517	0.2165063509461097	6	4	2
fam443	6	6	4	5.333333333333333	1.1547005383792517	0.2165063509461097	6	4	2
fam444	5	5	6	5.333333333333333	0.5773502691896258	0.10825317547305485	6	5	1
fam445	5	5	6	5.333333333333333	0.5773502691896258	0.10825317547305485	6	5	1
fam446	6	4	6	5.333333333333333	1.1547005383792517	0.2165063509461097	6	4	2
fam447	5	5	6	5.333333333333333	0.5773502691896258	0.10825317547305485	6	5	1
fam448	4	6	6	5.333333333333333	1.1547005383792517	0.2165063509461097	6	4	2
fam449	4	5	7	5.333333333333333	1.5275252316519465	0.28641098093474	7	4	3
fam450	7	5	4	5.333333333333333	1.5275252316519465	0.28641098093474	7	4	3
fam451	2	7	7	5.333333333333333	2.8867513459481287	0.5412658773652742	7	2	5
fam452	7	7	2	5.333333333333333	2.8867513459481287	0.5412658773652742	7	2	5
fam453	3	6	7	5.333333333333333	2.0816659994661326	0.3903123748998999	7	3	4
fam454	3	6	7	5.333333333333333	2.0816659994661326	0.3903123748998999	7	3	4
fam455	7	5	4	5.333333333333333	1.5275252316519465	0.28641098093474	7	4	3
fam456	2	7	7	5.333333333333333	2.8867513459481287	0.5412658773652742	7	2	5
fam457	3	7	6	5.333333333333333	2.0816659994661326	0.3903123748998999	7	3	4
fam458	2	8	7	5.666666666666667	3.2145502536643185	0.5672735741760562	8	2	6
fam459	2	8	7	5.666666666666667	3.2145502536643185	0.5672735741760562	8	2	6
fam460	8	3	5	5.333333333333333	2.516611478423583	0.47186465220442186	8	3	5
fam461	3	8	5	5.333333333333333	2.516611478423583	0.47186465220442186	8	3	5
fam462	2	8	7	5.666666666666667	3.2145502536643185	0.5672735741760562	8	2	6
fam463	2	8	7	5.666666666666667	3.2145502536643185	0.5672735741760562	8	2	6
fam464	2	8	7	5.666666666666667	3.2145502536643185	0.5672735741760562	8	2	6
fam465	8	6	2	5.333333333333333	3.055050463303893	0.57282196186948	8	2	6
fam466	2	7	8	5.666666666666667	3.214550253664318	0.5672735741760561	8	2	6
fam467	2	8	6	5.333333333333333	3.0550504633038935	0.5728219618694801	8	2	6
fam468	3	5	8	5.333333333333333	2.516611478423583	0.47186465220442186	8	3	5
fam469	2	6	8	5.333333333333333	3.055050463303893	0.57282196186948	8	2	6
fam470	8	4	4	5.333333333333333	2.309401076758503	0.4330127018922193	8	4	4
fam471	5	8	3	5.333333333333333	2.516611478423583	0.47186465220442186	8	3	5
fam472	2	8	7	5.666666666666667	3.2145502536643185	0.5672735741760562	8	2	6
fam473	2	8	7	5.666666666666667	3.2145502536643185	0.5672735741760562	8	2	6
fam474	2	7	7	5.333333333333333	2.8867513459481287	0.5412658773652742	7	2	5
fam475	2	9	6	5.666666666666667	3.5118845842842465	0.6197443384031023	9	2	7
fam476	2	9	6	5.666666666666667	3.5118845842842465	0.6197443384031023	9	2	7
fam477	2	9	6	5.666666666666667	3.5118845842842465	0.6197443384031023	9	2	7
fam478	3	9	4	5.333333333333333	3.2145502536643185	0.6027281725620598	9	3	6
fam479	2	8	7	5.666666666666667	3.2145502536643185	0.5672735741760562	8	2	6
fam480	2	9	6	5.666666666666667	3.5118845842842465	0.6197443384031023	9	2	7
fam481	2	9	6	5.666666666666667	3.5118845842842465	0.6197443384031023	9	2	7
fam482	2	9	6	5.666666666666667	3.5118845842842465	0.6197443384031023	9	2	7
fam483	6	9	2	5.666666666666667	3.511884584284246	0.6197443384031022	9	2	7
fam484	2	7	7	5.333333333333333	2.8867513459481287	0.5412658773652742	7	2	5
fam485	3	7	6	5.333333333333333	2.0816659994661326	0.3903123748998999	7	3	4
fam486	2	10	5	5.666666666666667	4.041451884327381	0.7131973913518906	10	2	8
fam487	2	10	5	5.666666666666667	4.041451884327381	0.7131973913518906	10	2	8
fam488	2	10	5	5.666666666666667	4.041451884327381	0.7131973913518906	10	2	8
fam489	5	10	2	5.666666666666667	4.041451884327381	0.7131973913518906	10	2	8
fam490	2	10	5	5.666666666666667	4.041451884327381	0.7131973913518906	10	2	8
fam491	3	10	3	5.333333333333333	4.041451884327381	0.7577722283113839	10	3	7
fam492	2	10	5	5.666666666666667	4.041451884327381	0.7131973913518906	10	2	8
fam493	5	6	5	5.333333333333333	0.5773502691896258	0.10825317547305485	6	5	1
fam494	2	11	4	5.666666666666667	4.725815626252608	0.8339674634563425	11	2	9
fam495	2	11	4	5.666666666666667	4.725815626252608	0.8339674634563425	11	2	9
fam496	11	2	3	5.333333333333333	4.932882862316247	0.9249155366842964	11	2	9
fam497	5	10	2	5.666666666666667	4.041451884327381	0.7131973913518906	10	2	8
fam498	8	4	4	5.333333333333333	2.309401076758503	0.4330127018922193	8	4	4
fam499	5	4	7	5.333333333333333	1.5275252316519465	0.28641098093474	7	4	3
fam500	2	8	7	5.666666666666667	3.2145502536643185	0.5672735741760562	8	2	6
fam501	5	7	4	5.333333333333333	1.5275252316519465	0.28641098093474	7	4	3
fam502	4	6	6	5.333333333333333	1.1547005383792517	0.2165063509461097	6	4	2
fam503	2	12	3	5.666666666666667	5.507570547286102	0.9719242142269592	12	2	10
fam504	4	5	7	5.333333333333333	1.5275252316519465	0.28641098093474	7	4	3
fam505	2	5	10	5.666666666666667	4.041451884327381	0.7131973913518906	10	2	8
fam506	3	6	7	5.333333333333333	2.0816659994661326	0.3903123748998999	7	3	4
fam507	2	8	7	5.666666666666667	3.2145502536643185	0.5672735741760562	8	2	6
fam508	2	13	2	5.666666666666667	6.350852961085883	1.1207387578386852	13	2	11
fam509	3	7	6	5.333333333333333	2.0816659994661326	0.3903123748998999	7	3	4
fam510	2	10	5	5.666666666666667	4.041451884327381	0.7131973913518906	10	2	8
fam511	4	8	4	5.333333333333333	2.309401076758503	0.4330127018922193	8	4	4
fam512	2	10	5	5.666666666666667	4.041451884327381	0.7131973913518906	10	2	8
fam513	2	11	4	5.666666666666667	4.725815626252608	0.8339674634563425	11	2	9
fam514	5	4	7	5.333333333333333	1.5275252316519465	0.28641098093474	7	4	3
fam515	2	10	5	5.666666666666667	4.041451884327381	0.7131973913518906	10	2	8
fam516	2	11	4	5.666666666666667	4.725815626252608	0.8339674634563425	11	2	9
fam517	3	10	3	5.333333333333333	4.041451884327381	0.7577722283113839	10	3	7
fam518	2	8	6	5.333333333333333	3.0550504633038935	0.5728219618694801	8	2	6
fam519	2	2	14	6.0	6.928203230275509	1.1547005383792515	14	2	12
fam520	2	8	6	5.333333333333333	3.0550504633038935	0.5728219618694801	8	2	6
fam521	4	2	10	5.333333333333333	4.163331998932266	0.7806247497997999	10	2	8
fam522	2	7	7	5.333333333333333	2.8867513459481287	0.5412658773652742	7	2	5
fam523	5	7	4	5.333333333333333	1.5275252316519465	0.28641098093474	7	4	3
fam524	5	5	5	5.0	0.0	0.0	5	5	0
fam525	5	5	5	5.0	0.0	0.0	5	5	0
fam526	5	5	5	5.0	0.0	0.0	5	5	0
fam527	5	5	5	5.0	0.0	0.0	5	5	0
fam528	3	6	6	5.0	1.7320508075688772	0.34641016151377546	6	3	3
fam529	4	6	5	5.0	1.0	0.2	6	4	2
fam530	3	6	6	5.0	1.7320508075688772	0.34641016151377546	6	3	3
fam531	5	4	6	5.0	1.0	0.2	6	4	2
fam532	5	6	4	5.0	1.0	0.2	6	4	2
fam533	4	6	5	5.0	1.0	0.2	6	4	2
fam534	5	6	4	5.0	1.0	0.2	6	4	2
fam535	5	6	4	5.0	1.0	0.2	6	4	2
fam536	4	6	5	5.0	1.0	0.2	6	4	2
fam537	4	5	6	5.0	1.0	0.2	6	4	2
fam538	3	6	6	5.0	1.7320508075688772	0.34641016151377546	6	3	3
fam539	4	6	5	5.0	1.0	0.2	6	4	2
fam540	2	7	7	5.333333333333333	2.8867513459481287	0.5412658773652742	7	2	5
fam541	3	7	5	5.0	2.0	0.4	7	3	4
fam542	7	2	7	5.333333333333333	2.8867513459481287	0.5412658773652742	7	2	5
fam543	3	5	7	5.0	2.0	0.4	7	3	4
fam544	4	4	7	5.0	1.7320508075688772	0.34641016151377546	7	4	3
fam545	2	6	7	5.0	2.6457513110645907	0.5291502622129182	7	2	5
fam546	2	7	7	5.333333333333333	2.8867513459481287	0.5412658773652742	7	2	5
fam547	3	5	7	5.0	2.0	0.4	7	3	4
fam548	2	7	6	5.0	2.6457513110645907	0.5291502622129182	7	2	5
fam549	2	7	6	5.0	2.6457513110645907	0.5291502622129182	7	2	5
fam550	2	7	6	5.0	2.6457513110645907	0.5291502622129182	7	2	5
fam551	2	7	7	5.333333333333333	2.8867513459481287	0.5412658773652742	7	2	5
fam552	7	5	3	5.0	2.0	0.4	7	3	4
fam553	3	5	7	5.0	2.0	0.4	7	3	4
fam554	3	7	5	5.0	2.0	0.4	7	3	4
fam555	3	5	7	5.0	2.0	0.4	7	3	4
fam556	3	7	5	5.0	2.0	0.4	7	3	4
fam557	2	6	7	5.0	2.6457513110645907	0.5291502622129182	7	2	5
fam558	2	6	7	5.0	2.6457513110645907	0.5291502622129182	7	2	5
fam559	2	7	6	5.0	2.6457513110645907	0.5291502622129182	7	2	5
fam560	2	7	6	5.0	2.6457513110645907	0.5291502622129182	7	2	5
fam561	6	7	2	5.0	2.6457513110645907	0.5291502622129182	7	2	5
fam562	3	6	6	5.0	1.7320508075688772	0.34641016151377546	6	3	3
fam563	2	8	6	5.333333333333333	3.0550504633038935	0.5728219618694801	8	2	6
fam564	2	8	6	5.333333333333333	3.0550504633038935	0.5728219618694801	8	2	6
fam565	2	8	5	5.0	3.0	0.6	8	2	6
fam566	6	8	2	5.333333333333333	3.055050463303893	0.57282196186948	8	2	6
fam567	2	8	6	5.333333333333333	3.0550504633038935	0.5728219618694801	8	2	6
fam568	2	6	8	5.333333333333333	3.055050463303893	0.57282196186948	8	2	6
fam569	2	8	6	5.333333333333333	3.0550504633038935	0.5728219618694801	8	2	6
fam570	5	8	2	5.0	3.0	0.6	8	2	6
fam571	2	6	8	5.333333333333333	3.055050463303893	0.57282196186948	8	2	6
fam572	2	8	6	5.333333333333333	3.0550504633038935	0.5728219618694801	8	2	6
fam573	8	6	2	5.333333333333333	3.055050463303893	0.57282196186948	8	2	6
fam574	2	6	8	5.333333333333333	3.055050463303893	0.57282196186948	8	2	6
fam575	2	8	6	5.333333333333333	3.0550504633038935	0.5728219618694801	8	2	6
fam576	6	8	2	5.333333333333333	3.055050463303893	0.57282196186948	8	2	6
fam577	5	8	2	5.0	3.0	0.6	8	2	6
fam578	2	8	6	5.333333333333333	3.0550504633038935	0.5728219618694801	8	2	6
fam579	2	5	8	5.0	3.0	0.6	8	2	6
fam580	2	6	8	5.333333333333333	3.055050463303893	0.57282196186948	8	2	6
fam581	2	8	5	5.0	3.0	0.6	8	2	6
fam582	2	8	5	5.0	3.0	0.6	8	2	6
fam583	2	8	5	5.0	3.0	0.6	8	2	6
fam584	3	8	4	5.0	2.6457513110645907	0.5291502622129182	8	3	5
fam585	6	5	4	5.0	1.0	0.2	6	4	2
fam586	3	7	5	5.0	2.0	0.4	7	3	4
fam587	2	9	4	5.0	3.605551275463989	0.7211102550927978	9	2	7
fam588	2	9	5	5.333333333333333	3.5118845842842465	0.6584783595532963	9	2	7
fam589	2	9	5	5.333333333333333	3.5118845842842465	0.6584783595532963	9	2	7
fam590	2	9	4	5.0	3.605551275463989	0.7211102550927978	9	2	7
fam591	2	9	5	5.333333333333333	3.5118845842842465	0.6584783595532963	9	2	7
fam592	2	4	9	5.0	3.605551275463989	0.7211102550927978	9	2	7
fam593	2	5	9	5.333333333333333	3.511884584284246	0.6584783595532961	9	2	7
fam594	2	9	5	5.333333333333333	3.5118845842842465	0.6584783595532963	9	2	7
fam595	2	9	5	5.333333333333333	3.5118845842842465	0.6584783595532963	9	2	7
fam596	2	9	5	5.333333333333333	3.5118845842842465	0.6584783595532963	9	2	7
fam597	2	9	5	5.333333333333333	3.5118845842842465	0.6584783595532963	9	2	7
fam598	2	9	5	5.333333333333333	3.5118845842842465	0.6584783595532963	9	2	7
fam599	2	9	5	5.333333333333333	3.5118845842842465	0.6584783595532963	9	2	7
fam600	4	7	4	5.0	1.7320508075688772	0.34641016151377546	7	4	3
fam601	6	6	3	5.0	1.7320508075688772	0.34641016151377546	6	3	3
fam602	6	7	2	5.0	2.6457513110645907	0.5291502622129182	7	2	5
fam603	5	5	5	5.0	0.0	0.0	5	5	0
fam604	2	10	4	5.333333333333333	4.163331998932266	0.7806247497997999	10	2	8
fam605	4	10	2	5.333333333333333	4.163331998932266	0.7806247497997999	10	2	8
fam606	5	7	3	5.0	2.0	0.4	7	3	4
fam607	2	10	4	5.333333333333333	4.163331998932266	0.7806247497997999	10	2	8
fam608	2	10	4	5.333333333333333	4.163331998932266	0.7806247497997999	10	2	8
fam609	3	5	7	5.0	2.0	0.4	7	3	4
fam610	2	10	4	5.333333333333333	4.163331998932266	0.7806247497997999	10	2	8
fam611	5	5	5	5.0	0.0	0.0	5	5	0
fam612	2	10	4	5.333333333333333	4.163331998932266	0.7806247497997999	10	2	8
fam613	5	6	4	5.0	1.0	0.2	6	4	2
fam614	3	5	7	5.0	2.0	0.4	7	3	4
fam615	2	9	5	5.333333333333333	3.5118845842842465	0.6584783595532963	9	2	7
fam616	2	11	2	5.0	5.196152422706632	1.0392304845413265	11	2	9
fam617	2	11	3	5.333333333333333	4.932882862316247	0.9249155366842964	11	2	9
fam618	4	7	4	5.0	1.7320508075688772	0.34641016151377546	7	4	3
fam619	2	3	11	5.333333333333333	4.932882862316247	0.9249155366842964	11	2	9
fam620	4	5	6	5.0	1.0	0.2	6	4	2
fam621	2	5	8	5.0	3.0	0.6	8	2	6
fam622	2	8	6	5.333333333333333	3.0550504633038935	0.5728219618694801	8	2	6
fam623	2	7	7	5.333333333333333	2.8867513459481287	0.5412658773652742	7	2	5
fam624	4	6	5	5.0	1.0	0.2	6	4	2
fam625	2	7	7	5.333333333333333	2.8867513459481287	0.5412658773652742	7	2	5
fam626	4	7	4	5.0	1.7320508075688772	0.34641016151377546	7	4	3
fam627	2	2	12	5.333333333333333	5.773502691896258	1.0825317547305484	12	2	10
fam628	12	2	2	5.333333333333333	5.773502691896258	1.0825317547305484	12	2	10
fam629	3	7	5	5.0	2.0	0.4	7	3	4
fam630	5	6	4	5.0	1.0	0.2	6	4	2
fam631	2	9	5	5.333333333333333	3.5118845842842465	0.6584783595532963	9	2	7
fam632	2	7	7	5.333333333333333	2.8867513459481287	0.5412658773652742	7	2	5
fam633	2	8	6	5.333333333333333	3.0550504633038935	0.5728219618694801	8	2	6
fam634	2	8	6	5.333333333333333	3.0550504633038935	0.5728219618694801	8	2	6
fam635	2	4	9	5.0	3.605551275463989	0.7211102550927978	9	2	7
fam636	2	8	6	5.333333333333333	3.0550504633038935	0.5728219618694801	8	2	6
fam637	2	6	7	5.0	2.6457513110645907	0.5291502622129182	7	2	5
fam638	2	13	2	5.666666666666667	6.350852961085883	1.1207387578386852	13	2	11
fam639	2	8	6	5.333333333333333	3.0550504633038935	0.5728219618694801	8	2	6
fam640	2	7	7	5.333333333333333	2.8867513459481287	0.5412658773652742	7	2	5
fam641	7	4	4	5.0	1.7320508075688772	0.34641016151377546	7	4	3
fam642	2	9	5	5.333333333333333	3.5118845842842465	0.6584783595532963	9	2	7
fam643	2	10	3	5.0	4.358898943540674	0.8717797887081348	10	2	8
fam644	2	9	5	5.333333333333333	3.5118845842842465	0.6584783595532963	9	2	7
fam645	2	4	9	5.0	3.605551275463989	0.7211102550927978	9	2	7
fam646	5	5	4	4.666666666666667	0.5773502691896258	0.12371791482634839	5	4	1
fam647	4	5	5	4.666666666666667	0.5773502691896258	0.12371791482634839	5	4	1
fam648	5	4	5	4.666666666666667	0.5773502691896258	0.12371791482634839	5	4	1
fam649	4	5	5	4.666666666666667	0.5773502691896258	0.12371791482634839	5	4	1
fam650	4	5	5	4.666666666666667	0.5773502691896258	0.12371791482634839	5	4	1
fam651	4	5	5	4.666666666666667	0.5773502691896258	0.12371791482634839	5	4	1
fam652	4	5	5	4.666666666666667	0.5773502691896258	0.12371791482634839	5	4	1
fam653	5	4	5	4.666666666666667	0.5773502691896258	0.12371791482634839	5	4	1
fam654	5	4	5	4.666666666666667	0.5773502691896258	0.12371791482634839	5	4	1
fam655	4	5	5	4.666666666666667	0.5773502691896258	0.12371791482634839	5	4	1
fam656	5	5	4	4.666666666666667	0.5773502691896258	0.12371791482634839	5	4	1
fam657	4	6	4	4.666666666666667	1.1547005383792517	0.24743582965269678	6	4	2
fam658	4	6	4	4.666666666666667	1.1547005383792517	0.24743582965269678	6	4	2
fam659	5	6	3	4.666666666666667	1.5275252316519465	0.32732683535398854	6	3	3
fam660	3	5	6	4.666666666666667	1.5275252316519465	0.32732683535398854	6	3	3
fam661	3	5	6	4.666666666666667	1.5275252316519465	0.32732683535398854	6	3	3
fam662	6	2	6	4.666666666666667	2.309401076758503	0.49487165930539345	6	2	4
fam663	4	6	4	4.666666666666667	1.1547005383792517	0.24743582965269678	6	4	2
fam664	6	3	5	4.666666666666667	1.5275252316519465	0.32732683535398854	6	3	3
fam665	4	4	6	4.666666666666667	1.1547005383792517	0.24743582965269678	6	4	2
fam666	4	6	4	4.666666666666667	1.1547005383792517	0.24743582965269678	6	4	2
fam667	3	5	6	4.666666666666667	1.5275252316519465	0.32732683535398854	6	3	3
fam668	3	6	5	4.666666666666667	1.5275252316519465	0.32732683535398854	6	3	3
fam669	3	5	6	4.666666666666667	1.5275252316519465	0.32732683535398854	6	3	3
fam670	3	6	5	4.666666666666667	1.5275252316519465	0.32732683535398854	6	3	3
fam671	5	3	6	4.666666666666667	1.5275252316519465	0.32732683535398854	6	3	3
fam672	3	5	6	4.666666666666667	1.5275252316519465	0.32732683535398854	6	3	3
fam673	3	6	5	4.666666666666667	1.5275252316519465	0.32732683535398854	6	3	3
fam674	6	4	4	4.666666666666667	1.1547005383792517	0.24743582965269678	6	4	2
fam675	2	6	7	5.0	2.6457513110645907	0.5291502622129182	7	2	5
fam676	3	7	4	4.666666666666667	2.0816659994661326	0.4460712855998855	7	3	4
fam677	2	7	6	5.0	2.6457513110645907	0.5291502622129182	7	2	5
fam678	2	7	6	5.0	2.6457513110645907	0.5291502622129182	7	2	5
fam679	2	6	7	5.0	2.6457513110645907	0.5291502622129182	7	2	5
fam680	3	7	4	4.666666666666667	2.0816659994661326	0.4460712855998855	7	3	4
fam681	3	7	4	4.666666666666667	2.0816659994661326	0.4460712855998855	7	3	4
fam682	2	6	7	5.0	2.6457513110645907	0.5291502622129182	7	2	5
fam683	2	7	5	4.666666666666667	2.516611478423583	0.5392738882336249	7	2	5
fam684	2	7	6	5.0	2.6457513110645907	0.5291502622129182	7	2	5
fam685	2	5	7	4.666666666666667	2.516611478423583	0.5392738882336249	7	2	5
fam686	2	7	6	5.0	2.6457513110645907	0.5291502622129182	7	2	5
fam687	2	6	7	5.0	2.6457513110645907	0.5291502622129182	7	2	5
fam688	2	7	6	5.0	2.6457513110645907	0.5291502622129182	7	2	5
fam689	2	6	7	5.0	2.6457513110645907	0.5291502622129182	7	2	5
fam690	3	4	7	4.666666666666667	2.0816659994661326	0.4460712855998855	7	3	4
fam691	2	6	7	5.0	2.6457513110645907	0.5291502622129182	7	2	5
fam692	2	6	7	5.0	2.6457513110645907	0.5291502622129182	7	2	5
fam693	2	6	7	5.0	2.6457513110645907	0.5291502622129182	7	2	5
fam694	2	7	6	5.0	2.6457513110645907	0.5291502622129182	7	2	5
fam695	2	6	7	5.0	2.6457513110645907	0.5291502622129182	7	2	5
fam696	2	6	7	5.0	2.6457513110645907	0.5291502622129182	7	2	5
fam697	2	7	6	5.0	2.6457513110645907	0.5291502622129182	7	2	5
fam698	2	6	7	5.0	2.6457513110645907	0.5291502622129182	7	2	5
fam699	3	4	7	4.666666666666667	2.0816659994661326	0.4460712855998855	7	3	4
fam700	2	7	5	4.666666666666667	2.516611478423583	0.5392738882336249	7	2	5
fam701	3	7	4	4.666666666666667	2.0816659994661326	0.4460712855998855	7	3	4
fam702	2	6	7	5.0	2.6457513110645907	0.5291502622129182	7	2	5
fam703	7	5	2	4.666666666666667	2.516611478423583	0.5392738882336249	7	2	5
fam704	7	3	4	4.666666666666667	2.0816659994661326	0.4460712855998855	7	3	4
fam705	6	7	2	5.0	2.6457513110645907	0.5291502622129182	7	2	5
fam706	2	7	6	5.0	2.6457513110645907	0.5291502622129182	7	2	5
fam707	2	6	7	5.0	2.6457513110645907	0.5291502622129182	7	2	5
fam708	2	7	6	5.0	2.6457513110645907	0.5291502622129182	7	2	5
fam709	2	8	5	5.0	3.0	0.6	8	2	6
fam710	2	8	5	5.0	3.0	0.6	8	2	6
fam711	8	2	5	5.0	3.0	0.6	8	2	6
fam712	2	8	5	5.0	3.0	0.6	8	2	6
fam713	2	4	8	4.666666666666667	3.055050463303893	0.6546536707079771	8	2	6
fam714	2	8	5	5.0	3.0	0.6	8	2	6
fam715	2	5	8	5.0	3.0	0.6	8	2	6
fam716	2	8	5	5.0	3.0	0.6	8	2	6
fam717	2	8	4	4.666666666666667	3.0550504633038935	0.6546536707079771	8	2	6
fam718	2	8	5	5.0	3.0	0.6	8	2	6
fam719	2	8	5	5.0	3.0	0.6	8	2	6
fam720	2	8	5	5.0	3.0	0.6	8	2	6
fam721	4	8	2	4.666666666666667	3.055050463303893	0.6546536707079771	8	2	6
fam722	2	8	5	5.0	3.0	0.6	8	2	6
fam723	2	8	5	5.0	3.0	0.6	8	2	6
fam724	2	8	5	5.0	3.0	0.6	8	2	6
fam725	4	2	8	4.666666666666667	3.055050463303893	0.6546536707079771	8	2	6
fam726	2	8	5	5.0	3.0	0.6	8	2	6
fam727	2	4	8	4.666666666666667	3.055050463303893	0.6546536707079771	8	2	6
fam728	8	2	5	5.0	3.0	0.6	8	2	6
fam729	2	4	8	4.666666666666667	3.055050463303893	0.6546536707079771	8	2	6
fam730	5	8	2	5.0	3.0	0.6	8	2	6
fam731	6	2	6	4.666666666666667	2.309401076758503	0.49487165930539345	6	2	4
fam732	3	7	4	4.666666666666667	2.0816659994661326	0.4460712855998855	7	3	4
fam733	9	3	2	4.666666666666667	3.7859388972001824	0.8112726208286105	9	2	7
fam734	2	9	4	5.0	3.605551275463989	0.7211102550927978	9	2	7
fam735	2	9	4	5.0	3.605551275463989	0.7211102550927978	9	2	7
fam736	2	9	4	5.0	3.605551275463989	0.7211102550927978	9	2	7
fam737	2	4	9	5.0	3.605551275463989	0.7211102550927978	9	2	7
fam738	2	9	4	5.0	3.605551275463989	0.7211102550927978	9	2	7
fam739	2	9	4	5.0	3.605551275463989	0.7211102550927978	9	2	7
fam740	2	4	9	5.0	3.605551275463989	0.7211102550927978	9	2	7
fam741	2	9	3	4.666666666666667	3.7859388972001824	0.8112726208286105	9	2	7
fam742	2	3	9	4.666666666666667	3.7859388972001824	0.8112726208286105	9	2	7
fam743	2	9	4	5.0	3.605551275463989	0.7211102550927978	9	2	7
fam744	2	9	4	5.0	3.605551275463989	0.7211102550927978	9	2	7
fam745	4	9	2	5.0	3.605551275463989	0.7211102550927978	9	2	7
fam746	2	7	5	4.666666666666667	2.516611478423583	0.5392738882336249	7	2	5
fam747	2	7	6	5.0	2.6457513110645907	0.5291502622129182	7	2	5
fam748	3	10	2	5.0	4.358898943540674	0.8717797887081348	10	2	8
fam749	2	10	2	4.666666666666667	4.618802153517007	0.9897433186107871	10	2	8
fam750	3	10	2	5.0	4.358898943540674	0.8717797887081348	10	2	8
fam751	2	8	5	5.0	3.0	0.6	8	2	6
fam752	5	8	2	5.0	3.0	0.6	8	2	6
fam753	4	5	5	4.666666666666667	0.5773502691896258	0.12371791482634839	5	4	1
fam754	2	8	5	5.0	3.0	0.6	8	2	6
fam755	4	5	5	4.666666666666667	0.5773502691896258	0.12371791482634839	5	4	1
fam756	2	2	11	5.0	5.196152422706632	1.0392304845413265	11	2	9
fam757	2	11	2	5.0	5.196152422706632	1.0392304845413265	11	2	9
fam758	2	11	2	5.0	5.196152422706632	1.0392304845413265	11	2	9
fam759	4	9	2	5.0	3.605551275463989	0.7211102550927978	9	2	7
fam760	5	6	3	4.666666666666667	1.5275252316519465	0.32732683535398854	6	3	3
fam761	2	7	6	5.0	2.6457513110645907	0.5291502622129182	7	2	5
fam762	2	8	5	5.0	3.0	0.6	8	2	6
fam763	2	7	6	5.0	2.6457513110645907	0.5291502622129182	7	2	5
fam764	2	12	2	5.333333333333333	5.773502691896258	1.0825317547305484	12	2	10
fam765	2	12	2	5.333333333333333	5.773502691896258	1.0825317547305484	12	2	10
fam766	2	12	2	5.333333333333333	5.773502691896258	1.0825317547305484	12	2	10
fam767	2	12	2	5.333333333333333	5.773502691896258	1.0825317547305484	12	2	10
fam768	2	12	2	5.333333333333333	5.773502691896258	1.0825317547305484	12	2	10
fam769	2	6	6	4.666666666666667	2.309401076758503	0.49487165930539345	6	2	4
fam770	2	12	2	5.333333333333333	5.773502691896258	1.0825317547305484	12	2	10
fam771	2	12	2	5.333333333333333	5.773502691896258	1.0825317547305484	12	2	10
fam772	2	6	6	4.666666666666667	2.309401076758503	0.49487165930539345	6	2	4
fam773	2	4	9	5.0	3.605551275463989	0.7211102550927978	9	2	7
fam774	2	9	4	5.0	3.605551275463989	0.7211102550927978	9	2	7
fam775	2	8	5	5.0	3.0	0.6	8	2	6
fam776	6	6	2	4.666666666666667	2.309401076758503	0.49487165930539345	6	2	4
fam777	2	5	8	5.0	3.0	0.6	8	2	6
fam778	3	4	7	4.666666666666667	2.0816659994661326	0.4460712855998855	7	3	4
fam779	4	9	2	5.0	3.605551275463989	0.7211102550927978	9	2	7
fam780	2	6	6	4.666666666666667	2.309401076758503	0.49487165930539345	6	2	4
fam781	3	8	3	4.666666666666667	2.8867513459481287	0.6185895741317419	8	3	5
fam782	2	9	4	5.0	3.605551275463989	0.7211102550927978	9	2	7
fam783	2	7	6	5.0	2.6457513110645907	0.5291502622129182	7	2	5
fam784	2	5	8	5.0	3.0	0.6	8	2	6
fam785	5	4	4	4.333333333333333	0.5773502691896258	0.13323467750529827	5	4	1
fam786	3	5	5	4.333333333333333	1.1547005383792517	0.26646935501059654	5	3	2
fam787	5	3	5	4.333333333333333	1.1547005383792517	0.26646935501059654	5	3	2
fam788	4	4	5	4.333333333333333	0.5773502691896258	0.13323467750529827	5	4	1
fam789	3	5	5	4.333333333333333	1.1547005383792517	0.26646935501059654	5	3	2
fam790	4	5	4	4.333333333333333	0.5773502691896258	0.13323467750529827	5	4	1
fam791	5	4	4	4.333333333333333	0.5773502691896258	0.13323467750529827	5	4	1
fam792	4	5	4	4.333333333333333	0.5773502691896258	0.13323467750529827	5	4	1
fam793	3	5	5	4.333333333333333	1.1547005383792517	0.26646935501059654	5	3	2
fam794	4	4	5	4.333333333333333	0.5773502691896258	0.13323467750529827	5	4	1
fam795	4	4	5	4.333333333333333	0.5773502691896258	0.13323467750529827	5	4	1
fam796	4	4	5	4.333333333333333	0.5773502691896258	0.13323467750529827	5	4	1
fam797	4	5	4	4.333333333333333	0.5773502691896258	0.13323467750529827	5	4	1
fam798	5	4	4	4.333333333333333	0.5773502691896258	0.13323467750529827	5	4	1
fam799	4	4	5	4.333333333333333	0.5773502691896258	0.13323467750529827	5	4	1
fam800	5	4	4	4.333333333333333	0.5773502691896258	0.13323467750529827	5	4	1
fam801	4	4	5	4.333333333333333	0.5773502691896258	0.13323467750529827	5	4	1
fam802	4	4	5	4.333333333333333	0.5773502691896258	0.13323467750529827	5	4	1
fam803	4	4	5	4.333333333333333	0.5773502691896258	0.13323467750529827	5	4	1
fam804	5	5	3	4.333333333333333	1.1547005383792517	0.26646935501059654	5	3	2
fam805	6	4	3	4.333333333333333	1.5275252316519465	0.3525058226889108	6	3	3
fam806	4	6	3	4.333333333333333	1.5275252316519465	0.3525058226889108	6	3	3
fam807	2	6	6	4.666666666666667	2.309401076758503	0.49487165930539345	6	2	4
fam808	2	6	6	4.666666666666667	2.309401076758503	0.49487165930539345	6	2	4
fam809	2	6	6	4.666666666666667	2.309401076758503	0.49487165930539345	6	2	4
fam810	3	6	4	4.333333333333333	1.5275252316519465	0.3525058226889108	6	3	3
fam811	2	6	5	4.333333333333333	2.0816659994661326	0.4803844614152614	6	2	4
fam812	3	6	4	4.333333333333333	1.5275252316519465	0.3525058226889108	6	3	3
fam813	2	6	5	4.333333333333333	2.0816659994661326	0.4803844614152614	6	2	4
fam814	3	6	4	4.333333333333333	1.5275252316519465	0.3525058226889108	6	3	3
fam815	2	6	6	4.666666666666667	2.309401076758503	0.49487165930539345	6	2	4
fam816	3	6	4	4.333333333333333	1.5275252316519465	0.3525058226889108	6	3	3
fam817	2	6	6	4.666666666666667	2.309401076758503	0.49487165930539345	6	2	4
fam818	3	4	6	4.333333333333333	1.5275252316519465	0.3525058226889108	6	3	3
fam819	4	6	3	4.333333333333333	1.5275252316519465	0.3525058226889108	6	3	3
fam820	2	6	6	4.666666666666667	2.309401076758503	0.49487165930539345	6	2	4
fam821	2	6	6	4.666666666666667	2.309401076758503	0.49487165930539345	6	2	4
fam822	2	6	5	4.333333333333333	2.0816659994661326	0.4803844614152614	6	2	4
fam823	6	4	3	4.333333333333333	1.5275252316519465	0.3525058226889108	6	3	3
fam824	4	6	3	4.333333333333333	1.5275252316519465	0.3525058226889108	6	3	3
fam825	4	6	3	4.333333333333333	1.5275252316519465	0.3525058226889108	6	3	3
fam826	2	6	6	4.666666666666667	2.309401076758503	0.49487165930539345	6	2	4
fam827	2	6	6	4.666666666666667	2.309401076758503	0.49487165930539345	6	2	4
fam828	2	5	6	4.333333333333333	2.0816659994661326	0.4803844614152614	6	2	4
fam829	4	3	6	4.333333333333333	1.5275252316519465	0.3525058226889108	6	3	3
fam830	2	6	5	4.333333333333333	2.0816659994661326	0.4803844614152614	6	2	4
fam831	3	4	6	4.333333333333333	1.5275252316519465	0.3525058226889108	6	3	3
fam832	4	6	3	4.333333333333333	1.5275252316519465	0.3525058226889108	6	3	3
fam833	6	3	4	4.333333333333333	1.5275252316519465	0.3525058226889108	6	3	3
fam834	2	6	6	4.666666666666667	2.309401076758503	0.49487165930539345	6	2	4
fam835	2	5	6	4.333333333333333	2.0816659994661326	0.4803844614152614	6	2	4
fam836	2	5	6	4.333333333333333	2.0816659994661326	0.4803844614152614	6	2	4
fam837	3	4	6	4.333333333333333	1.5275252316519465	0.3525058226889108	6	3	3
fam838	2	6	6	4.666666666666667	2.309401076758503	0.49487165930539345	6	2	4
fam839	3	4	6	4.333333333333333	1.5275252316519465	0.3525058226889108	6	3	3
fam840	4	6	3	4.333333333333333	1.5275252316519465	0.3525058226889108	6	3	3
fam841	2	6	6	4.666666666666667	2.309401076758503	0.49487165930539345	6	2	4
fam842	3	6	4	4.333333333333333	1.5275252316519465	0.3525058226889108	6	3	3
fam843	2	6	6	4.666666666666667	2.309401076758503	0.49487165930539345	6	2	4
fam844	2	6	6	4.666666666666667	2.309401076758503	0.49487165930539345	6	2	4
fam845	3	6	4	4.333333333333333	1.5275252316519465	0.3525058226889108	6	3	3
fam846	3	6	4	4.333333333333333	1.5275252316519465	0.3525058226889108	6	3	3
fam847	5	6	2	4.333333333333333	2.0816659994661326	0.4803844614152614	6	2	4
fam848	6	4	3	4.333333333333333	1.5275252316519465	0.3525058226889108	6	3	3
fam849	2	6	6	4.666666666666667	2.309401076758503	0.49487165930539345	6	2	4
fam850	2	6	6	4.666666666666667	2.309401076758503	0.49487165930539345	6	2	4
fam851	2	6	5	4.333333333333333	2.0816659994661326	0.4803844614152614	6	2	4
fam852	3	6	4	4.333333333333333	1.5275252316519465	0.3525058226889108	6	3	3
fam853	4	5	4	4.333333333333333	0.5773502691896258	0.13323467750529827	5	4	1
fam854	2	4	7	4.333333333333333	2.516611478423583	0.5807564950208269	7	2	5
fam855	3	3	7	4.333333333333333	2.309401076758503	0.532938710021193	7	3	4
fam856	2	7	5	4.666666666666667	2.516611478423583	0.5392738882336249	7	2	5
fam857	2	7	5	4.666666666666667	2.516611478423583	0.5392738882336249	7	2	5
fam858	2	7	5	4.666666666666667	2.516611478423583	0.5392738882336249	7	2	5
fam859	2	4	7	4.333333333333333	2.516611478423583	0.5807564950208269	7	2	5
fam860	3	7	3	4.333333333333333	2.309401076758503	0.532938710021193	7	3	4
fam861	2	7	5	4.666666666666667	2.516611478423583	0.5392738882336249	7	2	5
fam862	2	7	4	4.333333333333333	2.516611478423583	0.5807564950208269	7	2	5
fam863	2	7	5	4.666666666666667	2.516611478423583	0.5392738882336249	7	2	5
fam864	2	7	5	4.666666666666667	2.516611478423583	0.5392738882336249	7	2	5
fam865	2	5	7	4.666666666666667	2.516611478423583	0.5392738882336249	7	2	5
fam866	2	7	5	4.666666666666667	2.516611478423583	0.5392738882336249	7	2	5
fam867	2	7	5	4.666666666666667	2.516611478423583	0.5392738882336249	7	2	5
fam868	2	7	5	4.666666666666667	2.516611478423583	0.5392738882336249	7	2	5
fam869	2	7	5	4.666666666666667	2.516611478423583	0.5392738882336249	7	2	5
fam870	2	5	7	4.666666666666667	2.516611478423583	0.5392738882336249	7	2	5
fam871	2	7	5	4.666666666666667	2.516611478423583	0.5392738882336249	7	2	5
fam872	2	7	4	4.333333333333333	2.516611478423583	0.5807564950208269	7	2	5
fam873	5	7	2	4.666666666666667	2.516611478423583	0.5392738882336249	7	2	5
fam874	2	7	5	4.666666666666667	2.516611478423583	0.5392738882336249	7	2	5
fam875	3	3	7	4.333333333333333	2.309401076758503	0.532938710021193	7	3	4
fam876	2	7	5	4.666666666666667	2.516611478423583	0.5392738882336249	7	2	5
fam877	3	7	3	4.333333333333333	2.309401076758503	0.532938710021193	7	3	4
fam878	2	5	7	4.666666666666667	2.516611478423583	0.5392738882336249	7	2	5
fam879	2	7	4	4.333333333333333	2.516611478423583	0.5807564950208269	7	2	5
fam880	2	7	5	4.666666666666667	2.516611478423583	0.5392738882336249	7	2	5
fam881	2	7	5	4.666666666666667	2.516611478423583	0.5392738882336249	7	2	5
fam882	2	5	7	4.666666666666667	2.516611478423583	0.5392738882336249	7	2	5
fam883	2	7	5	4.666666666666667	2.516611478423583	0.5392738882336249	7	2	5
fam884	2	7	5	4.666666666666667	2.516611478423583	0.5392738882336249	7	2	5
fam885	2	5	7	4.666666666666667	2.516611478423583	0.5392738882336249	7	2	5
fam886	2	7	5	4.666666666666667	2.516611478423583	0.5392738882336249	7	2	5
fam887	2	7	5	4.666666666666667	2.516611478423583	0.5392738882336249	7	2	5
fam888	2	5	7	4.666666666666667	2.516611478423583	0.5392738882336249	7	2	5
fam889	2	5	7	4.666666666666667	2.516611478423583	0.5392738882336249	7	2	5
fam890	2	7	5	4.666666666666667	2.516611478423583	0.5392738882336249	7	2	5
fam891	7	2	5	4.666666666666667	2.516611478423583	0.5392738882336249	7	2	5
fam892	5	7	2	4.666666666666667	2.516611478423583	0.5392738882336249	7	2	5
fam893	2	4	7	4.333333333333333	2.516611478423583	0.5807564950208269	7	2	5
fam894	5	7	2	4.666666666666667	2.516611478423583	0.5392738882336249	7	2	5
fam895	7	4	2	4.333333333333333	2.516611478423583	0.5807564950208269	7	2	5
fam896	4	5	4	4.333333333333333	0.5773502691896258	0.13323467750529827	5	4	1
fam897	4	5	4	4.333333333333333	0.5773502691896258	0.13323467750529827	5	4	1
fam898	3	6	4	4.333333333333333	1.5275252316519465	0.3525058226889108	6	3	3
fam899	6	2	5	4.333333333333333	2.0816659994661326	0.4803844614152614	6	2	4
fam900	5	4	4	4.333333333333333	0.5773502691896258	0.13323467750529827	5	4	1
fam901	2	8	4	4.666666666666667	3.0550504633038935	0.6546536707079771	8	2	6
fam902	2	4	8	4.666666666666667	3.055050463303893	0.6546536707079771	8	2	6
fam903	8	3	2	4.333333333333333	3.214550253664318	0.7418192893071504	8	2	6
fam904	2	8	4	4.666666666666667	3.0550504633038935	0.6546536707079771	8	2	6
fam905	2	8	4	4.666666666666667	3.0550504633038935	0.6546536707079771	8	2	6
fam906	2	7	5	4.666666666666667	2.516611478423583	0.5392738882336249	7	2	5
fam907	4	8	2	4.666666666666667	3.055050463303893	0.6546536707079771	8	2	6
fam908	8	3	2	4.333333333333333	3.214550253664318	0.7418192893071504	8	2	6
fam909	2	8	4	4.666666666666667	3.0550504633038935	0.6546536707079771	8	2	6
fam910	2	4	8	4.666666666666667	3.055050463303893	0.6546536707079771	8	2	6
fam911	2	8	4	4.666666666666667	3.0550504633038935	0.6546536707079771	8	2	6
fam912	2	8	3	4.333333333333333	3.2145502536643185	0.7418192893071505	8	2	6
fam913	3	5	5	4.333333333333333	1.1547005383792517	0.26646935501059654	5	3	2
fam914	2	8	4	4.666666666666667	3.0550504633038935	0.6546536707079771	8	2	6
fam915	3	8	2	4.333333333333333	3.214550253664318	0.7418192893071504	8	2	6
fam916	5	4	4	4.333333333333333	0.5773502691896258	0.13323467750529827	5	4	1
fam917	2	8	4	4.666666666666667	3.0550504633038935	0.6546536707079771	8	2	6
fam918	2	8	4	4.666666666666667	3.0550504633038935	0.6546536707079771	8	2	6
fam919	2	8	4	4.666666666666667	3.0550504633038935	0.6546536707079771	8	2	6
fam920	2	4	8	4.666666666666667	3.055050463303893	0.6546536707079771	8	2	6
fam921	4	5	4	4.333333333333333	0.5773502691896258	0.13323467750529827	5	4	1
fam922	2	6	6	4.666666666666667	2.309401076758503	0.49487165930539345	6	2	4
fam923	4	3	6	4.333333333333333	1.5275252316519465	0.3525058226889108	6	3	3
fam924	2	3	9	4.666666666666667	3.7859388972001824	0.8112726208286105	9	2	7
fam925	4	5	4	4.333333333333333	0.5773502691896258	0.13323467750529827	5	4	1
fam926	2	9	3	4.666666666666667	3.7859388972001824	0.8112726208286105	9	2	7
fam927	2	8	4	4.666666666666667	3.0550504633038935	0.6546536707079771	8	2	6
fam928	2	7	5	4.666666666666667	2.516611478423583	0.5392738882336249	7	2	5
fam929	2	6	6	4.666666666666667	2.309401076758503	0.49487165930539345	6	2	4
fam930	3	9	2	4.666666666666667	3.7859388972001824	0.8112726208286105	9	2	7
fam931	2	9	3	4.666666666666667	3.7859388972001824	0.8112726208286105	9	2	7
fam932	5	4	4	4.333333333333333	0.5773502691896258	0.13323467750529827	5	4	1
fam933	4	4	5	4.333333333333333	0.5773502691896258	0.13323467750529827	5	4	1
fam934	3	9	2	4.666666666666667	3.7859388972001824	0.8112726208286105	9	2	7
fam935	2	3	9	4.666666666666667	3.7859388972001824	0.8112726208286105	9	2	7
fam936	3	9	2	4.666666666666667	3.7859388972001824	0.8112726208286105	9	2	7
fam937	8	4	2	4.666666666666667	3.055050463303893	0.6546536707079771	8	2	6
fam938	6	4	3	4.333333333333333	1.5275252316519465	0.3525058226889108	6	3	3
fam939	4	4	5	4.333333333333333	0.5773502691896258	0.13323467750529827	5	4	1
fam940	2	6	5	4.333333333333333	2.0816659994661326	0.4803844614152614	6	2	4
fam941	3	4	6	4.333333333333333	1.5275252316519465	0.3525058226889108	6	3	3
fam942	2	5	7	4.666666666666667	2.516611478423583	0.5392738882336249	7	2	5
fam943	2	7	5	4.666666666666667	2.516611478423583	0.5392738882336249	7	2	5
fam944	3	5	5	4.333333333333333	1.1547005383792517	0.26646935501059654	5	3	2
fam945	2	10	2	4.666666666666667	4.618802153517007	0.9897433186107871	10	2	8
fam946	2	10	2	4.666666666666667	4.618802153517007	0.9897433186107871	10	2	8
fam947	2	10	2	4.666666666666667	4.618802153517007	0.9897433186107871	10	2	8
fam948	2	9	3	4.666666666666667	3.7859388972001824	0.8112726208286105	9	2	7
fam949	3	5	5	4.333333333333333	1.1547005383792517	0.26646935501059654	5	3	2
fam950	2	10	2	4.666666666666667	4.618802153517007	0.9897433186107871	10	2	8
fam951	3	9	2	4.666666666666667	3.7859388972001824	0.8112726208286105	9	2	7
fam952	3	6	4	4.333333333333333	1.5275252316519465	0.3525058226889108	6	3	3
fam953	2	5	7	4.666666666666667	2.516611478423583	0.5392738882336249	7	2	5
fam954	2	7	5	4.666666666666667	2.516611478423583	0.5392738882336249	7	2	5
fam955	2	5	6	4.333333333333333	2.0816659994661326	0.4803844614152614	6	2	4
fam956	2	9	3	4.666666666666667	3.7859388972001824	0.8112726208286105	9	2	7
fam957	2	6	6	4.666666666666667	2.309401076758503	0.49487165930539345	6	2	4
fam958	5	4	4	4.333333333333333	0.5773502691896258	0.13323467750529827	5	4	1
fam959	2	7	4	4.333333333333333	2.516611478423583	0.5807564950208269	7	2	5
fam960	4	5	4	4.333333333333333	0.5773502691896258	0.13323467750529827	5	4	1
fam961	4	4	5	4.333333333333333	0.5773502691896258	0.13323467750529827	5	4	1
fam962	2	5	6	4.333333333333333	2.0816659994661326	0.4803844614152614	6	2	4
fam963	3	6	4	4.333333333333333	1.5275252316519465	0.3525058226889108	6	3	3
fam964	2	5	6	4.333333333333333	2.0816659994661326	0.4803844614152614	6	2	4
fam965	5	6	2	4.333333333333333	2.0816659994661326	0.4803844614152614	6	2	4
fam966	3	5	5	4.333333333333333	1.1547005383792517	0.26646935501059654	5	3	2
fam967	4	4	5	4.333333333333333	0.5773502691896258	0.13323467750529827	5	4	1
fam968	2	11	2	5.0	5.196152422706632	1.0392304845413265	11	2	9
fam969	2	10	2	4.666666666666667	4.618802153517007	0.9897433186107871	10	2	8
fam970	2	11	2	5.0	5.196152422706632	1.0392304845413265	11	2	9
fam971	2	11	2	5.0	5.196152422706632	1.0392304845413265	11	2	9
fam972	2	7	4	4.333333333333333	2.516611478423583	0.5807564950208269	7	2	5
fam973	2	7	4	4.333333333333333	2.516611478423583	0.5807564950208269	7	2	5
fam974	2	7	4	4.333333333333333	2.516611478423583	0.5807564950208269	7	2	5
fam975	4	5	4	4.333333333333333	0.5773502691896258	0.13323467750529827	5	4	1
fam976	2	5	7	4.666666666666667	2.516611478423583	0.5392738882336249	7	2	5
fam977	2	9	2	4.333333333333333	4.041451884327381	0.9326427425370879	9	2	7
fam978	2	7	5	4.666666666666667	2.516611478423583	0.5392738882336249	7	2	5
fam979	2	8	4	4.666666666666667	3.0550504633038935	0.6546536707079771	8	2	6
fam980	4	5	4	4.333333333333333	0.5773502691896258	0.13323467750529827	5	4	1
fam981	2	6	6	4.666666666666667	2.309401076758503	0.49487165930539345	6	2	4
fam982	2	6	6	4.666666666666667	2.309401076758503	0.49487165930539345	6	2	4
fam983	2	8	4	4.666666666666667	3.0550504633038935	0.6546536707079771	8	2	6
fam984	5	6	2	4.333333333333333	2.0816659994661326	0.4803844614152614	6	2	4
fam985	2	7	5	4.666666666666667	2.516611478423583	0.5392738882336249	7	2	5
fam986	2	5	6	4.333333333333333	2.0816659994661326	0.4803844614152614	6	2	4
fam987	2	7	5	4.666666666666667	2.516611478423583	0.5392738882336249	7	2	5
fam988	2	4	8	4.666666666666667	3.055050463303893	0.6546536707079771	8	2	6
fam989	2	6	6	4.666666666666667	2.309401076758503	0.49487165930539345	6	2	4
fam990	2	5	7	4.666666666666667	2.516611478423583	0.5392738882336249	7	2	5
fam991	2	2	10	4.666666666666667	4.618802153517007	0.9897433186107871	10	2	8
fam992	4	5	4	4.333333333333333	0.5773502691896258	0.13323467750529827	5	4	1
fam993	2	5	6	4.333333333333333	2.0816659994661326	0.4803844614152614	6	2	4
fam994	2	6	6	4.666666666666667	2.309401076758503	0.49487165930539345	6	2	4
fam995	2	7	5	4.666666666666667	2.516611478423583	0.5392738882336249	7	2	5
fam996	5	4	4	4.333333333333333	0.5773502691896258	0.13323467750529827	5	4	1
fam997	4	4	4	4.0	0.0	0.0	4	4	0
fam998	4	4	4	4.0	0.0	0.0	4	4	0
fam999	4	4	4	4.0	0.0	0.0	4	4	0
fam1000	4	4	4	4.0	0.0	0.0	4	4	0
fam1001	4	4	4	4.0	0.0	0.0	4	4	0
fam1002	4	4	4	4.0	0.0	0.0	4	4	0
fam1003	4	4	4	4.0	0.0	0.0	4	4	0
fam1004	4	4	4	4.0	0.0	0.0	4	4	0
fam1005	4	4	4	4.0	0.0	0.0	4	4	0
fam1006	4	4	4	4.0	0.0	0.0	4	4	0
fam1007	4	4	4	4.0	0.0	0.0	4	4	0
fam1008	4	4	4	4.0	0.0	0.0	4	4	0
fam1009	4	4	4	4.0	0.0	0.0	4	4	0
fam1010	4	4	4	4.0	0.0	0.0	4	4	0
fam1011	4	4	4	4.0	0.0	0.0	4	4	0
fam1012	4	4	4	4.0	0.0	0.0	4	4	0
fam1013	4	4	4	4.0	0.0	0.0	4	4	0
fam1014	4	4	4	4.0	0.0	0.0	4	4	0
fam1015	4	4	4	4.0	0.0	0.0	4	4	0
fam1016	4	4	4	4.0	0.0	0.0	4	4	0
fam1017	3	4	5	4.0	1.0	0.25	5	3	2
fam1018	3	5	4	4.0	1.0	0.25	5	3	2
fam1019	2	5	5	4.0	1.7320508075688772	0.4330127018922193	5	2	3
fam1020	5	5	2	4.0	1.7320508075688772	0.4330127018922193	5	2	3
fam1021	3	5	4	4.0	1.0	0.25	5	3	2
fam1022	3	4	5	4.0	1.0	0.25	5	3	2
fam1023	5	5	2	4.0	1.7320508075688772	0.4330127018922193	5	2	3
fam1024	2	5	5	4.0	1.7320508075688772	0.4330127018922193	5	2	3
fam1025	2	5	5	4.0	1.7320508075688772	0.4330127018922193	5	2	3
fam1026	3	4	5	4.0	1.0	0.25	5	3	2
fam1027	5	2	5	4.0	1.7320508075688772	0.4330127018922193	5	2	3
fam1028	3	4	5	4.0	1.0	0.25	5	3	2
fam1029	3	5	4	4.0	1.0	0.25	5	3	2
fam1030	5	3	4	4.0	1.0	0.25	5	3	2
fam1031	3	5	4	4.0	1.0	0.25	5	3	2
fam1032	4	5	3	4.0	1.0	0.25	5	3	2
fam1033	4	3	5	4.0	1.0	0.25	5	3	2
fam1034	3	4	5	4.0	1.0	0.25	5	3	2
fam1035	4	5	3	4.0	1.0	0.25	5	3	2
fam1036	2	5	5	4.0	1.7320508075688772	0.4330127018922193	5	2	3
fam1037	3	5	4	4.0	1.0	0.25	5	3	2
fam1038	3	5	4	4.0	1.0	0.25	5	3	2
fam1039	3	5	4	4.0	1.0	0.25	5	3	2
fam1040	4	5	3	4.0	1.0	0.25	5	3	2
fam1041	3	5	4	4.0	1.0	0.25	5	3	2
fam1042	5	3	4	4.0	1.0	0.25	5	3	2
fam1043	2	5	5	4.0	1.7320508075688772	0.4330127018922193	5	2	3
fam1044	2	5	5	4.0	1.7320508075688772	0.4330127018922193	5	2	3
fam1045	2	5	5	4.0	1.7320508075688772	0.4330127018922193	5	2	3
fam1046	5	4	3	4.0	1.0	0.25	5	3	2
fam1047	2	5	5	4.0	1.7320508075688772	0.4330127018922193	5	2	3
fam1048	4	3	5	4.0	1.0	0.25	5	3	2
fam1049	3	4	5	4.0	1.0	0.25	5	3	2
fam1050	5	4	3	4.0	1.0	0.25	5	3	2
fam1051	3	5	4	4.0	1.0	0.25	5	3	2
fam1052	3	4	5	4.0	1.0	0.25	5	3	2
fam1053	5	3	4	4.0	1.0	0.25	5	3	2
fam1054	2	5	5	4.0	1.7320508075688772	0.4330127018922193	5	2	3
fam1055	3	5	4	4.0	1.0	0.25	5	3	2
fam1056	2	5	5	4.0	1.7320508075688772	0.4330127018922193	5	2	3
fam1057	4	5	3	4.0	1.0	0.25	5	3	2
fam1058	3	5	4	4.0	1.0	0.25	5	3	2
fam1059	5	6	2	4.333333333333333	2.0816659994661326	0.4803844614152614	6	2	4
fam1060	2	6	4	4.0	2.0	0.5	6	2	4
fam1061	3	6	3	4.0	1.7320508075688772	0.4330127018922193	6	3	3
fam1062	2	4	6	4.0	2.0	0.5	6	2	4
fam1063	2	5	6	4.333333333333333	2.0816659994661326	0.4803844614152614	6	2	4
fam1064	2	6	5	4.333333333333333	2.0816659994661326	0.4803844614152614	6	2	4
fam1065	2	6	5	4.333333333333333	2.0816659994661326	0.4803844614152614	6	2	4
fam1066	2	6	4	4.0	2.0	0.5	6	2	4
fam1067	3	6	3	4.0	1.7320508075688772	0.4330127018922193	6	3	3
fam1068	6	3	3	4.0	1.7320508075688772	0.4330127018922193	6	3	3
fam1069	4	6	2	4.0	2.0	0.5	6	2	4
fam1070	2	6	5	4.333333333333333	2.0816659994661326	0.4803844614152614	6	2	4
fam1071	5	6	2	4.333333333333333	2.0816659994661326	0.4803844614152614	6	2	4
fam1072	3	6	3	4.0	1.7320508075688772	0.4330127018922193	6	3	3
fam1073	2	6	5	4.333333333333333	2.0816659994661326	0.4803844614152614	6	2	4
fam1074	6	2	4	4.0	2.0	0.5	6	2	4
fam1075	2	4	6	4.0	2.0	0.5	6	2	4
fam1076	2	6	5	4.333333333333333	2.0816659994661326	0.4803844614152614	6	2	4
fam1077	2	5	6	4.333333333333333	2.0816659994661326	0.4803844614152614	6	2	4
fam1078	6	2	5	4.333333333333333	2.0816659994661326	0.4803844614152614	6	2	4
fam1079	3	6	3	4.0	1.7320508075688772	0.4330127018922193	6	3	3
fam1080	6	3	3	4.0	1.7320508075688772	0.4330127018922193	6	3	3
fam1081	2	6	5	4.333333333333333	2.0816659994661326	0.4803844614152614	6	2	4
fam1082	2	6	4	4.0	2.0	0.5	6	2	4
fam1083	4	6	2	4.0	2.0	0.5	6	2	4
fam1084	2	5	6	4.333333333333333	2.0816659994661326	0.4803844614152614	6	2	4
fam1085	2	6	5	4.333333333333333	2.0816659994661326	0.4803844614152614	6	2	4
fam1086	4	6	2	4.0	2.0	0.5	6	2	4
fam1087	2	5	6	4.333333333333333	2.0816659994661326	0.4803844614152614	6	2	4
fam1088	4	2	6	4.0	2.0	0.5	6	2	4
fam1089	5	6	2	4.333333333333333	2.0816659994661326	0.4803844614152614	6	2	4
fam1090	3	6	3	4.0	1.7320508075688772	0.4330127018922193	6	3	3
fam1091	2	5	6	4.333333333333333	2.0816659994661326	0.4803844614152614	6	2	4
fam1092	3	3	6	4.0	1.7320508075688772	0.4330127018922193	6	3	3
fam1093	2	6	5	4.333333333333333	2.0816659994661326	0.4803844614152614	6	2	4
fam1094	6	4	2	4.0	2.0	0.5	6	2	4
fam1095	2	6	5	4.333333333333333	2.0816659994661326	0.4803844614152614	6	2	4
fam1096	2	6	5	4.333333333333333	2.0816659994661326	0.4803844614152614	6	2	4
fam1097	2	6	4	4.0	2.0	0.5	6	2	4
fam1098	2	6	5	4.333333333333333	2.0816659994661326	0.4803844614152614	6	2	4
fam1099	2	6	5	4.333333333333333	2.0816659994661326	0.4803844614152614	6	2	4
fam1100	5	6	2	4.333333333333333	2.0816659994661326	0.4803844614152614	6	2	4
fam1101	2	6	5	4.333333333333333	2.0816659994661326	0.4803844614152614	6	2	4
fam1102	2	6	5	4.333333333333333	2.0816659994661326	0.4803844614152614	6	2	4
fam1103	2	6	4	4.0	2.0	0.5	6	2	4
fam1104	2	6	5	4.333333333333333	2.0816659994661326	0.4803844614152614	6	2	4
fam1105	2	6	5	4.333333333333333	2.0816659994661326	0.4803844614152614	6	2	4
fam1106	4	6	2	4.0	2.0	0.5	6	2	4
fam1107	6	3	3	4.0	1.7320508075688772	0.4330127018922193	6	3	3
fam1108	6	4	2	4.0	2.0	0.5	6	2	4
fam1109	2	6	4	4.0	2.0	0.5	6	2	4
fam1110	4	6	2	4.0	2.0	0.5	6	2	4
fam1111	5	6	2	4.333333333333333	2.0816659994661326	0.4803844614152614	6	2	4
fam1112	3	6	3	4.0	1.7320508075688772	0.4330127018922193	6	3	3
fam1113	2	5	6	4.333333333333333	2.0816659994661326	0.4803844614152614	6	2	4
fam1114	2	6	5	4.333333333333333	2.0816659994661326	0.4803844614152614	6	2	4
fam1115	2	6	5	4.333333333333333	2.0816659994661326	0.4803844614152614	6	2	4
fam1116	2	6	5	4.333333333333333	2.0816659994661326	0.4803844614152614	6	2	4
fam1117	5	2	6	4.333333333333333	2.0816659994661326	0.4803844614152614	6	2	4
fam1118	2	6	5	4.333333333333333	2.0816659994661326	0.4803844614152614	6	2	4
fam1119	2	6	5	4.333333333333333	2.0816659994661326	0.4803844614152614	6	2	4
fam1120	3	3	6	4.0	1.7320508075688772	0.4330127018922193	6	3	3
fam1121	6	5	2	4.333333333333333	2.0816659994661326	0.4803844614152614	6	2	4
fam1122	4	5	3	4.0	1.0	0.25	5	3	2
fam1123	2	7	4	4.333333333333333	2.516611478423583	0.5807564950208269	7	2	5
fam1124	2	7	4	4.333333333333333	2.516611478423583	0.5807564950208269	7	2	5
fam1125	2	4	7	4.333333333333333	2.516611478423583	0.5807564950208269	7	2	5
fam1126	2	7	4	4.333333333333333	2.516611478423583	0.5807564950208269	7	2	5
fam1127	7	2	3	4.0	2.6457513110645907	0.6614378277661477	7	2	5
fam1128	2	4	7	4.333333333333333	2.516611478423583	0.5807564950208269	7	2	5
fam1129	2	7	4	4.333333333333333	2.516611478423583	0.5807564950208269	7	2	5
fam1130	2	4	7	4.333333333333333	2.516611478423583	0.5807564950208269	7	2	5
fam1131	7	4	2	4.333333333333333	2.516611478423583	0.5807564950208269	7	2	5
fam1132	2	7	4	4.333333333333333	2.516611478423583	0.5807564950208269	7	2	5
fam1133	2	4	7	4.333333333333333	2.516611478423583	0.5807564950208269	7	2	5
fam1134	4	2	7	4.333333333333333	2.516611478423583	0.5807564950208269	7	2	5
fam1135	2	7	4	4.333333333333333	2.516611478423583	0.5807564950208269	7	2	5
fam1136	2	4	7	4.333333333333333	2.516611478423583	0.5807564950208269	7	2	5
fam1137	2	4	7	4.333333333333333	2.516611478423583	0.5807564950208269	7	2	5
fam1138	3	7	2	4.0	2.6457513110645907	0.6614378277661477	7	2	5
fam1139	2	4	7	4.333333333333333	2.516611478423583	0.5807564950208269	7	2	5
fam1140	2	6	5	4.333333333333333	2.0816659994661326	0.4803844614152614	6	2	4
fam1141	4	2	7	4.333333333333333	2.516611478423583	0.5807564950208269	7	2	5
fam1142	2	7	3	4.0	2.6457513110645907	0.6614378277661477	7	2	5
fam1143	2	7	4	4.333333333333333	2.516611478423583	0.5807564950208269	7	2	5
fam1144	2	7	4	4.333333333333333	2.516611478423583	0.5807564950208269	7	2	5
fam1145	4	7	2	4.333333333333333	2.516611478423583	0.5807564950208269	7	2	5
fam1146	2	4	7	4.333333333333333	2.516611478423583	0.5807564950208269	7	2	5
fam1147	2	7	3	4.0	2.6457513110645907	0.6614378277661477	7	2	5
fam1148	2	7	3	4.0	2.6457513110645907	0.6614378277661477	7	2	5
fam1149	2	4	7	4.333333333333333	2.516611478423583	0.5807564950208269	7	2	5
fam1150	2	4	6	4.0	2.0	0.5	6	2	4
fam1151	3	5	4	4.0	1.0	0.25	5	3	2
fam1152	4	4	4	4.0	0.0	0.0	4	4	0
fam1153	2	6	5	4.333333333333333	2.0816659994661326	0.4803844614152614	6	2	4
fam1154	2	6	5	4.333333333333333	2.0816659994661326	0.4803844614152614	6	2	4
fam1155	2	6	5	4.333333333333333	2.0816659994661326	0.4803844614152614	6	2	4
fam1156	2	6	4	4.0	2.0	0.5	6	2	4
fam1157	2	5	5	4.0	1.7320508075688772	0.4330127018922193	5	2	3
fam1158	2	6	4	4.0	2.0	0.5	6	2	4
fam1159	2	6	5	4.333333333333333	2.0816659994661326	0.4803844614152614	6	2	4
fam1160	2	3	8	4.333333333333333	3.214550253664318	0.7418192893071504	8	2	6
fam1161	2	8	3	4.333333333333333	3.2145502536643185	0.7418192893071505	8	2	6
fam1162	2	8	3	4.333333333333333	3.2145502536643185	0.7418192893071505	8	2	6
fam1163	2	8	2	4.0	3.4641016151377544	0.8660254037844386	8	2	6
fam1164	2	3	8	4.333333333333333	3.214550253664318	0.7418192893071504	8	2	6
fam1165	2	8	3	4.333333333333333	3.2145502536643185	0.7418192893071505	8	2	6
fam1166	4	4	4	4.0	0.0	0.0	4	4	0
fam1167	2	8	3	4.333333333333333	3.2145502536643185	0.7418192893071505	8	2	6
fam1168	2	8	2	4.0	3.4641016151377544	0.8660254037844386	8	2	6
fam1169	2	8	2	4.0	3.4641016151377544	0.8660254037844386	8	2	6
fam1170	2	8	3	4.333333333333333	3.2145502536643185	0.7418192893071505	8	2	6
fam1171	2	3	8	4.333333333333333	3.214550253664318	0.7418192893071504	8	2	6
fam1172	2	8	2	4.0	3.4641016151377544	0.8660254037844386	8	2	6
fam1173	3	8	2	4.333333333333333	3.214550253664318	0.7418192893071504	8	2	6
fam1174	2	8	3	4.333333333333333	3.2145502536643185	0.7418192893071505	8	2	6
fam1175	2	8	3	4.333333333333333	3.2145502536643185	0.7418192893071505	8	2	6
fam1176	2	8	3	4.333333333333333	3.2145502536643185	0.7418192893071505	8	2	6
fam1177	2	8	2	4.0	3.4641016151377544	0.8660254037844386	8	2	6
fam1178	2	7	4	4.333333333333333	2.516611478423583	0.5807564950208269	7	2	5
fam1179	2	7	4	4.333333333333333	2.516611478423583	0.5807564950208269	7	2	5
fam1180	4	6	2	4.0	2.0	0.5	6	2	4
fam1181	5	4	3	4.0	1.0	0.25	5	3	2
fam1182	5	6	2	4.333333333333333	2.0816659994661326	0.4803844614152614	6	2	4
fam1183	2	6	4	4.0	2.0	0.5	6	2	4
fam1184	4	5	3	4.0	1.0	0.25	5	3	2
fam1185	3	5	4	4.0	1.0	0.25	5	3	2
fam1186	2	5	6	4.333333333333333	2.0816659994661326	0.4803844614152614	6	2	4
fam1187	2	6	5	4.333333333333333	2.0816659994661326	0.4803844614152614	6	2	4
fam1188	2	6	4	4.0	2.0	0.5	6	2	4
fam1189	9	2	2	4.333333333333333	4.041451884327381	0.9326427425370879	9	2	7
fam1190	2	9	2	4.333333333333333	4.041451884327381	0.9326427425370879	9	2	7
fam1191	3	5	4	4.0	1.0	0.25	5	3	2
fam1192	2	2	9	4.333333333333333	4.041451884327381	0.9326427425370879	9	2	7
fam1193	2	9	2	4.333333333333333	4.041451884327381	0.9326427425370879	9	2	7
fam1194	2	9	2	4.333333333333333	4.041451884327381	0.9326427425370879	9	2	7
fam1195	2	9	2	4.333333333333333	4.041451884327381	0.9326427425370879	9	2	7
fam1196	4	5	3	4.0	1.0	0.25	5	3	2
fam1197	2	2	9	4.333333333333333	4.041451884327381	0.9326427425370879	9	2	7
fam1198	2	9	2	4.333333333333333	4.041451884327381	0.9326427425370879	9	2	7
fam1199	2	5	6	4.333333333333333	2.0816659994661326	0.4803844614152614	6	2	4
fam1200	3	4	5	4.0	1.0	0.25	5	3	2
fam1201	2	7	4	4.333333333333333	2.516611478423583	0.5807564950208269	7	2	5
fam1202	2	5	6	4.333333333333333	2.0816659994661326	0.4803844614152614	6	2	4
fam1203	4	6	2	4.0	2.0	0.5	6	2	4
fam1204	5	3	4	4.0	1.0	0.25	5	3	2
fam1205	3	3	6	4.0	1.7320508075688772	0.4330127018922193	6	3	3
fam1206	3	6	3	4.0	1.7320508075688772	0.4330127018922193	6	3	3
fam1207	4	4	4	4.0	0.0	0.0	4	4	0
fam1208	2	4	7	4.333333333333333	2.516611478423583	0.5807564950208269	7	2	5
fam1209	2	7	4	4.333333333333333	2.516611478423583	0.5807564950208269	7	2	5
fam1210	2	5	5	4.0	1.7320508075688772	0.4330127018922193	5	2	3
fam1211	4	4	4	4.0	0.0	0.0	4	4	0
fam1212	2	10	2	4.666666666666667	4.618802153517007	0.9897433186107871	10	2	8
fam1213	2	10	2	4.666666666666667	4.618802153517007	0.9897433186107871	10	2	8
fam1214	2	5	5	4.0	1.7320508075688772	0.4330127018922193	5	2	3
fam1215	2	10	2	4.666666666666667	4.618802153517007	0.9897433186107871	10	2	8
fam1216	2	10	2	4.666666666666667	4.618802153517007	0.9897433186107871	10	2	8
fam1217	2	10	2	4.666666666666667	4.618802153517007	0.9897433186107871	10	2	8
fam1218	2	10	2	4.666666666666667	4.618802153517007	0.9897433186107871	10	2	8
fam1219	2	10	2	4.666666666666667	4.618802153517007	0.9897433186107871	10	2	8
fam1220	2	10	2	4.666666666666667	4.618802153517007	0.9897433186107871	10	2	8
fam1221	2	10	2	4.666666666666667	4.618802153517007	0.9897433186107871	10	2	8
fam1222	2	10	2	4.666666666666667	4.618802153517007	0.9897433186107871	10	2	8
fam1223	2	9	2	4.333333333333333	4.041451884327381	0.9326427425370879	9	2	7
fam1224	2	6	4	4.0	2.0	0.5	6	2	4
fam1225	2	10	2	4.666666666666667	4.618802153517007	0.9897433186107871	10	2	8
fam1226	2	10	2	4.666666666666667	4.618802153517007	0.9897433186107871	10	2	8
fam1227	2	10	2	4.666666666666667	4.618802153517007	0.9897433186107871	10	2	8
fam1228	2	10	2	4.666666666666667	4.618802153517007	0.9897433186107871	10	2	8
fam1229	2	5	5	4.0	1.7320508075688772	0.4330127018922193	5	2	3
fam1230	2	2	10	4.666666666666667	4.618802153517007	0.9897433186107871	10	2	8
fam1231	3	5	4	4.0	1.0	0.25	5	3	2
fam1232	4	7	2	4.333333333333333	2.516611478423583	0.5807564950208269	7	2	5
fam1233	2	7	3	4.0	2.6457513110645907	0.6614378277661477	7	2	5
fam1234	2	7	4	4.333333333333333	2.516611478423583	0.5807564950208269	7	2	5
fam1235	3	5	4	4.0	1.0	0.25	5	3	2
fam1236	2	7	4	4.333333333333333	2.516611478423583	0.5807564950208269	7	2	5
fam1237	2	7	4	4.333333333333333	2.516611478423583	0.5807564950208269	7	2	5
fam1238	2	5	5	4.0	1.7320508075688772	0.4330127018922193	5	2	3
fam1239	3	7	2	4.0	2.6457513110645907	0.6614378277661477	7	2	5
fam1240	3	7	2	4.0	2.6457513110645907	0.6614378277661477	7	2	5
fam1241	4	6	2	4.0	2.0	0.5	6	2	4
fam1242	4	3	4	3.6666666666666665	0.5773502691896258	0.15745916432444343	4	3	1
fam1243	3	4	4	3.6666666666666665	0.5773502691896258	0.15745916432444343	4	3	1
fam1244	3	4	4	3.6666666666666665	0.5773502691896258	0.15745916432444343	4	3	1
fam1245	3	4	4	3.6666666666666665	0.5773502691896258	0.15745916432444343	4	3	1
fam1246	3	4	4	3.6666666666666665	0.5773502691896258	0.15745916432444343	4	3	1
fam1247	4	4	3	3.6666666666666665	0.5773502691896258	0.15745916432444343	4	3	1
fam1248	3	4	4	3.6666666666666665	0.5773502691896258	0.15745916432444343	4	3	1
fam1249	3	4	4	3.6666666666666665	0.5773502691896258	0.15745916432444343	4	3	1
fam1250	3	4	4	3.6666666666666665	0.5773502691896258	0.15745916432444343	4	3	1
fam1251	4	4	3	3.6666666666666665	0.5773502691896258	0.15745916432444343	4	3	1
fam1252	4	4	3	3.6666666666666665	0.5773502691896258	0.15745916432444343	4	3	1
fam1253	3	4	4	3.6666666666666665	0.5773502691896258	0.15745916432444343	4	3	1
fam1254	4	4	3	3.6666666666666665	0.5773502691896258	0.15745916432444343	4	3	1
fam1255	3	4	4	3.6666666666666665	0.5773502691896258	0.15745916432444343	4	3	1
fam1256	3	4	4	3.6666666666666665	0.5773502691896258	0.15745916432444343	4	3	1
fam1257	4	4	3	3.6666666666666665	0.5773502691896258	0.15745916432444343	4	3	1
fam1258	3	4	4	3.6666666666666665	0.5773502691896258	0.15745916432444343	4	3	1
fam1259	4	4	3	3.6666666666666665	0.5773502691896258	0.15745916432444343	4	3	1
fam1260	4	3	4	3.6666666666666665	0.5773502691896258	0.15745916432444343	4	3	1
fam1261	3	4	4	3.6666666666666665	0.5773502691896258	0.15745916432444343	4	3	1
fam1262	3	4	4	3.6666666666666665	0.5773502691896258	0.15745916432444343	4	3	1
fam1263	4	4	3	3.6666666666666665	0.5773502691896258	0.15745916432444343	4	3	1
fam1264	3	4	4	3.6666666666666665	0.5773502691896258	0.15745916432444343	4	3	1
fam1265	3	4	4	3.6666666666666665	0.5773502691896258	0.15745916432444343	4	3	1
fam1266	3	4	4	3.6666666666666665	0.5773502691896258	0.15745916432444343	4	3	1
fam1267	3	4	4	3.6666666666666665	0.5773502691896258	0.15745916432444343	4	3	1
fam1268	3	4	4	3.6666666666666665	0.5773502691896258	0.15745916432444343	4	3	1
fam1269	4	4	3	3.6666666666666665	0.5773502691896258	0.15745916432444343	4	3	1
fam1270	3	4	4	3.6666666666666665	0.5773502691896258	0.15745916432444343	4	3	1
fam1271	3	4	4	3.6666666666666665	0.5773502691896258	0.15745916432444343	4	3	1
fam1272	3	4	4	3.6666666666666665	0.5773502691896258	0.15745916432444343	4	3	1
fam1273	3	4	4	3.6666666666666665	0.5773502691896258	0.15745916432444343	4	3	1
fam1274	4	4	3	3.6666666666666665	0.5773502691896258	0.15745916432444343	4	3	1
fam1275	3	4	4	3.6666666666666665	0.5773502691896258	0.15745916432444343	4	3	1
fam1276	3	4	4	3.6666666666666665	0.5773502691896258	0.15745916432444343	4	3	1
fam1277	3	4	4	3.6666666666666665	0.5773502691896258	0.15745916432444343	4	3	1
fam1278	4	4	3	3.6666666666666665	0.5773502691896258	0.15745916432444343	4	3	1
fam1279	3	4	4	3.6666666666666665	0.5773502691896258	0.15745916432444343	4	3	1
fam1280	2	4	5	3.6666666666666665	1.5275252316519465	0.4165977904505309	5	2	3
fam1281	3	3	5	3.6666666666666665	1.1547005383792515	0.3149183286488868	5	3	2
fam1282	4	5	2	3.6666666666666665	1.5275252316519465	0.4165977904505309	5	2	3
fam1283	3	5	3	3.6666666666666665	1.1547005383792515	0.3149183286488868	5	3	2
fam1284	2	5	4	3.6666666666666665	1.5275252316519468	0.41659779045053097	5	2	3
fam1285	2	4	5	3.6666666666666665	1.5275252316519465	0.4165977904505309	5	2	3
fam1286	2	5	5	4.0	1.7320508075688772	0.4330127018922193	5	2	3
fam1287	3	3	5	3.6666666666666665	1.1547005383792515	0.3149183286488868	5	3	2
fam1288	2	5	5	4.0	1.7320508075688772	0.4330127018922193	5	2	3
fam1289	2	5	4	3.6666666666666665	1.5275252316519468	0.41659779045053097	5	2	3
fam1290	2	5	5	4.0	1.7320508075688772	0.4330127018922193	5	2	3
fam1291	2	5	5	4.0	1.7320508075688772	0.4330127018922193	5	2	3
fam1292	2	5	5	4.0	1.7320508075688772	0.4330127018922193	5	2	3
fam1293	2	5	5	4.0	1.7320508075688772	0.4330127018922193	5	2	3
fam1294	2	5	5	4.0	1.7320508075688772	0.4330127018922193	5	2	3
fam1295	5	2	5	4.0	1.7320508075688772	0.4330127018922193	5	2	3
fam1296	3	5	3	3.6666666666666665	1.1547005383792515	0.3149183286488868	5	3	2
fam1297	2	5	5	4.0	1.7320508075688772	0.4330127018922193	5	2	3
fam1298	2	5	5	4.0	1.7320508075688772	0.4330127018922193	5	2	3
fam1299	2	5	4	3.6666666666666665	1.5275252316519468	0.41659779045053097	5	2	3
fam1300	3	5	3	3.6666666666666665	1.1547005383792515	0.3149183286488868	5	3	2
fam1301	2	5	5	4.0	1.7320508075688772	0.4330127018922193	5	2	3
fam1302	5	4	2	3.6666666666666665	1.5275252316519465	0.4165977904505309	5	2	3
fam1303	5	3	3	3.6666666666666665	1.1547005383792515	0.3149183286488868	5	3	2
fam1304	4	2	5	3.6666666666666665	1.5275252316519465	0.4165977904505309	5	2	3
fam1305	3	3	5	3.6666666666666665	1.1547005383792515	0.3149183286488868	5	3	2
fam1306	3	5	3	3.6666666666666665	1.1547005383792515	0.3149183286488868	5	3	2
fam1307	4	5	2	3.6666666666666665	1.5275252316519465	0.4165977904505309	5	2	3
fam1308	2	5	5	4.0	1.7320508075688772	0.4330127018922193	5	2	3
fam1309	2	5	5	4.0	1.7320508075688772	0.4330127018922193	5	2	3
fam1310	2	5	5	4.0	1.7320508075688772	0.4330127018922193	5	2	3
fam1311	4	5	2	3.6666666666666665	1.5275252316519465	0.4165977904505309	5	2	3
fam1312	2	5	5	4.0	1.7320508075688772	0.4330127018922193	5	2	3
fam1313	2	5	5	4.0	1.7320508075688772	0.4330127018922193	5	2	3
fam1314	4	5	2	3.6666666666666665	1.5275252316519465	0.4165977904505309	5	2	3
fam1315	2	5	5	4.0	1.7320508075688772	0.4330127018922193	5	2	3
fam1316	4	5	2	3.6666666666666665	1.5275252316519465	0.4165977904505309	5	2	3
fam1317	2	5	4	3.6666666666666665	1.5275252316519468	0.41659779045053097	5	2	3
fam1318	2	5	4	3.6666666666666665	1.5275252316519468	0.41659779045053097	5	2	3
fam1319	2	5	4	3.6666666666666665	1.5275252316519468	0.41659779045053097	5	2	3
fam1320	2	5	4	3.6666666666666665	1.5275252316519468	0.41659779045053097	5	2	3
fam1321	5	3	3	3.6666666666666665	1.1547005383792515	0.3149183286488868	5	3	2
fam1322	3	3	5	3.6666666666666665	1.1547005383792515	0.3149183286488868	5	3	2
fam1323	2	5	5	4.0	1.7320508075688772	0.4330127018922193	5	2	3
fam1324	3	5	3	3.6666666666666665	1.1547005383792515	0.3149183286488868	5	3	2
fam1325	2	5	4	3.6666666666666665	1.5275252316519468	0.41659779045053097	5	2	3
fam1326	2	5	5	4.0	1.7320508075688772	0.4330127018922193	5	2	3
fam1327	2	5	4	3.6666666666666665	1.5275252316519468	0.41659779045053097	5	2	3
fam1328	2	5	5	4.0	1.7320508075688772	0.4330127018922193	5	2	3
fam1329	2	4	5	3.6666666666666665	1.5275252316519465	0.4165977904505309	5	2	3
fam1330	2	5	5	4.0	1.7320508075688772	0.4330127018922193	5	2	3
fam1331	4	2	5	3.6666666666666665	1.5275252316519465	0.4165977904505309	5	2	3
fam1332	2	4	5	3.6666666666666665	1.5275252316519465	0.4165977904505309	5	2	3
fam1333	5	3	3	3.6666666666666665	1.1547005383792515	0.3149183286488868	5	3	2
fam1334	2	4	5	3.6666666666666665	1.5275252316519465	0.4165977904505309	5	2	3
fam1335	2	5	5	4.0	1.7320508075688772	0.4330127018922193	5	2	3
fam1336	4	5	2	3.6666666666666665	1.5275252316519465	0.4165977904505309	5	2	3
fam1337	2	4	5	3.6666666666666665	1.5275252316519465	0.4165977904505309	5	2	3
fam1338	2	4	5	3.6666666666666665	1.5275252316519465	0.4165977904505309	5	2	3
fam1339	3	3	5	3.6666666666666665	1.1547005383792515	0.3149183286488868	5	3	2
fam1340	5	5	2	4.0	1.7320508075688772	0.4330127018922193	5	2	3
fam1341	3	5	3	3.6666666666666665	1.1547005383792515	0.3149183286488868	5	3	2
fam1342	2	5	4	3.6666666666666665	1.5275252316519468	0.41659779045053097	5	2	3
fam1343	2	5	4	3.6666666666666665	1.5275252316519468	0.41659779045053097	5	2	3
fam1344	2	4	5	3.6666666666666665	1.5275252316519465	0.4165977904505309	5	2	3
fam1345	2	5	5	4.0	1.7320508075688772	0.4330127018922193	5	2	3
fam1346	2	5	5	4.0	1.7320508075688772	0.4330127018922193	5	2	3
fam1347	2	4	5	3.6666666666666665	1.5275252316519465	0.4165977904505309	5	2	3
fam1348	3	5	3	3.6666666666666665	1.1547005383792515	0.3149183286488868	5	3	2
fam1349	2	5	5	4.0	1.7320508075688772	0.4330127018922193	5	2	3
fam1350	4	2	5	3.6666666666666665	1.5275252316519465	0.4165977904505309	5	2	3
fam1351	2	5	5	4.0	1.7320508075688772	0.4330127018922193	5	2	3
fam1352	2	5	4	3.6666666666666665	1.5275252316519468	0.41659779045053097	5	2	3
fam1353	3	3	5	3.6666666666666665	1.1547005383792515	0.3149183286488868	5	3	2
fam1354	2	5	5	4.0	1.7320508075688772	0.4330127018922193	5	2	3
fam1355	2	5	5	4.0	1.7320508075688772	0.4330127018922193	5	2	3
fam1356	5	2	4	3.6666666666666665	1.5275252316519468	0.41659779045053097	5	2	3
fam1357	5	5	2	4.0	1.7320508075688772	0.4330127018922193	5	2	3
fam1358	2	5	5	4.0	1.7320508075688772	0.4330127018922193	5	2	3
fam1359	2	4	5	3.6666666666666665	1.5275252316519465	0.4165977904505309	5	2	3
fam1360	2	5	5	4.0	1.7320508075688772	0.4330127018922193	5	2	3
fam1361	2	5	5	4.0	1.7320508075688772	0.4330127018922193	5	2	3
fam1362	2	4	5	3.6666666666666665	1.5275252316519465	0.4165977904505309	5	2	3
fam1363	3	5	3	3.6666666666666665	1.1547005383792515	0.3149183286488868	5	3	2
fam1364	2	5	5	4.0	1.7320508075688772	0.4330127018922193	5	2	3
fam1365	2	4	5	3.6666666666666665	1.5275252316519465	0.4165977904505309	5	2	3
fam1366	5	4	2	3.6666666666666665	1.5275252316519465	0.4165977904505309	5	2	3
fam1367	2	6	4	4.0	2.0	0.5	6	2	4
fam1368	6	2	4	4.0	2.0	0.5	6	2	4
fam1369	2	6	4	4.0	2.0	0.5	6	2	4
fam1370	2	6	4	4.0	2.0	0.5	6	2	4
fam1371	2	6	4	4.0	2.0	0.5	6	2	4
fam1372	2	6	4	4.0	2.0	0.5	6	2	4
fam1373	2	3	6	3.6666666666666665	2.081665999466133	0.5677270907634908	6	2	4
fam1374	2	6	4	4.0	2.0	0.5	6	2	4
fam1375	2	4	6	4.0	2.0	0.5	6	2	4
fam1376	2	6	4	4.0	2.0	0.5	6	2	4
fam1377	2	4	6	4.0	2.0	0.5	6	2	4
fam1378	2	6	4	4.0	2.0	0.5	6	2	4
fam1379	2	4	6	4.0	2.0	0.5	6	2	4
fam1380	2	3	6	3.6666666666666665	2.081665999466133	0.5677270907634908	6	2	4
fam1381	2	3	6	3.6666666666666665	2.081665999466133	0.5677270907634908	6	2	4
fam1382	2	6	4	4.0	2.0	0.5	6	2	4
fam1383	6	4	2	4.0	2.0	0.5	6	2	4
fam1384	2	6	3	3.6666666666666665	2.081665999466133	0.5677270907634908	6	2	4
fam1385	2	3	6	3.6666666666666665	2.081665999466133	0.5677270907634908	6	2	4
fam1386	2	6	4	4.0	2.0	0.5	6	2	4
fam1387	2	5	5	4.0	1.7320508075688772	0.4330127018922193	5	2	3
fam1388	2	3	6	3.6666666666666665	2.081665999466133	0.5677270907634908	6	2	4
fam1389	2	6	4	4.0	2.0	0.5	6	2	4
fam1390	3	6	2	3.6666666666666665	2.081665999466133	0.5677270907634908	6	2	4
fam1391	2	6	4	4.0	2.0	0.5	6	2	4
fam1392	6	2	3	3.6666666666666665	2.081665999466133	0.5677270907634908	6	2	4
fam1393	6	3	2	3.6666666666666665	2.081665999466133	0.5677270907634908	6	2	4
fam1394	2	6	3	3.6666666666666665	2.081665999466133	0.5677270907634908	6	2	4
fam1395	3	2	6	3.6666666666666665	2.081665999466133	0.5677270907634908	6	2	4
fam1396	2	6	4	4.0	2.0	0.5	6	2	4
fam1397	2	6	4	4.0	2.0	0.5	6	2	4
fam1398	2	6	4	4.0	2.0	0.5	6	2	4
fam1399	2	6	4	4.0	2.0	0.5	6	2	4
fam1400	2	6	4	4.0	2.0	0.5	6	2	4
fam1401	2	6	3	3.6666666666666665	2.081665999466133	0.5677270907634908	6	2	4
fam1402	6	3	2	3.6666666666666665	2.081665999466133	0.5677270907634908	6	2	4
fam1403	2	6	4	4.0	2.0	0.5	6	2	4
fam1404	2	6	3	3.6666666666666665	2.081665999466133	0.5677270907634908	6	2	4
fam1405	2	6	4	4.0	2.0	0.5	6	2	4
fam1406	2	6	4	4.0	2.0	0.5	6	2	4
fam1407	2	6	4	4.0	2.0	0.5	6	2	4
fam1408	6	2	3	3.6666666666666665	2.081665999466133	0.5677270907634908	6	2	4
fam1409	2	6	4	4.0	2.0	0.5	6	2	4
fam1410	6	2	3	3.6666666666666665	2.081665999466133	0.5677270907634908	6	2	4
fam1411	2	6	4	4.0	2.0	0.5	6	2	4
fam1412	3	2	6	3.6666666666666665	2.081665999466133	0.5677270907634908	6	2	4
fam1413	2	3	6	3.6666666666666665	2.081665999466133	0.5677270907634908	6	2	4
fam1414	2	4	6	4.0	2.0	0.5	6	2	4
fam1415	2	6	4	4.0	2.0	0.5	6	2	4
fam1416	2	6	4	4.0	2.0	0.5	6	2	4
fam1417	2	6	4	4.0	2.0	0.5	6	2	4
fam1418	3	2	6	3.6666666666666665	2.081665999466133	0.5677270907634908	6	2	4
fam1419	2	6	4	4.0	2.0	0.5	6	2	4
fam1420	2	4	6	4.0	2.0	0.5	6	2	4
fam1421	2	4	5	3.6666666666666665	1.5275252316519465	0.4165977904505309	5	2	3
fam1422	3	3	5	3.6666666666666665	1.1547005383792515	0.3149183286488868	5	3	2
fam1423	2	7	3	4.0	2.6457513110645907	0.6614378277661477	7	2	5
fam1424	2	3	7	4.0	2.6457513110645907	0.6614378277661477	7	2	5
fam1425	2	7	3	4.0	2.6457513110645907	0.6614378277661477	7	2	5
fam1426	2	7	3	4.0	2.6457513110645907	0.6614378277661477	7	2	5
fam1427	2	3	7	4.0	2.6457513110645907	0.6614378277661477	7	2	5
fam1428	2	7	3	4.0	2.6457513110645907	0.6614378277661477	7	2	5
fam1429	2	3	7	4.0	2.6457513110645907	0.6614378277661477	7	2	5
fam1430	2	7	2	3.6666666666666665	2.886751345948129	0.787295821622217	7	2	5
fam1431	2	3	7	4.0	2.6457513110645907	0.6614378277661477	7	2	5
fam1432	7	2	2	3.6666666666666665	2.886751345948129	0.787295821622217	7	2	5
fam1433	2	7	3	4.0	2.6457513110645907	0.6614378277661477	7	2	5
fam1434	2	7	3	4.0	2.6457513110645907	0.6614378277661477	7	2	5
fam1435	2	7	3	4.0	2.6457513110645907	0.6614378277661477	7	2	5
fam1436	2	7	3	4.0	2.6457513110645907	0.6614378277661477	7	2	5
fam1437	2	7	3	4.0	2.6457513110645907	0.6614378277661477	7	2	5
fam1438	2	7	3	4.0	2.6457513110645907	0.6614378277661477	7	2	5
fam1439	2	3	7	4.0	2.6457513110645907	0.6614378277661477	7	2	5
fam1440	2	3	7	4.0	2.6457513110645907	0.6614378277661477	7	2	5
fam1441	2	7	3	4.0	2.6457513110645907	0.6614378277661477	7	2	5
fam1442	2	7	3	4.0	2.6457513110645907	0.6614378277661477	7	2	5
fam1443	2	7	3	4.0	2.6457513110645907	0.6614378277661477	7	2	5
fam1444	2	7	3	4.0	2.6457513110645907	0.6614378277661477	7	2	5
fam1445	2	2	7	3.6666666666666665	2.886751345948129	0.787295821622217	7	2	5
fam1446	2	7	3	4.0	2.6457513110645907	0.6614378277661477	7	2	5
fam1447	2	7	3	4.0	2.6457513110645907	0.6614378277661477	7	2	5
fam1448	2	6	4	4.0	2.0	0.5	6	2	4
fam1449	2	7	2	3.6666666666666665	2.886751345948129	0.787295821622217	7	2	5
fam1450	2	7	3	4.0	2.6457513110645907	0.6614378277661477	7	2	5
fam1451	2	7	3	4.0	2.6457513110645907	0.6614378277661477	7	2	5
fam1452	2	7	3	4.0	2.6457513110645907	0.6614378277661477	7	2	5
fam1453	2	7	3	4.0	2.6457513110645907	0.6614378277661477	7	2	5
fam1454	2	7	3	4.0	2.6457513110645907	0.6614378277661477	7	2	5
fam1455	2	7	3	4.0	2.6457513110645907	0.6614378277661477	7	2	5
fam1456	2	3	7	4.0	2.6457513110645907	0.6614378277661477	7	2	5
fam1457	2	7	3	4.0	2.6457513110645907	0.6614378277661477	7	2	5
fam1458	2	7	3	4.0	2.6457513110645907	0.6614378277661477	7	2	5
fam1459	4	4	3	3.6666666666666665	0.5773502691896258	0.15745916432444343	4	3	1
fam1460	3	5	3	3.6666666666666665	1.1547005383792515	0.3149183286488868	5	3	2
fam1461	2	6	4	4.0	2.0	0.5	6	2	4
fam1462	2	5	4	3.6666666666666665	1.5275252316519468	0.41659779045053097	5	2	3
fam1463	2	4	5	3.6666666666666665	1.5275252316519465	0.4165977904505309	5	2	3
fam1464	3	3	5	3.6666666666666665	1.1547005383792515	0.3149183286488868	5	3	2
fam1465	3	5	3	3.6666666666666665	1.1547005383792515	0.3149183286488868	5	3	2
fam1466	3	4	4	3.6666666666666665	0.5773502691896258	0.15745916432444343	4	3	1
fam1467	4	4	3	3.6666666666666665	0.5773502691896258	0.15745916432444343	4	3	1
fam1468	3	4	4	3.6666666666666665	0.5773502691896258	0.15745916432444343	4	3	1
fam1469	3	2	6	3.6666666666666665	2.081665999466133	0.5677270907634908	6	2	4
fam1470	5	5	2	4.0	1.7320508075688772	0.4330127018922193	5	2	3
fam1471	3	4	4	3.6666666666666665	0.5773502691896258	0.15745916432444343	4	3	1
fam1472	8	2	2	4.0	3.4641016151377544	0.8660254037844386	8	2	6
fam1473	2	8	2	4.0	3.4641016151377544	0.8660254037844386	8	2	6
fam1474	2	8	2	4.0	3.4641016151377544	0.8660254037844386	8	2	6
fam1475	2	8	2	4.0	3.4641016151377544	0.8660254037844386	8	2	6
fam1476	2	8	2	4.0	3.4641016151377544	0.8660254037844386	8	2	6
fam1477	2	8	2	4.0	3.4641016151377544	0.8660254037844386	8	2	6
fam1478	2	7	3	4.0	2.6457513110645907	0.6614378277661477	7	2	5
fam1479	2	8	2	4.0	3.4641016151377544	0.8660254037844386	8	2	6
fam1480	8	2	2	4.0	3.4641016151377544	0.8660254037844386	8	2	6
fam1481	3	5	3	3.6666666666666665	1.1547005383792515	0.3149183286488868	5	3	2
fam1482	2	8	2	4.0	3.4641016151377544	0.8660254037844386	8	2	6
fam1483	2	8	2	4.0	3.4641016151377544	0.8660254037844386	8	2	6
fam1484	2	8	2	4.0	3.4641016151377544	0.8660254037844386	8	2	6
fam1485	2	7	2	3.6666666666666665	2.886751345948129	0.787295821622217	7	2	5
fam1486	2	6	4	4.0	2.0	0.5	6	2	4
fam1487	2	6	4	4.0	2.0	0.5	6	2	4
fam1488	2	5	4	3.6666666666666665	1.5275252316519468	0.41659779045053097	5	2	3
fam1489	4	6	2	4.0	2.0	0.5	6	2	4
fam1490	3	4	4	3.6666666666666665	0.5773502691896258	0.15745916432444343	4	3	1
fam1491	2	6	4	4.0	2.0	0.5	6	2	4
fam1492	2	6	4	4.0	2.0	0.5	6	2	4
fam1493	3	4	4	3.6666666666666665	0.5773502691896258	0.15745916432444343	4	3	1
fam1494	3	4	4	3.6666666666666665	0.5773502691896258	0.15745916432444343	4	3	1
fam1495	2	5	5	4.0	1.7320508075688772	0.4330127018922193	5	2	3
fam1496	2	9	2	4.333333333333333	4.041451884327381	0.9326427425370879	9	2	7
fam1497	2	2	7	3.6666666666666665	2.886751345948129	0.787295821622217	7	2	5
fam1498	2	9	2	4.333333333333333	4.041451884327381	0.9326427425370879	9	2	7
fam1499	2	9	2	4.333333333333333	4.041451884327381	0.9326427425370879	9	2	7
fam1500	2	7	2	3.6666666666666665	2.886751345948129	0.787295821622217	7	2	5
fam1501	2	2	9	4.333333333333333	4.041451884327381	0.9326427425370879	9	2	7
fam1502	2	9	2	4.333333333333333	4.041451884327381	0.9326427425370879	9	2	7
fam1503	2	9	2	4.333333333333333	4.041451884327381	0.9326427425370879	9	2	7
fam1504	2	2	9	4.333333333333333	4.041451884327381	0.9326427425370879	9	2	7
fam1505	2	9	2	4.333333333333333	4.041451884327381	0.9326427425370879	9	2	7
fam1506	2	9	2	4.333333333333333	4.041451884327381	0.9326427425370879	9	2	7
fam1507	2	9	2	4.333333333333333	4.041451884327381	0.9326427425370879	9	2	7
fam1508	2	9	2	4.333333333333333	4.041451884327381	0.9326427425370879	9	2	7
fam1509	2	9	2	4.333333333333333	4.041451884327381	0.9326427425370879	9	2	7
fam1510	3	6	2	3.6666666666666665	2.081665999466133	0.5677270907634908	6	2	4
fam1511	2	4	5	3.6666666666666665	1.5275252316519465	0.4165977904505309	5	2	3
fam1512	4	5	2	3.6666666666666665	1.5275252316519465	0.4165977904505309	5	2	3
fam1513	2	9	2	4.333333333333333	4.041451884327381	0.9326427425370879	9	2	7
fam1514	2	9	2	4.333333333333333	4.041451884327381	0.9326427425370879	9	2	7
fam1515	2	7	2	3.6666666666666665	2.886751345948129	0.787295821622217	7	2	5
fam1516	2	9	2	4.333333333333333	4.041451884327381	0.9326427425370879	9	2	7
fam1517	2	9	2	4.333333333333333	4.041451884327381	0.9326427425370879	9	2	7
fam1518	2	6	3	3.6666666666666665	2.081665999466133	0.5677270907634908	6	2	4
fam1519	2	7	3	4.0	2.6457513110645907	0.6614378277661477	7	2	5
fam1520	2	5	4	3.6666666666666665	1.5275252316519468	0.41659779045053097	5	2	3
fam1521	4	5	2	3.6666666666666665	1.5275252316519465	0.4165977904505309	5	2	3
fam1522	2	6	4	4.0	2.0	0.5	6	2	4
fam1523	3	3	5	3.6666666666666665	1.1547005383792515	0.3149183286488868	5	3	2
fam1524	2	5	5	4.0	1.7320508075688772	0.4330127018922193	5	2	3
fam1525	2	6	3	3.6666666666666665	2.081665999466133	0.5677270907634908	6	2	4
fam1526	2	7	3	4.0	2.6457513110645907	0.6614378277661477	7	2	5
fam1527	2	2	8	4.0	3.4641016151377544	0.8660254037844386	8	2	6
fam1528	2	5	5	4.0	1.7320508075688772	0.4330127018922193	5	2	3
fam1529	4	4	3	3.6666666666666665	0.5773502691896258	0.15745916432444343	4	3	1
fam1530	2	4	6	4.0	2.0	0.5	6	2	4
fam1531	2	2	7	3.6666666666666665	2.886751345948129	0.787295821622217	7	2	5
fam1532	2	5	4	3.6666666666666665	1.5275252316519468	0.41659779045053097	5	2	3
fam1533	4	5	2	3.6666666666666665	1.5275252316519465	0.4165977904505309	5	2	3
fam1534	2	5	4	3.6666666666666665	1.5275252316519468	0.41659779045053097	5	2	3
fam1535	4	3	4	3.6666666666666665	0.5773502691896258	0.15745916432444343	4	3	1
fam1536	4	4	3	3.6666666666666665	0.5773502691896258	0.15745916432444343	4	3	1
fam1537	3	3	5	3.6666666666666665	1.1547005383792515	0.3149183286488868	5	3	2
fam1538	2	5	4	3.6666666666666665	1.5275252316519468	0.41659779045053097	5	2	3
fam1539	2	5	5	4.0	1.7320508075688772	0.4330127018922193	5	2	3
fam1540	2	4	4	3.3333333333333335	1.1547005383792515	0.3464101615137754	4	2	2
fam1541	4	3	3	3.3333333333333335	0.5773502691896258	0.17320508075688776	4	3	1
fam1542	3	4	3	3.3333333333333335	0.5773502691896258	0.17320508075688776	4	3	1
fam1543	2	4	4	3.3333333333333335	1.1547005383792515	0.3464101615137754	4	2	2
fam1544	4	3	3	3.3333333333333335	0.5773502691896258	0.17320508075688776	4	3	1
fam1545	2	4	4	3.3333333333333335	1.1547005383792515	0.3464101615137754	4	2	2
fam1546	3	3	4	3.3333333333333335	0.5773502691896258	0.17320508075688776	4	3	1
fam1547	3	3	4	3.3333333333333335	0.5773502691896258	0.17320508075688776	4	3	1
fam1548	2	4	4	3.3333333333333335	1.1547005383792515	0.3464101615137754	4	2	2
fam1549	3	4	3	3.3333333333333335	0.5773502691896258	0.17320508075688776	4	3	1
fam1550	2	4	4	3.3333333333333335	1.1547005383792515	0.3464101615137754	4	2	2
fam1551	2	4	4	3.3333333333333335	1.1547005383792515	0.3464101615137754	4	2	2
fam1552	3	4	3	3.3333333333333335	0.5773502691896258	0.17320508075688776	4	3	1
fam1553	2	4	4	3.3333333333333335	1.1547005383792515	0.3464101615137754	4	2	2
fam1554	4	2	4	3.3333333333333335	1.1547005383792515	0.3464101615137754	4	2	2
fam1555	2	4	4	3.3333333333333335	1.1547005383792515	0.3464101615137754	4	2	2
fam1556	3	3	4	3.3333333333333335	0.5773502691896258	0.17320508075688776	4	3	1
fam1557	2	4	4	3.3333333333333335	1.1547005383792515	0.3464101615137754	4	2	2
fam1558	2	4	4	3.3333333333333335	1.1547005383792515	0.3464101615137754	4	2	2
fam1559	3	4	3	3.3333333333333335	0.5773502691896258	0.17320508075688776	4	3	1
fam1560	2	4	4	3.3333333333333335	1.1547005383792515	0.3464101615137754	4	2	2
fam1561	3	4	3	3.3333333333333335	0.5773502691896258	0.17320508075688776	4	3	1
fam1562	3	3	4	3.3333333333333335	0.5773502691896258	0.17320508075688776	4	3	1
fam1563	3	4	3	3.3333333333333335	0.5773502691896258	0.17320508075688776	4	3	1
fam1564	2	4	4	3.3333333333333335	1.1547005383792515	0.3464101615137754	4	2	2
fam1565	2	4	4	3.3333333333333335	1.1547005383792515	0.3464101615137754	4	2	2
fam1566	4	3	3	3.3333333333333335	0.5773502691896258	0.17320508075688776	4	3	1
fam1567	4	3	3	3.3333333333333335	0.5773502691896258	0.17320508075688776	4	3	1
fam1568	2	4	4	3.3333333333333335	1.1547005383792515	0.3464101615137754	4	2	2
fam1569	4	3	3	3.3333333333333335	0.5773502691896258	0.17320508075688776	4	3	1
fam1570	3	4	3	3.3333333333333335	0.5773502691896258	0.17320508075688776	4	3	1
fam1571	2	4	4	3.3333333333333335	1.1547005383792515	0.3464101615137754	4	2	2
fam1572	3	3	4	3.3333333333333335	0.5773502691896258	0.17320508075688776	4	3	1
fam1573	2	4	4	3.3333333333333335	1.1547005383792515	0.3464101615137754	4	2	2
fam1574	2	4	4	3.3333333333333335	1.1547005383792515	0.3464101615137754	4	2	2
fam1575	3	3	4	3.3333333333333335	0.5773502691896258	0.17320508075688776	4	3	1
fam1576	2	4	4	3.3333333333333335	1.1547005383792515	0.3464101615137754	4	2	2
fam1577	2	4	4	3.3333333333333335	1.1547005383792515	0.3464101615137754	4	2	2
fam1578	3	3	4	3.3333333333333335	0.5773502691896258	0.17320508075688776	4	3	1
fam1579	2	4	4	3.3333333333333335	1.1547005383792515	0.3464101615137754	4	2	2
fam1580	3	3	4	3.3333333333333335	0.5773502691896258	0.17320508075688776	4	3	1
fam1581	3	3	4	3.3333333333333335	0.5773502691896258	0.17320508075688776	4	3	1
fam1582	4	2	4	3.3333333333333335	1.1547005383792515	0.3464101615137754	4	2	2
fam1583	2	4	4	3.3333333333333335	1.1547005383792515	0.3464101615137754	4	2	2
fam1584	3	3	4	3.3333333333333335	0.5773502691896258	0.17320508075688776	4	3	1
fam1585	4	4	2	3.3333333333333335	1.1547005383792515	0.3464101615137754	4	2	2
fam1586	3	4	3	3.3333333333333335	0.5773502691896258	0.17320508075688776	4	3	1
fam1587	2	4	4	3.3333333333333335	1.1547005383792515	0.3464101615137754	4	2	2
fam1588	4	3	3	3.3333333333333335	0.5773502691896258	0.17320508075688776	4	3	1
fam1589	2	4	4	3.3333333333333335	1.1547005383792515	0.3464101615137754	4	2	2
fam1590	2	4	4	3.3333333333333335	1.1547005383792515	0.3464101615137754	4	2	2
fam1591	3	4	3	3.3333333333333335	0.5773502691896258	0.17320508075688776	4	3	1
fam1592	4	3	3	3.3333333333333335	0.5773502691896258	0.17320508075688776	4	3	1
fam1593	2	4	4	3.3333333333333335	1.1547005383792515	0.3464101615137754	4	2	2
fam1594	3	4	3	3.3333333333333335	0.5773502691896258	0.17320508075688776	4	3	1
fam1595	3	3	4	3.3333333333333335	0.5773502691896258	0.17320508075688776	4	3	1
fam1596	4	3	3	3.3333333333333335	0.5773502691896258	0.17320508075688776	4	3	1
fam1597	4	3	3	3.3333333333333335	0.5773502691896258	0.17320508075688776	4	3	1
fam1598	3	3	4	3.3333333333333335	0.5773502691896258	0.17320508075688776	4	3	1
fam1599	4	4	2	3.3333333333333335	1.1547005383792515	0.3464101615137754	4	2	2
fam1600	2	4	4	3.3333333333333335	1.1547005383792515	0.3464101615137754	4	2	2
fam1601	4	2	4	3.3333333333333335	1.1547005383792515	0.3464101615137754	4	2	2
fam1602	4	3	3	3.3333333333333335	0.5773502691896258	0.17320508075688776	4	3	1
fam1603	3	4	3	3.3333333333333335	0.5773502691896258	0.17320508075688776	4	3	1
fam1604	2	4	4	3.3333333333333335	1.1547005383792515	0.3464101615137754	4	2	2
fam1605	2	4	4	3.3333333333333335	1.1547005383792515	0.3464101615137754	4	2	2
fam1606	4	3	3	3.3333333333333335	0.5773502691896258	0.17320508075688776	4	3	1
fam1607	3	4	3	3.3333333333333335	0.5773502691896258	0.17320508075688776	4	3	1
fam1608	2	4	4	3.3333333333333335	1.1547005383792515	0.3464101615137754	4	2	2
fam1609	2	4	4	3.3333333333333335	1.1547005383792515	0.3464101615137754	4	2	2
fam1610	2	4	4	3.3333333333333335	1.1547005383792515	0.3464101615137754	4	2	2
fam1611	2	4	4	3.3333333333333335	1.1547005383792515	0.3464101615137754	4	2	2
fam1612	4	3	3	3.3333333333333335	0.5773502691896258	0.17320508075688776	4	3	1
fam1613	3	4	3	3.3333333333333335	0.5773502691896258	0.17320508075688776	4	3	1
fam1614	2	4	4	3.3333333333333335	1.1547005383792515	0.3464101615137754	4	2	2
fam1615	2	4	4	3.3333333333333335	1.1547005383792515	0.3464101615137754	4	2	2
fam1616	3	3	4	3.3333333333333335	0.5773502691896258	0.17320508075688776	4	3	1
fam1617	2	4	4	3.3333333333333335	1.1547005383792515	0.3464101615137754	4	2	2
fam1618	2	4	4	3.3333333333333335	1.1547005383792515	0.3464101615137754	4	2	2
fam1619	2	4	4	3.3333333333333335	1.1547005383792515	0.3464101615137754	4	2	2
fam1620	2	4	4	3.3333333333333335	1.1547005383792515	0.3464101615137754	4	2	2
fam1621	4	3	3	3.3333333333333335	0.5773502691896258	0.17320508075688776	4	3	1
fam1622	2	5	4	3.6666666666666665	1.5275252316519468	0.41659779045053097	5	2	3
fam1623	2	5	4	3.6666666666666665	1.5275252316519468	0.41659779045053097	5	2	3
fam1624	2	3	5	3.3333333333333335	1.5275252316519465	0.45825756949558394	5	2	3
fam1625	2	4	5	3.6666666666666665	1.5275252316519465	0.4165977904505309	5	2	3
fam1626	2	5	3	3.3333333333333335	1.5275252316519468	0.458257569495584	5	2	3
fam1627	2	5	3	3.3333333333333335	1.5275252316519468	0.458257569495584	5	2	3
fam1628	2	5	4	3.6666666666666665	1.5275252316519468	0.41659779045053097	5	2	3
fam1629	2	4	5	3.6666666666666665	1.5275252316519465	0.4165977904505309	5	2	3
fam1630	2	5	3	3.3333333333333335	1.5275252316519468	0.458257569495584	5	2	3
fam1631	2	4	5	3.6666666666666665	1.5275252316519465	0.4165977904505309	5	2	3
fam1632	2	4	5	3.6666666666666665	1.5275252316519465	0.4165977904505309	5	2	3
fam1633	5	3	2	3.3333333333333335	1.5275252316519465	0.45825756949558394	5	2	3
fam1634	2	5	3	3.3333333333333335	1.5275252316519468	0.458257569495584	5	2	3
fam1635	2	5	3	3.3333333333333335	1.5275252316519468	0.458257569495584	5	2	3
fam1636	2	4	5	3.6666666666666665	1.5275252316519465	0.4165977904505309	5	2	3
fam1637	2	5	4	3.6666666666666665	1.5275252316519468	0.41659779045053097	5	2	3
fam1638	2	3	5	3.3333333333333335	1.5275252316519465	0.45825756949558394	5	2	3
fam1639	2	5	4	3.6666666666666665	1.5275252316519468	0.41659779045053097	5	2	3
fam1640	2	4	5	3.6666666666666665	1.5275252316519465	0.4165977904505309	5	2	3
fam1641	2	5	4	3.6666666666666665	1.5275252316519468	0.41659779045053097	5	2	3
fam1642	2	3	5	3.3333333333333335	1.5275252316519465	0.45825756949558394	5	2	3
fam1643	2	4	5	3.6666666666666665	1.5275252316519465	0.4165977904505309	5	2	3
fam1644	2	5	4	3.6666666666666665	1.5275252316519468	0.41659779045053097	5	2	3
fam1645	2	5	4	3.6666666666666665	1.5275252316519468	0.41659779045053097	5	2	3
fam1646	2	5	3	3.3333333333333335	1.5275252316519468	0.458257569495584	5	2	3
fam1647	2	4	5	3.6666666666666665	1.5275252316519465	0.4165977904505309	5	2	3
fam1648	2	5	4	3.6666666666666665	1.5275252316519468	0.41659779045053097	5	2	3
fam1649	2	5	4	3.6666666666666665	1.5275252316519468	0.41659779045053097	5	2	3
fam1650	2	4	5	3.6666666666666665	1.5275252316519465	0.4165977904505309	5	2	3
fam1651	2	3	5	3.3333333333333335	1.5275252316519465	0.45825756949558394	5	2	3
fam1652	2	4	5	3.6666666666666665	1.5275252316519465	0.4165977904505309	5	2	3
fam1653	2	3	5	3.3333333333333335	1.5275252316519465	0.45825756949558394	5	2	3
fam1654	2	5	4	3.6666666666666665	1.5275252316519468	0.41659779045053097	5	2	3
fam1655	2	4	5	3.6666666666666665	1.5275252316519465	0.4165977904505309	5	2	3
fam1656	2	5	3	3.3333333333333335	1.5275252316519468	0.458257569495584	5	2	3
fam1657	5	4	2	3.6666666666666665	1.5275252316519465	0.4165977904505309	5	2	3
fam1658	5	2	3	3.3333333333333335	1.5275252316519468	0.458257569495584	5	2	3
fam1659	5	3	2	3.3333333333333335	1.5275252316519465	0.45825756949558394	5	2	3
fam1660	2	5	4	3.6666666666666665	1.5275252316519468	0.41659779045053097	5	2	3
fam1661	2	5	4	3.6666666666666665	1.5275252316519468	0.41659779045053097	5	2	3
fam1662	2	3	5	3.3333333333333335	1.5275252316519465	0.45825756949558394	5	2	3
fam1663	2	5	4	3.6666666666666665	1.5275252316519468	0.41659779045053097	5	2	3
fam1664	2	5	3	3.3333333333333335	1.5275252316519468	0.458257569495584	5	2	3
fam1665	2	5	4	3.6666666666666665	1.5275252316519468	0.41659779045053097	5	2	3
fam1666	2	3	5	3.3333333333333335	1.5275252316519465	0.45825756949558394	5	2	3
fam1667	2	5	4	3.6666666666666665	1.5275252316519468	0.41659779045053097	5	2	3
fam1668	2	5	3	3.3333333333333335	1.5275252316519468	0.458257569495584	5	2	3
fam1669	2	5	4	3.6666666666666665	1.5275252316519468	0.41659779045053097	5	2	3
fam1670	2	4	5	3.6666666666666665	1.5275252316519465	0.4165977904505309	5	2	3
fam1671	2	3	5	3.3333333333333335	1.5275252316519465	0.45825756949558394	5	2	3
fam1672	2	4	5	3.6666666666666665	1.5275252316519465	0.4165977904505309	5	2	3
fam1673	2	4	5	3.6666666666666665	1.5275252316519465	0.4165977904505309	5	2	3
fam1674	5	4	2	3.6666666666666665	1.5275252316519465	0.4165977904505309	5	2	3
fam1675	3	5	2	3.3333333333333335	1.5275252316519465	0.45825756949558394	5	2	3
fam1676	5	3	2	3.3333333333333335	1.5275252316519465	0.45825756949558394	5	2	3
fam1677	2	5	3	3.3333333333333335	1.5275252316519468	0.458257569495584	5	2	3
fam1678	2	4	5	3.6666666666666665	1.5275252316519465	0.4165977904505309	5	2	3
fam1679	2	5	4	3.6666666666666665	1.5275252316519468	0.41659779045053097	5	2	3
fam1680	2	5	4	3.6666666666666665	1.5275252316519468	0.41659779045053097	5	2	3
fam1681	2	5	3	3.3333333333333335	1.5275252316519468	0.458257569495584	5	2	3
fam1682	2	3	5	3.3333333333333335	1.5275252316519465	0.45825756949558394	5	2	3
fam1683	2	4	5	3.6666666666666665	1.5275252316519465	0.4165977904505309	5	2	3
fam1684	3	5	2	3.3333333333333335	1.5275252316519465	0.45825756949558394	5	2	3
fam1685	3	2	5	3.3333333333333335	1.5275252316519465	0.45825756949558394	5	2	3
fam1686	2	4	5	3.6666666666666665	1.5275252316519465	0.4165977904505309	5	2	3
fam1687	2	4	5	3.6666666666666665	1.5275252316519465	0.4165977904505309	5	2	3
fam1688	2	4	5	3.6666666666666665	1.5275252316519465	0.4165977904505309	5	2	3
fam1689	2	5	4	3.6666666666666665	1.5275252316519468	0.41659779045053097	5	2	3
fam1690	3	5	2	3.3333333333333335	1.5275252316519465	0.45825756949558394	5	2	3
fam1691	2	5	4	3.6666666666666665	1.5275252316519468	0.41659779045053097	5	2	3
fam1692	2	4	5	3.6666666666666665	1.5275252316519465	0.4165977904505309	5	2	3
fam1693	2	5	4	3.6666666666666665	1.5275252316519468	0.41659779045053097	5	2	3
fam1694	2	5	3	3.3333333333333335	1.5275252316519468	0.458257569495584	5	2	3
fam1695	2	5	4	3.6666666666666665	1.5275252316519468	0.41659779045053097	5	2	3
fam1696	2	5	4	3.6666666666666665	1.5275252316519468	0.41659779045053097	5	2	3
fam1697	3	5	2	3.3333333333333335	1.5275252316519465	0.45825756949558394	5	2	3
fam1698	5	2	3	3.3333333333333335	1.5275252316519468	0.458257569495584	5	2	3
fam1699	4	5	2	3.6666666666666665	1.5275252316519465	0.4165977904505309	5	2	3
fam1700	2	5	4	3.6666666666666665	1.5275252316519468	0.41659779045053097	5	2	3
fam1701	3	5	2	3.3333333333333335	1.5275252316519465	0.45825756949558394	5	2	3
fam1702	2	5	3	3.3333333333333335	1.5275252316519468	0.458257569495584	5	2	3
fam1703	2	5	3	3.3333333333333335	1.5275252316519468	0.458257569495584	5	2	3
fam1704	2	4	5	3.6666666666666665	1.5275252316519465	0.4165977904505309	5	2	3
fam1705	2	4	5	3.6666666666666665	1.5275252316519465	0.4165977904505309	5	2	3
fam1706	5	2	4	3.6666666666666665	1.5275252316519468	0.41659779045053097	5	2	3
fam1707	5	4	2	3.6666666666666665	1.5275252316519465	0.4165977904505309	5	2	3
fam1708	4	5	2	3.6666666666666665	1.5275252316519465	0.4165977904505309	5	2	3
fam1709	2	5	3	3.3333333333333335	1.5275252316519468	0.458257569495584	5	2	3
fam1710	2	5	4	3.6666666666666665	1.5275252316519468	0.41659779045053097	5	2	3
fam1711	2	5	4	3.6666666666666665	1.5275252316519468	0.41659779045053097	5	2	3
fam1712	2	5	3	3.3333333333333335	1.5275252316519468	0.458257569495584	5	2	3
fam1713	2	4	5	3.6666666666666665	1.5275252316519465	0.4165977904505309	5	2	3
fam1714	2	5	4	3.6666666666666665	1.5275252316519468	0.41659779045053097	5	2	3
fam1715	4	2	5	3.6666666666666665	1.5275252316519465	0.4165977904505309	5	2	3
fam1716	2	5	4	3.6666666666666665	1.5275252316519468	0.41659779045053097	5	2	3
fam1717	2	5	3	3.3333333333333335	1.5275252316519468	0.458257569495584	5	2	3
fam1718	2	5	4	3.6666666666666665	1.5275252316519468	0.41659779045053097	5	2	3
fam1719	2	5	4	3.6666666666666665	1.5275252316519468	0.41659779045053097	5	2	3
fam1720	2	4	5	3.6666666666666665	1.5275252316519465	0.4165977904505309	5	2	3
fam1721	2	4	5	3.6666666666666665	1.5275252316519465	0.4165977904505309	5	2	3
fam1722	2	5	4	3.6666666666666665	1.5275252316519468	0.41659779045053097	5	2	3
fam1723	3	5	2	3.3333333333333335	1.5275252316519465	0.45825756949558394	5	2	3
fam1724	2	5	4	3.6666666666666665	1.5275252316519468	0.41659779045053097	5	2	3
fam1725	2	5	4	3.6666666666666665	1.5275252316519468	0.41659779045053097	5	2	3
fam1726	2	5	4	3.6666666666666665	1.5275252316519468	0.41659779045053097	5	2	3
fam1727	2	5	4	3.6666666666666665	1.5275252316519468	0.41659779045053097	5	2	3
fam1728	3	5	2	3.3333333333333335	1.5275252316519465	0.45825756949558394	5	2	3
fam1729	2	4	5	3.6666666666666665	1.5275252316519465	0.4165977904505309	5	2	3
fam1730	2	4	5	3.6666666666666665	1.5275252316519465	0.4165977904505309	5	2	3
fam1731	3	3	4	3.3333333333333335	0.5773502691896258	0.17320508075688776	4	3	1
fam1732	2	6	3	3.6666666666666665	2.081665999466133	0.5677270907634908	6	2	4
fam1733	2	6	2	3.3333333333333335	2.3094010767585034	0.692820323027551	6	2	4
fam1734	2	6	3	3.6666666666666665	2.081665999466133	0.5677270907634908	6	2	4
fam1735	2	6	3	3.6666666666666665	2.081665999466133	0.5677270907634908	6	2	4
fam1736	2	6	3	3.6666666666666665	2.081665999466133	0.5677270907634908	6	2	4
fam1737	2	3	6	3.6666666666666665	2.081665999466133	0.5677270907634908	6	2	4
fam1738	2	3	6	3.6666666666666665	2.081665999466133	0.5677270907634908	6	2	4
fam1739	2	2	6	3.3333333333333335	2.3094010767585034	0.692820323027551	6	2	4
fam1740	2	2	6	3.3333333333333335	2.3094010767585034	0.692820323027551	6	2	4
fam1741	3	6	2	3.6666666666666665	2.081665999466133	0.5677270907634908	6	2	4
fam1742	2	6	3	3.6666666666666665	2.081665999466133	0.5677270907634908	6	2	4
fam1743	2	6	3	3.6666666666666665	2.081665999466133	0.5677270907634908	6	2	4
fam1744	3	3	4	3.3333333333333335	0.5773502691896258	0.17320508075688776	4	3	1
fam1745	2	6	3	3.6666666666666665	2.081665999466133	0.5677270907634908	6	2	4
fam1746	2	4	4	3.3333333333333335	1.1547005383792515	0.3464101615137754	4	2	2
fam1747	2	6	3	3.6666666666666665	2.081665999466133	0.5677270907634908	6	2	4
fam1748	2	6	2	3.3333333333333335	2.3094010767585034	0.692820323027551	6	2	4
fam1749	2	6	3	3.6666666666666665	2.081665999466133	0.5677270907634908	6	2	4
fam1750	4	3	3	3.3333333333333335	0.5773502691896258	0.17320508075688776	4	3	1
fam1751	2	6	2	3.3333333333333335	2.3094010767585034	0.692820323027551	6	2	4
fam1752	2	6	3	3.6666666666666665	2.081665999466133	0.5677270907634908	6	2	4
fam1753	2	6	3	3.6666666666666665	2.081665999466133	0.5677270907634908	6	2	4
fam1754	2	3	6	3.6666666666666665	2.081665999466133	0.5677270907634908	6	2	4
fam1755	2	6	3	3.6666666666666665	2.081665999466133	0.5677270907634908	6	2	4
fam1756	2	6	3	3.6666666666666665	2.081665999466133	0.5677270907634908	6	2	4
fam1757	2	4	4	3.3333333333333335	1.1547005383792515	0.3464101615137754	4	2	2
fam1758	2	6	3	3.6666666666666665	2.081665999466133	0.5677270907634908	6	2	4
fam1759	2	6	3	3.6666666666666665	2.081665999466133	0.5677270907634908	6	2	4
fam1760	2	5	4	3.6666666666666665	1.5275252316519468	0.41659779045053097	5	2	3
fam1761	2	3	6	3.6666666666666665	2.081665999466133	0.5677270907634908	6	2	4
fam1762	2	6	3	3.6666666666666665	2.081665999466133	0.5677270907634908	6	2	4
fam1763	2	6	3	3.6666666666666665	2.081665999466133	0.5677270907634908	6	2	4
fam1764	2	6	3	3.6666666666666665	2.081665999466133	0.5677270907634908	6	2	4
fam1765	2	6	2	3.3333333333333335	2.3094010767585034	0.692820323027551	6	2	4
fam1766	2	3	6	3.6666666666666665	2.081665999466133	0.5677270907634908	6	2	4
fam1767	2	6	2	3.3333333333333335	2.3094010767585034	0.692820323027551	6	2	4
fam1768	3	6	2	3.6666666666666665	2.081665999466133	0.5677270907634908	6	2	4
fam1769	2	6	3	3.6666666666666665	2.081665999466133	0.5677270907634908	6	2	4
fam1770	2	6	2	3.3333333333333335	2.3094010767585034	0.692820323027551	6	2	4
fam1771	6	2	2	3.3333333333333335	2.3094010767585034	0.692820323027551	6	2	4
fam1772	2	6	3	3.6666666666666665	2.081665999466133	0.5677270907634908	6	2	4
fam1773	2	3	6	3.6666666666666665	2.081665999466133	0.5677270907634908	6	2	4
fam1774	2	6	3	3.6666666666666665	2.081665999466133	0.5677270907634908	6	2	4
fam1775	2	6	3	3.6666666666666665	2.081665999466133	0.5677270907634908	6	2	4
fam1776	2	3	6	3.6666666666666665	2.081665999466133	0.5677270907634908	6	2	4
fam1777	2	2	6	3.3333333333333335	2.3094010767585034	0.692820323027551	6	2	4
fam1778	2	2	6	3.3333333333333335	2.3094010767585034	0.692820323027551	6	2	4
fam1779	2	6	3	3.6666666666666665	2.081665999466133	0.5677270907634908	6	2	4
fam1780	2	6	3	3.6666666666666665	2.081665999466133	0.5677270907634908	6	2	4
fam1781	2	6	3	3.6666666666666665	2.081665999466133	0.5677270907634908	6	2	4
fam1782	2	4	5	3.6666666666666665	1.5275252316519465	0.4165977904505309	5	2	3
fam1783	2	4	4	3.3333333333333335	1.1547005383792515	0.3464101615137754	4	2	2
fam1784	2	6	2	3.3333333333333335	2.3094010767585034	0.692820323027551	6	2	4
fam1785	4	3	3	3.3333333333333335	0.5773502691896258	0.17320508075688776	4	3	1
fam1786	3	4	3	3.3333333333333335	0.5773502691896258	0.17320508075688776	4	3	1
fam1787	2	4	5	3.6666666666666665	1.5275252316519465	0.4165977904505309	5	2	3
fam1788	2	5	4	3.6666666666666665	1.5275252316519468	0.41659779045053097	5	2	3
fam1789	2	5	4	3.6666666666666665	1.5275252316519468	0.41659779045053097	5	2	3
fam1790	4	3	3	3.3333333333333335	0.5773502691896258	0.17320508075688776	4	3	1
fam1791	2	5	4	3.6666666666666665	1.5275252316519468	0.41659779045053097	5	2	3
fam1792	2	4	4	3.3333333333333335	1.1547005383792515	0.3464101615137754	4	2	2
fam1793	2	4	4	3.3333333333333335	1.1547005383792515	0.3464101615137754	4	2	2
fam1794	5	2	3	3.3333333333333335	1.5275252316519468	0.458257569495584	5	2	3
fam1795	2	7	2	3.6666666666666665	2.886751345948129	0.787295821622217	7	2	5
fam1796	2	7	2	3.6666666666666665	2.886751345948129	0.787295821622217	7	2	5
fam1797	2	7	2	3.6666666666666665	2.886751345948129	0.787295821622217	7	2	5
fam1798	2	2	7	3.6666666666666665	2.886751345948129	0.787295821622217	7	2	5
fam1799	2	7	2	3.6666666666666665	2.886751345948129	0.787295821622217	7	2	5
fam1800	2	7	2	3.6666666666666665	2.886751345948129	0.787295821622217	7	2	5
fam1801	7	2	2	3.6666666666666665	2.886751345948129	0.787295821622217	7	2	5
fam1802	2	2	7	3.6666666666666665	2.886751345948129	0.787295821622217	7	2	5
fam1803	2	7	2	3.6666666666666665	2.886751345948129	0.787295821622217	7	2	5
fam1804	2	2	7	3.6666666666666665	2.886751345948129	0.787295821622217	7	2	5
fam1805	2	7	2	3.6666666666666665	2.886751345948129	0.787295821622217	7	2	5
fam1806	4	3	3	3.3333333333333335	0.5773502691896258	0.17320508075688776	4	3	1
fam1807	2	7	2	3.6666666666666665	2.886751345948129	0.787295821622217	7	2	5
fam1808	2	7	2	3.6666666666666665	2.886751345948129	0.787295821622217	7	2	5
fam1809	2	2	7	3.6666666666666665	2.886751345948129	0.787295821622217	7	2	5
fam1810	7	2	2	3.6666666666666665	2.886751345948129	0.787295821622217	7	2	5
fam1811	2	3	6	3.6666666666666665	2.081665999466133	0.5677270907634908	6	2	4
fam1812	3	4	3	3.3333333333333335	0.5773502691896258	0.17320508075688776	4	3	1
fam1813	2	7	2	3.6666666666666665	2.886751345948129	0.787295821622217	7	2	5
fam1814	2	7	2	3.6666666666666665	2.886751345948129	0.787295821622217	7	2	5
fam1815	3	6	2	3.6666666666666665	2.081665999466133	0.5677270907634908	6	2	4
fam1816	2	7	2	3.6666666666666665	2.886751345948129	0.787295821622217	7	2	5
fam1817	2	7	2	3.6666666666666665	2.886751345948129	0.787295821622217	7	2	5
fam1818	2	7	2	3.6666666666666665	2.886751345948129	0.787295821622217	7	2	5
fam1819	2	2	7	3.6666666666666665	2.886751345948129	0.787295821622217	7	2	5
fam1820	3	4	3	3.3333333333333335	0.5773502691896258	0.17320508075688776	4	3	1
fam1821	2	7	2	3.6666666666666665	2.886751345948129	0.787295821622217	7	2	5
fam1822	7	2	2	3.6666666666666665	2.886751345948129	0.787295821622217	7	2	5
fam1823	2	5	4	3.6666666666666665	1.5275252316519468	0.41659779045053097	5	2	3
fam1824	2	5	4	3.6666666666666665	1.5275252316519468	0.41659779045053097	5	2	3
fam1825	2	5	4	3.6666666666666665	1.5275252316519468	0.41659779045053097	5	2	3
fam1826	2	6	3	3.6666666666666665	2.081665999466133	0.5677270907634908	6	2	4
fam1827	2	6	3	3.6666666666666665	2.081665999466133	0.5677270907634908	6	2	4
fam1828	2	6	3	3.6666666666666665	2.081665999466133	0.5677270907634908	6	2	4
fam1829	2	6	3	3.6666666666666665	2.081665999466133	0.5677270907634908	6	2	4
fam1830	3	5	2	3.3333333333333335	1.5275252316519465	0.45825756949558394	5	2	3
fam1831	4	4	2	3.3333333333333335	1.1547005383792515	0.3464101615137754	4	2	2
fam1832	2	5	4	3.6666666666666665	1.5275252316519468	0.41659779045053097	5	2	3
fam1833	2	4	4	3.3333333333333335	1.1547005383792515	0.3464101615137754	4	2	2
fam1834	5	4	2	3.6666666666666665	1.5275252316519465	0.4165977904505309	5	2	3
fam1835	2	4	4	3.3333333333333335	1.1547005383792515	0.3464101615137754	4	2	2
fam1836	3	3	4	3.3333333333333335	0.5773502691896258	0.17320508075688776	4	3	1
fam1837	2	6	3	3.6666666666666665	2.081665999466133	0.5677270907634908	6	2	4
fam1838	3	3	4	3.3333333333333335	0.5773502691896258	0.17320508075688776	4	3	1
fam1839	4	2	4	3.3333333333333335	1.1547005383792515	0.3464101615137754	4	2	2
fam1840	8	2	2	4.0	3.4641016151377544	0.8660254037844386	8	2	6
fam1841	2	8	2	4.0	3.4641016151377544	0.8660254037844386	8	2	6
fam1842	2	8	2	4.0	3.4641016151377544	0.8660254037844386	8	2	6
fam1843	2	8	2	4.0	3.4641016151377544	0.8660254037844386	8	2	6
fam1844	2	7	2	3.6666666666666665	2.886751345948129	0.787295821622217	7	2	5
fam1845	2	8	2	4.0	3.4641016151377544	0.8660254037844386	8	2	6
fam1846	2	7	2	3.6666666666666665	2.886751345948129	0.787295821622217	7	2	5
fam1847	2	7	2	3.6666666666666665	2.886751345948129	0.787295821622217	7	2	5
fam1848	2	5	3	3.3333333333333335	1.5275252316519468	0.458257569495584	5	2	3
fam1849	2	8	2	4.0	3.4641016151377544	0.8660254037844386	8	2	6
fam1850	2	8	2	4.0	3.4641016151377544	0.8660254037844386	8	2	6
fam1851	2	8	2	4.0	3.4641016151377544	0.8660254037844386	8	2	6
fam1852	2	8	2	4.0	3.4641016151377544	0.8660254037844386	8	2	6
fam1853	4	2	4	3.3333333333333335	1.1547005383792515	0.3464101615137754	4	2	2
fam1854	2	8	2	4.0	3.4641016151377544	0.8660254037844386	8	2	6
fam1855	2	8	2	4.0	3.4641016151377544	0.8660254037844386	8	2	6
fam1856	2	4	4	3.3333333333333335	1.1547005383792515	0.3464101615137754	4	2	2
fam1857	2	8	2	4.0	3.4641016151377544	0.8660254037844386	8	2	6
fam1858	8	2	2	4.0	3.4641016151377544	0.8660254037844386	8	2	6
fam1859	2	8	2	4.0	3.4641016151377544	0.8660254037844386	8	2	6
fam1860	2	8	2	4.0	3.4641016151377544	0.8660254037844386	8	2	6
fam1861	2	8	2	4.0	3.4641016151377544	0.8660254037844386	8	2	6
fam1862	2	8	2	4.0	3.4641016151377544	0.8660254037844386	8	2	6
fam1863	2	8	2	4.0	3.4641016151377544	0.8660254037844386	8	2	6
fam1864	2	8	2	4.0	3.4641016151377544	0.8660254037844386	8	2	6
fam1865	2	8	2	4.0	3.4641016151377544	0.8660254037844386	8	2	6
fam1866	2	2	8	4.0	3.4641016151377544	0.8660254037844386	8	2	6
fam1867	2	8	2	4.0	3.4641016151377544	0.8660254037844386	8	2	6
fam1868	2	8	2	4.0	3.4641016151377544	0.8660254037844386	8	2	6
fam1869	2	8	2	4.0	3.4641016151377544	0.8660254037844386	8	2	6
fam1870	2	8	2	4.0	3.4641016151377544	0.8660254037844386	8	2	6
fam1871	2	8	2	4.0	3.4641016151377544	0.8660254037844386	8	2	6
fam1872	4	2	4	3.3333333333333335	1.1547005383792515	0.3464101615137754	4	2	2
fam1873	2	5	3	3.3333333333333335	1.5275252316519468	0.458257569495584	5	2	3
fam1874	2	7	2	3.6666666666666665	2.886751345948129	0.787295821622217	7	2	5
fam1875	2	8	2	4.0	3.4641016151377544	0.8660254037844386	8	2	6
fam1876	2	2	8	4.0	3.4641016151377544	0.8660254037844386	8	2	6
fam1877	7	2	2	3.6666666666666665	2.886751345948129	0.787295821622217	7	2	5
fam1878	2	2	7	3.6666666666666665	2.886751345948129	0.787295821622217	7	2	5
fam1879	3	4	3	3.3333333333333335	0.5773502691896258	0.17320508075688776	4	3	1
fam1880	2	6	3	3.6666666666666665	2.081665999466133	0.5677270907634908	6	2	4
fam1881	2	5	4	3.6666666666666665	1.5275252316519468	0.41659779045053097	5	2	3
fam1882	3	4	3	3.3333333333333335	0.5773502691896258	0.17320508075688776	4	3	1
fam1883	2	6	3	3.6666666666666665	2.081665999466133	0.5677270907634908	6	2	4
fam1884	2	3	5	3.3333333333333335	1.5275252316519465	0.45825756949558394	5	2	3
fam1885	2	3	6	3.6666666666666665	2.081665999466133	0.5677270907634908	6	2	4
fam1886	2	5	4	3.6666666666666665	1.5275252316519468	0.41659779045053097	5	2	3
fam1887	2	4	4	3.3333333333333335	1.1547005383792515	0.3464101615137754	4	2	2
fam1888	2	5	4	3.6666666666666665	1.5275252316519468	0.41659779045053097	5	2	3
fam1889	2	5	3	3.3333333333333335	1.5275252316519468	0.458257569495584	5	2	3
fam1890	3	3	4	3.3333333333333335	0.5773502691896258	0.17320508075688776	4	3	1
fam1891	2	4	4	3.3333333333333335	1.1547005383792515	0.3464101615137754	4	2	2
fam1892	2	4	5	3.6666666666666665	1.5275252316519465	0.4165977904505309	5	2	3
fam1893	2	4	4	3.3333333333333335	1.1547005383792515	0.3464101615137754	4	2	2
fam1894	2	6	3	3.6666666666666665	2.081665999466133	0.5677270907634908	6	2	4
fam1895	2	3	6	3.6666666666666665	2.081665999466133	0.5677270907634908	6	2	4
fam1896	2	6	2	3.3333333333333335	2.3094010767585034	0.692820323027551	6	2	4
fam1897	4	4	2	3.3333333333333335	1.1547005383792515	0.3464101615137754	4	2	2
fam1898	3	4	3	3.3333333333333335	0.5773502691896258	0.17320508075688776	4	3	1
fam1899	2	5	4	3.6666666666666665	1.5275252316519468	0.41659779045053097	5	2	3
fam1900	2	7	2	3.6666666666666665	2.886751345948129	0.787295821622217	7	2	5
fam1901	2	7	2	3.6666666666666665	2.886751345948129	0.787295821622217	7	2	5
fam1902	2	7	2	3.6666666666666665	2.886751345948129	0.787295821622217	7	2	5
fam1903	2	5	4	3.6666666666666665	1.5275252316519468	0.41659779045053097	5	2	3
fam1904	2	6	3	3.6666666666666665	2.081665999466133	0.5677270907634908	6	2	4
fam1905	3	3	3	3.0	0.0	0.0	3	3	0
fam1906	3	3	3	3.0	0.0	0.0	3	3	0
fam1907	3	3	3	3.0	0.0	0.0	3	3	0
fam1908	3	3	3	3.0	0.0	0.0	3	3	0
fam1909	3	3	3	3.0	0.0	0.0	3	3	0
fam1910	3	3	3	3.0	0.0	0.0	3	3	0
fam1911	3	3	3	3.0	0.0	0.0	3	3	0
fam1912	3	3	3	3.0	0.0	0.0	3	3	0
fam1913	3	3	3	3.0	0.0	0.0	3	3	0
fam1914	3	3	3	3.0	0.0	0.0	3	3	0
fam1915	3	3	3	3.0	0.0	0.0	3	3	0
fam1916	3	3	3	3.0	0.0	0.0	3	3	0
fam1917	3	3	3	3.0	0.0	0.0	3	3	0
fam1918	3	3	3	3.0	0.0	0.0	3	3	0
fam1919	3	3	3	3.0	0.0	0.0	3	3	0
fam1920	3	3	3	3.0	0.0	0.0	3	3	0
fam1921	3	3	3	3.0	0.0	0.0	3	3	0
fam1922	3	3	3	3.0	0.0	0.0	3	3	0
fam1923	3	3	3	3.0	0.0	0.0	3	3	0
fam1924	3	3	3	3.0	0.0	0.0	3	3	0
fam1925	3	3	3	3.0	0.0	0.0	3	3	0
fam1926	3	3	3	3.0	0.0	0.0	3	3	0
fam1927	3	3	3	3.0	0.0	0.0	3	3	0
fam1928	3	3	3	3.0	0.0	0.0	3	3	0
fam1929	3	3	3	3.0	0.0	0.0	3	3	0
fam1930	3	3	3	3.0	0.0	0.0	3	3	0
fam1931	3	3	3	3.0	0.0	0.0	3	3	0
fam1932	3	3	3	3.0	0.0	0.0	3	3	0
fam1933	3	3	3	3.0	0.0	0.0	3	3	0
fam1934	3	3	3	3.0	0.0	0.0	3	3	0
fam1935	3	3	3	3.0	0.0	0.0	3	3	0
fam1936	2	4	4	3.3333333333333335	1.1547005383792515	0.3464101615137754	4	2	2
fam1937	2	4	3	3.0	1.0	0.3333333333333333	4	2	2
fam1938	2	4	3	3.0	1.0	0.3333333333333333	4	2	2
fam1939	2	4	4	3.3333333333333335	1.1547005383792515	0.3464101615137754	4	2	2
fam1940	2	3	4	3.0	1.0	0.3333333333333333	4	2	2
fam1941	2	3	4	3.0	1.0	0.3333333333333333	4	2	2
fam1942	4	3	2	3.0	1.0	0.3333333333333333	4	2	2
fam1943	2	4	4	3.3333333333333335	1.1547005383792515	0.3464101615137754	4	2	2
fam1944	3	4	2	3.0	1.0	0.3333333333333333	4	2	2
fam1945	4	4	2	3.3333333333333335	1.1547005383792515	0.3464101615137754	4	2	2
fam1946	4	3	2	3.0	1.0	0.3333333333333333	4	2	2
fam1947	3	2	4	3.0	1.0	0.3333333333333333	4	2	2
fam1948	3	4	2	3.0	1.0	0.3333333333333333	4	2	2
fam1949	2	4	4	3.3333333333333335	1.1547005383792515	0.3464101615137754	4	2	2
fam1950	3	4	2	3.0	1.0	0.3333333333333333	4	2	2
fam1951	3	4	2	3.0	1.0	0.3333333333333333	4	2	2
fam1952	2	3	4	3.0	1.0	0.3333333333333333	4	2	2
fam1953	2	4	4	3.3333333333333335	1.1547005383792515	0.3464101615137754	4	2	2
fam1954	3	2	4	3.0	1.0	0.3333333333333333	4	2	2
fam1955	2	3	4	3.0	1.0	0.3333333333333333	4	2	2
fam1956	2	3	4	3.0	1.0	0.3333333333333333	4	2	2
fam1957	3	4	2	3.0	1.0	0.3333333333333333	4	2	2
fam1958	2	4	4	3.3333333333333335	1.1547005383792515	0.3464101615137754	4	2	2
fam1959	2	4	4	3.3333333333333335	1.1547005383792515	0.3464101615137754	4	2	2
fam1960	2	4	3	3.0	1.0	0.3333333333333333	4	2	2
fam1961	2	4	4	3.3333333333333335	1.1547005383792515	0.3464101615137754	4	2	2
fam1962	2	4	3	3.0	1.0	0.3333333333333333	4	2	2
fam1963	2	4	4	3.3333333333333335	1.1547005383792515	0.3464101615137754	4	2	2
fam1964	2	4	4	3.3333333333333335	1.1547005383792515	0.3464101615137754	4	2	2
fam1965	2	4	3	3.0	1.0	0.3333333333333333	4	2	2
fam1966	3	2	4	3.0	1.0	0.3333333333333333	4	2	2
fam1967	3	2	4	3.0	1.0	0.3333333333333333	4	2	2
fam1968	2	4	4	3.3333333333333335	1.1547005383792515	0.3464101615137754	4	2	2
fam1969	2	3	4	3.0	1.0	0.3333333333333333	4	2	2
fam1970	3	2	4	3.0	1.0	0.3333333333333333	4	2	2
fam1971	2	3	4	3.0	1.0	0.3333333333333333	4	2	2
fam1972	2	4	4	3.3333333333333335	1.1547005383792515	0.3464101615137754	4	2	2
fam1973	2	4	3	3.0	1.0	0.3333333333333333	4	2	2
fam1974	2	4	3	3.0	1.0	0.3333333333333333	4	2	2
fam1975	4	3	2	3.0	1.0	0.3333333333333333	4	2	2
fam1976	2	4	4	3.3333333333333335	1.1547005383792515	0.3464101615137754	4	2	2
fam1977	2	4	3	3.0	1.0	0.3333333333333333	4	2	2
fam1978	2	4	4	3.3333333333333335	1.1547005383792515	0.3464101615137754	4	2	2
fam1979	3	4	2	3.0	1.0	0.3333333333333333	4	2	2
fam1980	2	3	4	3.0	1.0	0.3333333333333333	4	2	2
fam1981	2	4	4	3.3333333333333335	1.1547005383792515	0.3464101615137754	4	2	2
fam1982	2	4	4	3.3333333333333335	1.1547005383792515	0.3464101615137754	4	2	2
fam1983	2	4	4	3.3333333333333335	1.1547005383792515	0.3464101615137754	4	2	2
fam1984	2	4	4	3.3333333333333335	1.1547005383792515	0.3464101615137754	4	2	2
fam1985	4	2	3	3.0	1.0	0.3333333333333333	4	2	2
fam1986	2	4	4	3.3333333333333335	1.1547005383792515	0.3464101615137754	4	2	2
fam1987	4	3	2	3.0	1.0	0.3333333333333333	4	2	2
fam1988	2	4	4	3.3333333333333335	1.1547005383792515	0.3464101615137754	4	2	2
fam1989	2	3	4	3.0	1.0	0.3333333333333333	4	2	2
fam1990	2	4	3	3.0	1.0	0.3333333333333333	4	2	2
fam1991	2	4	4	3.3333333333333335	1.1547005383792515	0.3464101615137754	4	2	2
fam1992	2	4	3	3.0	1.0	0.3333333333333333	4	2	2
fam1993	4	4	2	3.3333333333333335	1.1547005383792515	0.3464101615137754	4	2	2
fam1994	2	4	4	3.3333333333333335	1.1547005383792515	0.3464101615137754	4	2	2
fam1995	2	4	4	3.3333333333333335	1.1547005383792515	0.3464101615137754	4	2	2
fam1996	4	2	4	3.3333333333333335	1.1547005383792515	0.3464101615137754	4	2	2
fam1997	2	4	3	3.0	1.0	0.3333333333333333	4	2	2
fam1998	2	4	3	3.0	1.0	0.3333333333333333	4	2	2
fam1999	2	3	4	3.0	1.0	0.3333333333333333	4	2	2
fam2000	3	2	4	3.0	1.0	0.3333333333333333	4	2	2
fam2001	2	4	4	3.3333333333333335	1.1547005383792515	0.3464101615137754	4	2	2
fam2002	2	4	4	3.3333333333333335	1.1547005383792515	0.3464101615137754	4	2	2
fam2003	3	4	2	3.0	1.0	0.3333333333333333	4	2	2
fam2004	2	4	4	3.3333333333333335	1.1547005383792515	0.3464101615137754	4	2	2
fam2005	2	4	4	3.3333333333333335	1.1547005383792515	0.3464101615137754	4	2	2
fam2006	4	3	2	3.0	1.0	0.3333333333333333	4	2	2
fam2007	4	4	2	3.3333333333333335	1.1547005383792515	0.3464101615137754	4	2	2
fam2008	4	4	2	3.3333333333333335	1.1547005383792515	0.3464101615137754	4	2	2
fam2009	2	3	4	3.0	1.0	0.3333333333333333	4	2	2
fam2010	3	4	2	3.0	1.0	0.3333333333333333	4	2	2
fam2011	2	3	4	3.0	1.0	0.3333333333333333	4	2	2
fam2012	2	3	4	3.0	1.0	0.3333333333333333	4	2	2
fam2013	2	4	3	3.0	1.0	0.3333333333333333	4	2	2
fam2014	2	4	3	3.0	1.0	0.3333333333333333	4	2	2
fam2015	2	4	4	3.3333333333333335	1.1547005383792515	0.3464101615137754	4	2	2
fam2016	2	4	3	3.0	1.0	0.3333333333333333	4	2	2
fam2017	2	4	4	3.3333333333333335	1.1547005383792515	0.3464101615137754	4	2	2
fam2018	3	2	4	3.0	1.0	0.3333333333333333	4	2	2
fam2019	2	3	4	3.0	1.0	0.3333333333333333	4	2	2
fam2020	2	4	3	3.0	1.0	0.3333333333333333	4	2	2
fam2021	2	4	3	3.0	1.0	0.3333333333333333	4	2	2
fam2022	2	3	4	3.0	1.0	0.3333333333333333	4	2	2
fam2023	3	2	4	3.0	1.0	0.3333333333333333	4	2	2
fam2024	2	4	3	3.0	1.0	0.3333333333333333	4	2	2
fam2025	2	4	4	3.3333333333333335	1.1547005383792515	0.3464101615137754	4	2	2
fam2026	2	4	3	3.0	1.0	0.3333333333333333	4	2	2
fam2027	2	4	4	3.3333333333333335	1.1547005383792515	0.3464101615137754	4	2	2
fam2028	2	4	4	3.3333333333333335	1.1547005383792515	0.3464101615137754	4	2	2
fam2029	2	4	3	3.0	1.0	0.3333333333333333	4	2	2
fam2030	2	3	4	3.0	1.0	0.3333333333333333	4	2	2
fam2031	2	4	4	3.3333333333333335	1.1547005383792515	0.3464101615137754	4	2	2
fam2032	2	4	4	3.3333333333333335	1.1547005383792515	0.3464101615137754	4	2	2
fam2033	2	3	4	3.0	1.0	0.3333333333333333	4	2	2
fam2034	2	4	4	3.3333333333333335	1.1547005383792515	0.3464101615137754	4	2	2
fam2035	2	3	4	3.0	1.0	0.3333333333333333	4	2	2
fam2036	2	4	4	3.3333333333333335	1.1547005383792515	0.3464101615137754	4	2	2
fam2037	2	4	3	3.0	1.0	0.3333333333333333	4	2	2
fam2038	2	4	3	3.0	1.0	0.3333333333333333	4	2	2
fam2039	2	4	4	3.3333333333333335	1.1547005383792515	0.3464101615137754	4	2	2
fam2040	2	4	4	3.3333333333333335	1.1547005383792515	0.3464101615137754	4	2	2
fam2041	3	4	2	3.0	1.0	0.3333333333333333	4	2	2
fam2042	4	2	3	3.0	1.0	0.3333333333333333	4	2	2
fam2043	3	2	4	3.0	1.0	0.3333333333333333	4	2	2
fam2044	2	4	3	3.0	1.0	0.3333333333333333	4	2	2
fam2045	2	3	4	3.0	1.0	0.3333333333333333	4	2	2
fam2046	4	2	3	3.0	1.0	0.3333333333333333	4	2	2
fam2047	2	4	3	3.0	1.0	0.3333333333333333	4	2	2
fam2048	2	4	3	3.0	1.0	0.3333333333333333	4	2	2
fam2049	2	4	3	3.0	1.0	0.3333333333333333	4	2	2
fam2050	2	4	4	3.3333333333333335	1.1547005383792515	0.3464101615137754	4	2	2
fam2051	2	4	4	3.3333333333333335	1.1547005383792515	0.3464101615137754	4	2	2
fam2052	2	3	4	3.0	1.0	0.3333333333333333	4	2	2
fam2053	4	3	2	3.0	1.0	0.3333333333333333	4	2	2
fam2054	2	4	4	3.3333333333333335	1.1547005383792515	0.3464101615137754	4	2	2
fam2055	2	4	3	3.0	1.0	0.3333333333333333	4	2	2
fam2056	2	4	4	3.3333333333333335	1.1547005383792515	0.3464101615137754	4	2	2
fam2057	2	4	4	3.3333333333333335	1.1547005383792515	0.3464101615137754	4	2	2
fam2058	2	4	4	3.3333333333333335	1.1547005383792515	0.3464101615137754	4	2	2
fam2059	2	4	4	3.3333333333333335	1.1547005383792515	0.3464101615137754	4	2	2
fam2060	2	4	4	3.3333333333333335	1.1547005383792515	0.3464101615137754	4	2	2
fam2061	2	4	4	3.3333333333333335	1.1547005383792515	0.3464101615137754	4	2	2
fam2062	2	4	3	3.0	1.0	0.3333333333333333	4	2	2
fam2063	2	4	4	3.3333333333333335	1.1547005383792515	0.3464101615137754	4	2	2
fam2064	2	4	3	3.0	1.0	0.3333333333333333	4	2	2
fam2065	2	4	4	3.3333333333333335	1.1547005383792515	0.3464101615137754	4	2	2
fam2066	4	4	2	3.3333333333333335	1.1547005383792515	0.3464101615137754	4	2	2
fam2067	4	4	2	3.3333333333333335	1.1547005383792515	0.3464101615137754	4	2	2
fam2068	2	4	4	3.3333333333333335	1.1547005383792515	0.3464101615137754	4	2	2
fam2069	2	4	4	3.3333333333333335	1.1547005383792515	0.3464101615137754	4	2	2
fam2070	2	4	3	3.0	1.0	0.3333333333333333	4	2	2
fam2071	2	4	4	3.3333333333333335	1.1547005383792515	0.3464101615137754	4	2	2
fam2072	2	4	4	3.3333333333333335	1.1547005383792515	0.3464101615137754	4	2	2
fam2073	2	3	4	3.0	1.0	0.3333333333333333	4	2	2
fam2074	2	4	4	3.3333333333333335	1.1547005383792515	0.3464101615137754	4	2	2
fam2075	2	4	3	3.0	1.0	0.3333333333333333	4	2	2
fam2076	2	3	4	3.0	1.0	0.3333333333333333	4	2	2
fam2077	2	4	4	3.3333333333333335	1.1547005383792515	0.3464101615137754	4	2	2
fam2078	2	4	3	3.0	1.0	0.3333333333333333	4	2	2
fam2079	2	4	4	3.3333333333333335	1.1547005383792515	0.3464101615137754	4	2	2
fam2080	2	4	4	3.3333333333333335	1.1547005383792515	0.3464101615137754	4	2	2
fam2081	2	3	4	3.0	1.0	0.3333333333333333	4	2	2
fam2082	2	4	4	3.3333333333333335	1.1547005383792515	0.3464101615137754	4	2	2
fam2083	2	4	4	3.3333333333333335	1.1547005383792515	0.3464101615137754	4	2	2
fam2084	2	4	4	3.3333333333333335	1.1547005383792515	0.3464101615137754	4	2	2
fam2085	2	3	4	3.0	1.0	0.3333333333333333	4	2	2
fam2086	2	4	4	3.3333333333333335	1.1547005383792515	0.3464101615137754	4	2	2
fam2087	2	4	4	3.3333333333333335	1.1547005383792515	0.3464101615137754	4	2	2
fam2088	2	4	3	3.0	1.0	0.3333333333333333	4	2	2
fam2089	2	3	4	3.0	1.0	0.3333333333333333	4	2	2
fam2090	3	4	2	3.0	1.0	0.3333333333333333	4	2	2
fam2091	2	4	4	3.3333333333333335	1.1547005383792515	0.3464101615137754	4	2	2
fam2092	3	2	4	3.0	1.0	0.3333333333333333	4	2	2
fam2093	2	4	4	3.3333333333333335	1.1547005383792515	0.3464101615137754	4	2	2
fam2094	2	4	4	3.3333333333333335	1.1547005383792515	0.3464101615137754	4	2	2
fam2095	3	4	2	3.0	1.0	0.3333333333333333	4	2	2
fam2096	2	4	3	3.0	1.0	0.3333333333333333	4	2	2
fam2097	3	4	2	3.0	1.0	0.3333333333333333	4	2	2
fam2098	2	4	3	3.0	1.0	0.3333333333333333	4	2	2
fam2099	3	4	2	3.0	1.0	0.3333333333333333	4	2	2
fam2100	3	2	4	3.0	1.0	0.3333333333333333	4	2	2
fam2101	4	2	3	3.0	1.0	0.3333333333333333	4	2	2
fam2102	3	4	2	3.0	1.0	0.3333333333333333	4	2	2
fam2103	4	2	4	3.3333333333333335	1.1547005383792515	0.3464101615137754	4	2	2
fam2104	2	4	4	3.3333333333333335	1.1547005383792515	0.3464101615137754	4	2	2
fam2105	2	4	4	3.3333333333333335	1.1547005383792515	0.3464101615137754	4	2	2
fam2106	2	4	3	3.0	1.0	0.3333333333333333	4	2	2
fam2107	2	4	4	3.3333333333333335	1.1547005383792515	0.3464101615137754	4	2	2
fam2108	4	4	2	3.3333333333333335	1.1547005383792515	0.3464101615137754	4	2	2
fam2109	5	3	2	3.3333333333333335	1.5275252316519465	0.45825756949558394	5	2	3
fam2110	2	3	5	3.3333333333333335	1.5275252316519465	0.45825756949558394	5	2	3
fam2111	2	3	5	3.3333333333333335	1.5275252316519465	0.45825756949558394	5	2	3
fam2112	5	2	3	3.3333333333333335	1.5275252316519468	0.458257569495584	5	2	3
fam2113	2	5	3	3.3333333333333335	1.5275252316519468	0.458257569495584	5	2	3
fam2114	2	5	2	3.0	1.7320508075688772	0.5773502691896257	5	2	3
fam2115	2	3	5	3.3333333333333335	1.5275252316519465	0.45825756949558394	5	2	3
fam2116	2	5	3	3.3333333333333335	1.5275252316519468	0.458257569495584	5	2	3
fam2117	2	3	5	3.3333333333333335	1.5275252316519465	0.45825756949558394	5	2	3
fam2118	2	5	2	3.0	1.7320508075688772	0.5773502691896257	5	2	3
fam2119	2	5	2	3.0	1.7320508075688772	0.5773502691896257	5	2	3
fam2120	2	5	3	3.3333333333333335	1.5275252316519468	0.458257569495584	5	2	3
fam2121	2	5	3	3.3333333333333335	1.5275252316519468	0.458257569495584	5	2	3
fam2122	2	5	3	3.3333333333333335	1.5275252316519468	0.458257569495584	5	2	3
fam2123	2	3	5	3.3333333333333335	1.5275252316519465	0.45825756949558394	5	2	3
fam2124	2	3	5	3.3333333333333335	1.5275252316519465	0.45825756949558394	5	2	3
fam2125	2	5	2	3.0	1.7320508075688772	0.5773502691896257	5	2	3
fam2126	2	5	3	3.3333333333333335	1.5275252316519468	0.458257569495584	5	2	3
fam2127	2	5	3	3.3333333333333335	1.5275252316519468	0.458257569495584	5	2	3
fam2128	2	5	2	3.0	1.7320508075688772	0.5773502691896257	5	2	3
fam2129	5	2	2	3.0	1.7320508075688772	0.5773502691896257	5	2	3
fam2130	2	5	3	3.3333333333333335	1.5275252316519468	0.458257569495584	5	2	3
fam2131	2	5	3	3.3333333333333335	1.5275252316519468	0.458257569495584	5	2	3
fam2132	2	5	2	3.0	1.7320508075688772	0.5773502691896257	5	2	3
fam2133	2	3	5	3.3333333333333335	1.5275252316519465	0.45825756949558394	5	2	3
fam2134	2	5	2	3.0	1.7320508075688772	0.5773502691896257	5	2	3
fam2135	2	3	5	3.3333333333333335	1.5275252316519465	0.45825756949558394	5	2	3
fam2136	2	5	2	3.0	1.7320508075688772	0.5773502691896257	5	2	3
fam2137	2	5	3	3.3333333333333335	1.5275252316519468	0.458257569495584	5	2	3
fam2138	3	5	2	3.3333333333333335	1.5275252316519465	0.45825756949558394	5	2	3
fam2139	2	5	3	3.3333333333333335	1.5275252316519468	0.458257569495584	5	2	3
fam2140	2	5	3	3.3333333333333335	1.5275252316519468	0.458257569495584	5	2	3
fam2141	2	5	3	3.3333333333333335	1.5275252316519468	0.458257569495584	5	2	3
fam2142	2	5	3	3.3333333333333335	1.5275252316519468	0.458257569495584	5	2	3
fam2143	5	2	2	3.0	1.7320508075688772	0.5773502691896257	5	2	3
fam2144	2	5	3	3.3333333333333335	1.5275252316519468	0.458257569495584	5	2	3
fam2145	2	5	2	3.0	1.7320508075688772	0.5773502691896257	5	2	3
fam2146	2	5	2	3.0	1.7320508075688772	0.5773502691896257	5	2	3
fam2147	2	3	5	3.3333333333333335	1.5275252316519465	0.45825756949558394	5	2	3
fam2148	2	3	5	3.3333333333333335	1.5275252316519465	0.45825756949558394	5	2	3
fam2149	2	5	3	3.3333333333333335	1.5275252316519468	0.458257569495584	5	2	3
fam2150	5	2	3	3.3333333333333335	1.5275252316519468	0.458257569495584	5	2	3
fam2151	2	3	5	3.3333333333333335	1.5275252316519465	0.45825756949558394	5	2	3
fam2152	2	5	2	3.0	1.7320508075688772	0.5773502691896257	5	2	3
fam2153	5	3	2	3.3333333333333335	1.5275252316519465	0.45825756949558394	5	2	3
fam2154	2	5	3	3.3333333333333335	1.5275252316519468	0.458257569495584	5	2	3
fam2155	5	2	2	3.0	1.7320508075688772	0.5773502691896257	5	2	3
fam2156	5	2	2	3.0	1.7320508075688772	0.5773502691896257	5	2	3
fam2157	2	5	3	3.3333333333333335	1.5275252316519468	0.458257569495584	5	2	3
fam2158	2	3	5	3.3333333333333335	1.5275252316519465	0.45825756949558394	5	2	3
fam2159	2	3	5	3.3333333333333335	1.5275252316519465	0.45825756949558394	5	2	3
fam2160	3	5	2	3.3333333333333335	1.5275252316519465	0.45825756949558394	5	2	3
fam2161	2	5	3	3.3333333333333335	1.5275252316519468	0.458257569495584	5	2	3
fam2162	2	5	3	3.3333333333333335	1.5275252316519468	0.458257569495584	5	2	3
fam2163	2	5	3	3.3333333333333335	1.5275252316519468	0.458257569495584	5	2	3
fam2164	2	5	2	3.0	1.7320508075688772	0.5773502691896257	5	2	3
fam2165	2	5	3	3.3333333333333335	1.5275252316519468	0.458257569495584	5	2	3
fam2166	2	5	3	3.3333333333333335	1.5275252316519468	0.458257569495584	5	2	3
fam2167	2	5	3	3.3333333333333335	1.5275252316519468	0.458257569495584	5	2	3
fam2168	2	5	2	3.0	1.7320508075688772	0.5773502691896257	5	2	3
fam2169	3	5	2	3.3333333333333335	1.5275252316519465	0.45825756949558394	5	2	3
fam2170	2	5	2	3.0	1.7320508075688772	0.5773502691896257	5	2	3
fam2171	2	5	3	3.3333333333333335	1.5275252316519468	0.458257569495584	5	2	3
fam2172	2	3	5	3.3333333333333335	1.5275252316519465	0.45825756949558394	5	2	3
fam2173	5	2	2	3.0	1.7320508075688772	0.5773502691896257	5	2	3
fam2174	2	5	3	3.3333333333333335	1.5275252316519468	0.458257569495584	5	2	3
fam2175	2	5	3	3.3333333333333335	1.5275252316519468	0.458257569495584	5	2	3
fam2176	2	3	5	3.3333333333333335	1.5275252316519465	0.45825756949558394	5	2	3
fam2177	3	5	2	3.3333333333333335	1.5275252316519465	0.45825756949558394	5	2	3
fam2178	3	2	5	3.3333333333333335	1.5275252316519465	0.45825756949558394	5	2	3
fam2179	2	5	2	3.0	1.7320508075688772	0.5773502691896257	5	2	3
fam2180	2	5	3	3.3333333333333335	1.5275252316519468	0.458257569495584	5	2	3
fam2181	2	5	3	3.3333333333333335	1.5275252316519468	0.458257569495584	5	2	3
fam2182	2	5	3	3.3333333333333335	1.5275252316519468	0.458257569495584	5	2	3
fam2183	2	5	2	3.0	1.7320508075688772	0.5773502691896257	5	2	3
fam2184	2	5	3	3.3333333333333335	1.5275252316519468	0.458257569495584	5	2	3
fam2185	2	5	2	3.0	1.7320508075688772	0.5773502691896257	5	2	3
fam2186	2	5	3	3.3333333333333335	1.5275252316519468	0.458257569495584	5	2	3
fam2187	2	5	3	3.3333333333333335	1.5275252316519468	0.458257569495584	5	2	3
fam2188	2	5	2	3.0	1.7320508075688772	0.5773502691896257	5	2	3
fam2189	2	5	2	3.0	1.7320508075688772	0.5773502691896257	5	2	3
fam2190	2	5	3	3.3333333333333335	1.5275252316519468	0.458257569495584	5	2	3
fam2191	2	3	5	3.3333333333333335	1.5275252316519465	0.45825756949558394	5	2	3
fam2192	2	5	3	3.3333333333333335	1.5275252316519468	0.458257569495584	5	2	3
fam2193	2	3	5	3.3333333333333335	1.5275252316519465	0.45825756949558394	5	2	3
fam2194	2	5	3	3.3333333333333335	1.5275252316519468	0.458257569495584	5	2	3
fam2195	2	2	5	3.0	1.7320508075688772	0.5773502691896257	5	2	3
fam2196	2	5	2	3.0	1.7320508075688772	0.5773502691896257	5	2	3
fam2197	2	5	2	3.0	1.7320508075688772	0.5773502691896257	5	2	3
fam2198	2	3	5	3.3333333333333335	1.5275252316519465	0.45825756949558394	5	2	3
fam2199	2	3	5	3.3333333333333335	1.5275252316519465	0.45825756949558394	5	2	3
fam2200	2	3	5	3.3333333333333335	1.5275252316519465	0.45825756949558394	5	2	3
fam2201	2	3	5	3.3333333333333335	1.5275252316519465	0.45825756949558394	5	2	3
fam2202	2	5	2	3.0	1.7320508075688772	0.5773502691896257	5	2	3
fam2203	2	5	2	3.0	1.7320508075688772	0.5773502691896257	5	2	3
fam2204	2	5	3	3.3333333333333335	1.5275252316519468	0.458257569495584	5	2	3
fam2205	2	5	3	3.3333333333333335	1.5275252316519468	0.458257569495584	5	2	3
fam2206	3	5	2	3.3333333333333335	1.5275252316519465	0.45825756949558394	5	2	3
fam2207	2	2	5	3.0	1.7320508075688772	0.5773502691896257	5	2	3
fam2208	2	5	2	3.0	1.7320508075688772	0.5773502691896257	5	2	3
fam2209	2	5	3	3.3333333333333335	1.5275252316519468	0.458257569495584	5	2	3
fam2210	2	5	3	3.3333333333333335	1.5275252316519468	0.458257569495584	5	2	3
fam2211	2	5	3	3.3333333333333335	1.5275252316519468	0.458257569495584	5	2	3
fam2212	2	5	3	3.3333333333333335	1.5275252316519468	0.458257569495584	5	2	3
fam2213	2	5	3	3.3333333333333335	1.5275252316519468	0.458257569495584	5	2	3
fam2214	2	3	5	3.3333333333333335	1.5275252316519465	0.45825756949558394	5	2	3
fam2215	2	5	2	3.0	1.7320508075688772	0.5773502691896257	5	2	3
fam2216	2	5	3	3.3333333333333335	1.5275252316519468	0.458257569495584	5	2	3
fam2217	2	5	2	3.0	1.7320508075688772	0.5773502691896257	5	2	3
fam2218	2	3	5	3.3333333333333335	1.5275252316519465	0.45825756949558394	5	2	3
fam2219	2	5	3	3.3333333333333335	1.5275252316519468	0.458257569495584	5	2	3
fam2220	5	3	2	3.3333333333333335	1.5275252316519465	0.45825756949558394	5	2	3
fam2221	2	3	5	3.3333333333333335	1.5275252316519465	0.45825756949558394	5	2	3
fam2222	3	2	5	3.3333333333333335	1.5275252316519465	0.45825756949558394	5	2	3
fam2223	2	5	3	3.3333333333333335	1.5275252316519468	0.458257569495584	5	2	3
fam2224	4	2	4	3.3333333333333335	1.1547005383792515	0.3464101615137754	4	2	2
fam2225	2	5	2	3.0	1.7320508075688772	0.5773502691896257	5	2	3
fam2226	2	5	2	3.0	1.7320508075688772	0.5773502691896257	5	2	3
fam2227	2	5	3	3.3333333333333335	1.5275252316519468	0.458257569495584	5	2	3
fam2228	2	3	5	3.3333333333333335	1.5275252316519465	0.45825756949558394	5	2	3
fam2229	2	3	5	3.3333333333333335	1.5275252316519465	0.45825756949558394	5	2	3
fam2230	2	3	5	3.3333333333333335	1.5275252316519465	0.45825756949558394	5	2	3
fam2231	2	4	3	3.0	1.0	0.3333333333333333	4	2	2
fam2232	2	3	4	3.0	1.0	0.3333333333333333	4	2	2
fam2233	3	3	3	3.0	0.0	0.0	3	3	0
fam2234	4	4	2	3.3333333333333335	1.1547005383792515	0.3464101615137754	4	2	2
fam2235	2	4	4	3.3333333333333335	1.1547005383792515	0.3464101615137754	4	2	2
fam2236	2	4	4	3.3333333333333335	1.1547005383792515	0.3464101615137754	4	2	2
fam2237	2	4	4	3.3333333333333335	1.1547005383792515	0.3464101615137754	4	2	2
fam2238	2	6	2	3.3333333333333335	2.3094010767585034	0.692820323027551	6	2	4
fam2239	2	6	2	3.3333333333333335	2.3094010767585034	0.692820323027551	6	2	4
fam2240	2	6	2	3.3333333333333335	2.3094010767585034	0.692820323027551	6	2	4
fam2241	2	6	2	3.3333333333333335	2.3094010767585034	0.692820323027551	6	2	4
fam2242	2	6	2	3.3333333333333335	2.3094010767585034	0.692820323027551	6	2	4
fam2243	2	4	4	3.3333333333333335	1.1547005383792515	0.3464101615137754	4	2	2
fam2244	2	2	6	3.3333333333333335	2.3094010767585034	0.692820323027551	6	2	4
fam2245	2	6	2	3.3333333333333335	2.3094010767585034	0.692820323027551	6	2	4
fam2246	2	6	2	3.3333333333333335	2.3094010767585034	0.692820323027551	6	2	4
fam2247	2	6	2	3.3333333333333335	2.3094010767585034	0.692820323027551	6	2	4
fam2248	2	2	6	3.3333333333333335	2.3094010767585034	0.692820323027551	6	2	4
fam2249	3	3	3	3.0	0.0	0.0	3	3	0
fam2250	2	6	2	3.3333333333333335	2.3094010767585034	0.692820323027551	6	2	4
fam2251	2	6	2	3.3333333333333335	2.3094010767585034	0.692820323027551	6	2	4
fam2252	2	6	2	3.3333333333333335	2.3094010767585034	0.692820323027551	6	2	4
fam2253	2	6	2	3.3333333333333335	2.3094010767585034	0.692820323027551	6	2	4
fam2254	2	6	2	3.3333333333333335	2.3094010767585034	0.692820323027551	6	2	4
fam2255	2	6	2	3.3333333333333335	2.3094010767585034	0.692820323027551	6	2	4
fam2256	2	6	2	3.3333333333333335	2.3094010767585034	0.692820323027551	6	2	4
fam2257	2	2	6	3.3333333333333335	2.3094010767585034	0.692820323027551	6	2	4
fam2258	3	3	3	3.0	0.0	0.0	3	3	0
fam2259	2	2	6	3.3333333333333335	2.3094010767585034	0.692820323027551	6	2	4
fam2260	2	2	6	3.3333333333333335	2.3094010767585034	0.692820323027551	6	2	4
fam2261	2	2	6	3.3333333333333335	2.3094010767585034	0.692820323027551	6	2	4
fam2262	2	6	2	3.3333333333333335	2.3094010767585034	0.692820323027551	6	2	4
fam2263	2	6	2	3.3333333333333335	2.3094010767585034	0.692820323027551	6	2	4
fam2264	2	6	2	3.3333333333333335	2.3094010767585034	0.692820323027551	6	2	4
fam2265	2	6	2	3.3333333333333335	2.3094010767585034	0.692820323027551	6	2	4
fam2266	2	6	2	3.3333333333333335	2.3094010767585034	0.692820323027551	6	2	4
fam2267	2	4	4	3.3333333333333335	1.1547005383792515	0.3464101615137754	4	2	2
fam2268	2	6	2	3.3333333333333335	2.3094010767585034	0.692820323027551	6	2	4
fam2269	2	6	2	3.3333333333333335	2.3094010767585034	0.692820323027551	6	2	4
fam2270	2	5	3	3.3333333333333335	1.5275252316519468	0.458257569495584	5	2	3
fam2271	2	6	2	3.3333333333333335	2.3094010767585034	0.692820323027551	6	2	4
fam2272	2	6	2	3.3333333333333335	2.3094010767585034	0.692820323027551	6	2	4
fam2273	2	6	2	3.3333333333333335	2.3094010767585034	0.692820323027551	6	2	4
fam2274	2	6	2	3.3333333333333335	2.3094010767585034	0.692820323027551	6	2	4
fam2275	2	6	2	3.3333333333333335	2.3094010767585034	0.692820323027551	6	2	4
fam2276	2	2	6	3.3333333333333335	2.3094010767585034	0.692820323027551	6	2	4
fam2277	2	6	2	3.3333333333333335	2.3094010767585034	0.692820323027551	6	2	4
fam2278	2	6	2	3.3333333333333335	2.3094010767585034	0.692820323027551	6	2	4
fam2279	2	2	6	3.3333333333333335	2.3094010767585034	0.692820323027551	6	2	4
fam2280	2	6	2	3.3333333333333335	2.3094010767585034	0.692820323027551	6	2	4
fam2281	2	2	6	3.3333333333333335	2.3094010767585034	0.692820323027551	6	2	4
fam2282	2	6	2	3.3333333333333335	2.3094010767585034	0.692820323027551	6	2	4
fam2283	2	6	2	3.3333333333333335	2.3094010767585034	0.692820323027551	6	2	4
fam2284	2	2	6	3.3333333333333335	2.3094010767585034	0.692820323027551	6	2	4
fam2285	2	3	4	3.0	1.0	0.3333333333333333	4	2	2
fam2286	2	6	2	3.3333333333333335	2.3094010767585034	0.692820323027551	6	2	4
fam2287	2	2	6	3.3333333333333335	2.3094010767585034	0.692820323027551	6	2	4
fam2288	2	2	6	3.3333333333333335	2.3094010767585034	0.692820323027551	6	2	4
fam2289	2	6	2	3.3333333333333335	2.3094010767585034	0.692820323027551	6	2	4
fam2290	2	2	6	3.3333333333333335	2.3094010767585034	0.692820323027551	6	2	4
fam2291	2	4	4	3.3333333333333335	1.1547005383792515	0.3464101615137754	4	2	2
fam2292	2	6	2	3.3333333333333335	2.3094010767585034	0.692820323027551	6	2	4
fam2293	2	6	2	3.3333333333333335	2.3094010767585034	0.692820323027551	6	2	4
fam2294	3	2	4	3.0	1.0	0.3333333333333333	4	2	2
fam2295	2	5	3	3.3333333333333335	1.5275252316519468	0.458257569495584	5	2	3
fam2296	2	5	3	3.3333333333333335	1.5275252316519468	0.458257569495584	5	2	3
fam2297	2	6	2	3.3333333333333335	2.3094010767585034	0.692820323027551	6	2	4
fam2298	3	3	3	3.0	0.0	0.0	3	3	0
fam2299	3	3	3	3.0	0.0	0.0	3	3	0
fam2300	2	5	2	3.0	1.7320508075688772	0.5773502691896257	5	2	3
fam2301	2	5	3	3.3333333333333335	1.5275252316519468	0.458257569495584	5	2	3
fam2302	3	5	2	3.3333333333333335	1.5275252316519465	0.45825756949558394	5	2	3
fam2303	2	3	4	3.0	1.0	0.3333333333333333	4	2	2
fam2304	3	4	2	3.0	1.0	0.3333333333333333	4	2	2
fam2305	2	4	4	3.3333333333333335	1.1547005383792515	0.3464101615137754	4	2	2
fam2306	2	5	3	3.3333333333333335	1.5275252316519468	0.458257569495584	5	2	3
fam2307	2	5	3	3.3333333333333335	1.5275252316519468	0.458257569495584	5	2	3
fam2308	2	5	3	3.3333333333333335	1.5275252316519468	0.458257569495584	5	2	3
fam2309	3	3	3	3.0	0.0	0.0	3	3	0
fam2310	2	4	3	3.0	1.0	0.3333333333333333	4	2	2
fam2311	3	3	3	3.0	0.0	0.0	3	3	0
fam2312	2	4	4	3.3333333333333335	1.1547005383792515	0.3464101615137754	4	2	2
fam2313	2	4	4	3.3333333333333335	1.1547005383792515	0.3464101615137754	4	2	2
fam2314	2	4	4	3.3333333333333335	1.1547005383792515	0.3464101615137754	4	2	2
fam2315	2	4	4	3.3333333333333335	1.1547005383792515	0.3464101615137754	4	2	2
fam2316	2	2	7	3.6666666666666665	2.886751345948129	0.787295821622217	7	2	5
fam2317	2	7	2	3.6666666666666665	2.886751345948129	0.787295821622217	7	2	5
fam2318	2	7	2	3.6666666666666665	2.886751345948129	0.787295821622217	7	2	5
fam2319	2	3	4	3.0	1.0	0.3333333333333333	4	2	2
fam2320	2	7	2	3.6666666666666665	2.886751345948129	0.787295821622217	7	2	5
fam2321	2	7	2	3.6666666666666665	2.886751345948129	0.787295821622217	7	2	5
fam2322	2	7	2	3.6666666666666665	2.886751345948129	0.787295821622217	7	2	5
fam2323	2	2	7	3.6666666666666665	2.886751345948129	0.787295821622217	7	2	5
fam2324	2	7	2	3.6666666666666665	2.886751345948129	0.787295821622217	7	2	5
fam2325	2	7	2	3.6666666666666665	2.886751345948129	0.787295821622217	7	2	5
fam2326	2	7	2	3.6666666666666665	2.886751345948129	0.787295821622217	7	2	5
fam2327	2	7	2	3.6666666666666665	2.886751345948129	0.787295821622217	7	2	5
fam2328	2	7	2	3.6666666666666665	2.886751345948129	0.787295821622217	7	2	5
fam2329	2	7	2	3.6666666666666665	2.886751345948129	0.787295821622217	7	2	5
fam2330	2	2	5	3.0	1.7320508075688772	0.5773502691896257	5	2	3
fam2331	2	7	2	3.6666666666666665	2.886751345948129	0.787295821622217	7	2	5
fam2332	3	3	3	3.0	0.0	0.0	3	3	0
fam2333	2	7	2	3.6666666666666665	2.886751345948129	0.787295821622217	7	2	5
fam2334	2	7	2	3.6666666666666665	2.886751345948129	0.787295821622217	7	2	5
fam2335	2	7	2	3.6666666666666665	2.886751345948129	0.787295821622217	7	2	5
fam2336	2	7	2	3.6666666666666665	2.886751345948129	0.787295821622217	7	2	5
fam2337	2	7	2	3.6666666666666665	2.886751345948129	0.787295821622217	7	2	5
fam2338	2	2	7	3.6666666666666665	2.886751345948129	0.787295821622217	7	2	5
fam2339	2	7	2	3.6666666666666665	2.886751345948129	0.787295821622217	7	2	5
fam2340	2	7	2	3.6666666666666665	2.886751345948129	0.787295821622217	7	2	5
fam2341	2	4	3	3.0	1.0	0.3333333333333333	4	2	2
fam2342	7	2	2	3.6666666666666665	2.886751345948129	0.787295821622217	7	2	5
fam2343	2	7	2	3.6666666666666665	2.886751345948129	0.787295821622217	7	2	5
fam2344	2	7	2	3.6666666666666665	2.886751345948129	0.787295821622217	7	2	5
fam2345	2	7	2	3.6666666666666665	2.886751345948129	0.787295821622217	7	2	5
fam2346	2	7	2	3.6666666666666665	2.886751345948129	0.787295821622217	7	2	5
fam2347	2	7	2	3.6666666666666665	2.886751345948129	0.787295821622217	7	2	5
fam2348	2	7	2	3.6666666666666665	2.886751345948129	0.787295821622217	7	2	5
fam2349	2	7	2	3.6666666666666665	2.886751345948129	0.787295821622217	7	2	5
fam2350	2	6	2	3.3333333333333335	2.3094010767585034	0.692820323027551	6	2	4
fam2351	7	2	2	3.6666666666666665	2.886751345948129	0.787295821622217	7	2	5
fam2352	2	6	2	3.3333333333333335	2.3094010767585034	0.692820323027551	6	2	4
fam2353	2	2	7	3.6666666666666665	2.886751345948129	0.787295821622217	7	2	5
fam2354	2	2	7	3.6666666666666665	2.886751345948129	0.787295821622217	7	2	5
fam2355	2	2	7	3.6666666666666665	2.886751345948129	0.787295821622217	7	2	5
fam2356	2	7	2	3.6666666666666665	2.886751345948129	0.787295821622217	7	2	5
fam2357	2	7	2	3.6666666666666665	2.886751345948129	0.787295821622217	7	2	5
fam2358	2	7	2	3.6666666666666665	2.886751345948129	0.787295821622217	7	2	5
fam2359	7	2	2	3.6666666666666665	2.886751345948129	0.787295821622217	7	2	5
fam2360	5	3	2	3.3333333333333335	1.5275252316519465	0.45825756949558394	5	2	3
fam2361	2	7	2	3.6666666666666665	2.886751345948129	0.787295821622217	7	2	5
fam2362	2	7	2	3.6666666666666665	2.886751345948129	0.787295821622217	7	2	5
fam2363	2	7	2	3.6666666666666665	2.886751345948129	0.787295821622217	7	2	5
fam2364	2	5	2	3.0	1.7320508075688772	0.5773502691896257	5	2	3
fam2365	2	7	2	3.6666666666666665	2.886751345948129	0.787295821622217	7	2	5
fam2366	2	7	2	3.6666666666666665	2.886751345948129	0.787295821622217	7	2	5
fam2367	2	7	2	3.6666666666666665	2.886751345948129	0.787295821622217	7	2	5
fam2368	2	4	3	3.0	1.0	0.3333333333333333	4	2	2
fam2369	2	7	2	3.6666666666666665	2.886751345948129	0.787295821622217	7	2	5
fam2370	7	2	2	3.6666666666666665	2.886751345948129	0.787295821622217	7	2	5
fam2371	2	6	2	3.3333333333333335	2.3094010767585034	0.692820323027551	6	2	4
fam2372	2	6	2	3.3333333333333335	2.3094010767585034	0.692820323027551	6	2	4
fam2373	2	6	2	3.3333333333333335	2.3094010767585034	0.692820323027551	6	2	4
fam2374	2	5	2	3.0	1.7320508075688772	0.5773502691896257	5	2	3
fam2375	4	3	2	3.0	1.0	0.3333333333333333	4	2	2
fam2376	2	5	3	3.3333333333333335	1.5275252316519468	0.458257569495584	5	2	3
fam2377	2	4	3	3.0	1.0	0.3333333333333333	4	2	2
fam2378	2	4	4	3.3333333333333335	1.1547005383792515	0.3464101615137754	4	2	2
fam2379	2	4	3	3.0	1.0	0.3333333333333333	4	2	2
fam2380	5	2	2	3.0	1.7320508075688772	0.5773502691896257	5	2	3
fam2381	4	2	3	3.0	1.0	0.3333333333333333	4	2	2
fam2382	2	6	2	3.3333333333333335	2.3094010767585034	0.692820323027551	6	2	4
fam2383	2	5	2	3.0	1.7320508075688772	0.5773502691896257	5	2	3
fam2384	2	4	3	3.0	1.0	0.3333333333333333	4	2	2
fam2385	3	3	3	3.0	0.0	0.0	3	3	0
fam2386	2	6	2	3.3333333333333335	2.3094010767585034	0.692820323027551	6	2	4
fam2387	2	5	3	3.3333333333333335	1.5275252316519468	0.458257569495584	5	2	3
fam2388	2	5	3	3.3333333333333335	1.5275252316519468	0.458257569495584	5	2	3
fam2389	2	4	4	3.3333333333333335	1.1547005383792515	0.3464101615137754	4	2	2
fam2390	2	5	3	3.3333333333333335	1.5275252316519468	0.458257569495584	5	2	3
fam2391	2	4	4	3.3333333333333335	1.1547005383792515	0.3464101615137754	4	2	2
fam2392	2	4	4	3.3333333333333335	1.1547005383792515	0.3464101615137754	4	2	2
fam2393	3	2	4	3.0	1.0	0.3333333333333333	4	2	2
fam2394	2	4	4	3.3333333333333335	1.1547005383792515	0.3464101615137754	4	2	2
fam2395	2	5	3	3.3333333333333335	1.5275252316519468	0.458257569495584	5	2	3
fam2396	2	5	3	3.3333333333333335	1.5275252316519468	0.458257569495584	5	2	3
fam2397	2	6	2	3.3333333333333335	2.3094010767585034	0.692820323027551	6	2	4
fam2398	2	3	5	3.3333333333333335	1.5275252316519465	0.45825756949558394	5	2	3
fam2399	2	4	4	3.3333333333333335	1.1547005383792515	0.3464101615137754	4	2	2
fam2400	2	3	5	3.3333333333333335	1.5275252316519465	0.45825756949558394	5	2	3
fam2401	2	7	2	3.6666666666666665	2.886751345948129	0.787295821622217	7	2	5
fam2402	2	4	4	3.3333333333333335	1.1547005383792515	0.3464101615137754	4	2	2
fam2403	2	6	2	3.3333333333333335	2.3094010767585034	0.692820323027551	6	2	4
fam2404	2	4	4	3.3333333333333335	1.1547005383792515	0.3464101615137754	4	2	2
fam2405	2	7	2	3.6666666666666665	2.886751345948129	0.787295821622217	7	2	5
fam2406	3	3	3	3.0	0.0	0.0	3	3	0
fam2407	2	2	6	3.3333333333333335	2.3094010767585034	0.692820323027551	6	2	4
fam2408	7	2	2	3.6666666666666665	2.886751345948129	0.787295821622217	7	2	5
fam2409	2	4	4	3.3333333333333335	1.1547005383792515	0.3464101615137754	4	2	2
fam2410	2	2	7	3.6666666666666665	2.886751345948129	0.787295821622217	7	2	5
fam2411	2	7	2	3.6666666666666665	2.886751345948129	0.787295821622217	7	2	5
fam2412	2	7	2	3.6666666666666665	2.886751345948129	0.787295821622217	7	2	5
fam2413	2	7	2	3.6666666666666665	2.886751345948129	0.787295821622217	7	2	5
fam2414	2	7	2	3.6666666666666665	2.886751345948129	0.787295821622217	7	2	5
fam2415	2	4	4	3.3333333333333335	1.1547005383792515	0.3464101615137754	4	2	2
fam2416	2	3	5	3.3333333333333335	1.5275252316519465	0.45825756949558394	5	2	3
fam2417	2	4	4	3.3333333333333335	1.1547005383792515	0.3464101615137754	4	2	2
fam2418	2	5	3	3.3333333333333335	1.5275252316519468	0.458257569495584	5	2	3
fam2419	2	2	6	3.3333333333333335	2.3094010767585034	0.692820323027551	6	2	4
fam2420	2	5	3	3.3333333333333335	1.5275252316519468	0.458257569495584	5	2	3
fam2421	2	4	4	3.3333333333333335	1.1547005383792515	0.3464101615137754	4	2	2
fam2422	2	4	4	3.3333333333333335	1.1547005383792515	0.3464101615137754	4	2	2
fam2423	3	2	5	3.3333333333333335	1.5275252316519465	0.45825756949558394	5	2	3
fam2424	7	2	2	3.6666666666666665	2.886751345948129	0.787295821622217	7	2	5
fam2425	2	5	3	3.3333333333333335	1.5275252316519468	0.458257569495584	5	2	3
fam2426	2	4	4	3.3333333333333335	1.1547005383792515	0.3464101615137754	4	2	2
fam2427	2	6	2	3.3333333333333335	2.3094010767585034	0.692820323027551	6	2	4
fam2428	2	6	2	3.3333333333333335	2.3094010767585034	0.692820323027551	6	2	4
fam2429	5	3	2	3.3333333333333335	1.5275252316519465	0.45825756949558394	5	2	3
fam2430	2	2	6	3.3333333333333335	2.3094010767585034	0.692820323027551	6	2	4
fam2431	2	4	4	3.3333333333333335	1.1547005383792515	0.3464101615137754	4	2	2
fam2432	2	7	2	3.6666666666666665	2.886751345948129	0.787295821622217	7	2	5
fam2433	4	2	4	3.3333333333333335	1.1547005383792515	0.3464101615137754	4	2	2
fam2434	4	4	2	3.3333333333333335	1.1547005383792515	0.3464101615137754	4	2	2
fam2435	2	4	4	3.3333333333333335	1.1547005383792515	0.3464101615137754	4	2	2
fam2436	2	6	2	3.3333333333333335	2.3094010767585034	0.692820323027551	6	2	4
fam2437	3	3	3	3.0	0.0	0.0	3	3	0
fam2438	2	6	2	3.3333333333333335	2.3094010767585034	0.692820323027551	6	2	4
fam2439	4	3	2	3.0	1.0	0.3333333333333333	4	2	2
fam2440	2	6	2	3.3333333333333335	2.3094010767585034	0.692820323027551	6	2	4
fam2441	2	6	2	3.3333333333333335	2.3094010767585034	0.692820323027551	6	2	4
fam2442	3	4	2	3.0	1.0	0.3333333333333333	4	2	2
fam2443	5	2	2	3.0	1.7320508075688772	0.5773502691896257	5	2	3
fam2444	2	6	2	3.3333333333333335	2.3094010767585034	0.692820323027551	6	2	4
fam2445	2	5	3	3.3333333333333335	1.5275252316519468	0.458257569495584	5	2	3
fam2446	3	3	3	3.0	0.0	0.0	3	3	0
fam2447	2	5	3	3.3333333333333335	1.5275252316519468	0.458257569495584	5	2	3
fam2448	2	3	4	3.0	1.0	0.3333333333333333	4	2	2
fam2449	3	3	3	3.0	0.0	0.0	3	3	0
fam2450	2	3	4	3.0	1.0	0.3333333333333333	4	2	2
fam2451	3	3	3	3.0	0.0	0.0	3	3	0
fam2452	5	3	2	3.3333333333333335	1.5275252316519465	0.45825756949558394	5	2	3
fam2453	2	3	3	2.6666666666666665	0.5773502691896258	0.2165063509461097	3	2	1
fam2454	2	3	3	2.6666666666666665	0.5773502691896258	0.2165063509461097	3	2	1
fam2455	2	3	3	2.6666666666666665	0.5773502691896258	0.2165063509461097	3	2	1
fam2456	2	3	3	2.6666666666666665	0.5773502691896258	0.2165063509461097	3	2	1
fam2457	3	2	3	2.6666666666666665	0.5773502691896258	0.2165063509461097	3	2	1
fam2458	2	3	3	2.6666666666666665	0.5773502691896258	0.2165063509461097	3	2	1
fam2459	2	3	3	2.6666666666666665	0.5773502691896258	0.2165063509461097	3	2	1
fam2460	2	3	3	2.6666666666666665	0.5773502691896258	0.2165063509461097	3	2	1
fam2461	2	3	3	2.6666666666666665	0.5773502691896258	0.2165063509461097	3	2	1
fam2462	3	2	3	2.6666666666666665	0.5773502691896258	0.2165063509461097	3	2	1
fam2463	3	2	3	2.6666666666666665	0.5773502691896258	0.2165063509461097	3	2	1
fam2464	2	3	3	2.6666666666666665	0.5773502691896258	0.2165063509461097	3	2	1
fam2465	3	3	2	2.6666666666666665	0.5773502691896258	0.2165063509461097	3	2	1
fam2466	2	3	3	2.6666666666666665	0.5773502691896258	0.2165063509461097	3	2	1
fam2467	2	3	3	2.6666666666666665	0.5773502691896258	0.2165063509461097	3	2	1
fam2468	2	3	3	2.6666666666666665	0.5773502691896258	0.2165063509461097	3	2	1
fam2469	2	3	3	2.6666666666666665	0.5773502691896258	0.2165063509461097	3	2	1
fam2470	2	3	3	2.6666666666666665	0.5773502691896258	0.2165063509461097	3	2	1
fam2471	2	3	3	2.6666666666666665	0.5773502691896258	0.2165063509461097	3	2	1
fam2472	2	3	3	2.6666666666666665	0.5773502691896258	0.2165063509461097	3	2	1
fam2473	2	3	3	2.6666666666666665	0.5773502691896258	0.2165063509461097	3	2	1
fam2474	2	3	3	2.6666666666666665	0.5773502691896258	0.2165063509461097	3	2	1
fam2475	2	3	3	2.6666666666666665	0.5773502691896258	0.2165063509461097	3	2	1
fam2476	3	3	2	2.6666666666666665	0.5773502691896258	0.2165063509461097	3	2	1
fam2477	2	3	3	2.6666666666666665	0.5773502691896258	0.2165063509461097	3	2	1
fam2478	2	3	3	2.6666666666666665	0.5773502691896258	0.2165063509461097	3	2	1
fam2479	3	3	2	2.6666666666666665	0.5773502691896258	0.2165063509461097	3	2	1
fam2480	2	3	3	2.6666666666666665	0.5773502691896258	0.2165063509461097	3	2	1
fam2481	3	2	3	2.6666666666666665	0.5773502691896258	0.2165063509461097	3	2	1
fam2482	3	2	3	2.6666666666666665	0.5773502691896258	0.2165063509461097	3	2	1
fam2483	2	3	3	2.6666666666666665	0.5773502691896258	0.2165063509461097	3	2	1
fam2484	2	3	3	2.6666666666666665	0.5773502691896258	0.2165063509461097	3	2	1
fam2485	2	3	3	2.6666666666666665	0.5773502691896258	0.2165063509461097	3	2	1
fam2486	2	3	3	2.6666666666666665	0.5773502691896258	0.2165063509461097	3	2	1
fam2487	2	3	3	2.6666666666666665	0.5773502691896258	0.2165063509461097	3	2	1
fam2488	2	3	3	2.6666666666666665	0.5773502691896258	0.2165063509461097	3	2	1
fam2489	3	3	2	2.6666666666666665	0.5773502691896258	0.2165063509461097	3	2	1
fam2490	3	2	3	2.6666666666666665	0.5773502691896258	0.2165063509461097	3	2	1
fam2491	3	2	3	2.6666666666666665	0.5773502691896258	0.2165063509461097	3	2	1
fam2492	2	3	3	2.6666666666666665	0.5773502691896258	0.2165063509461097	3	2	1
fam2493	2	3	3	2.6666666666666665	0.5773502691896258	0.2165063509461097	3	2	1
fam2494	3	3	2	2.6666666666666665	0.5773502691896258	0.2165063509461097	3	2	1
fam2495	2	3	3	2.6666666666666665	0.5773502691896258	0.2165063509461097	3	2	1
fam2496	3	3	2	2.6666666666666665	0.5773502691896258	0.2165063509461097	3	2	1
fam2497	3	2	3	2.6666666666666665	0.5773502691896258	0.2165063509461097	3	2	1
fam2498	2	3	3	2.6666666666666665	0.5773502691896258	0.2165063509461097	3	2	1
fam2499	2	3	3	2.6666666666666665	0.5773502691896258	0.2165063509461097	3	2	1
fam2500	3	2	3	2.6666666666666665	0.5773502691896258	0.2165063509461097	3	2	1
fam2501	2	3	3	2.6666666666666665	0.5773502691896258	0.2165063509461097	3	2	1
fam2502	2	3	3	2.6666666666666665	0.5773502691896258	0.2165063509461097	3	2	1
fam2503	2	3	3	2.6666666666666665	0.5773502691896258	0.2165063509461097	3	2	1
fam2504	2	3	3	2.6666666666666665	0.5773502691896258	0.2165063509461097	3	2	1
fam2505	3	2	3	2.6666666666666665	0.5773502691896258	0.2165063509461097	3	2	1
fam2506	2	3	3	2.6666666666666665	0.5773502691896258	0.2165063509461097	3	2	1
fam2507	2	3	3	2.6666666666666665	0.5773502691896258	0.2165063509461097	3	2	1
fam2508	2	3	3	2.6666666666666665	0.5773502691896258	0.2165063509461097	3	2	1
fam2509	3	2	3	2.6666666666666665	0.5773502691896258	0.2165063509461097	3	2	1
fam2510	2	3	3	2.6666666666666665	0.5773502691896258	0.2165063509461097	3	2	1
fam2511	3	3	2	2.6666666666666665	0.5773502691896258	0.2165063509461097	3	2	1
fam2512	3	2	3	2.6666666666666665	0.5773502691896258	0.2165063509461097	3	2	1
fam2513	2	3	3	2.6666666666666665	0.5773502691896258	0.2165063509461097	3	2	1
fam2514	3	2	3	2.6666666666666665	0.5773502691896258	0.2165063509461097	3	2	1
fam2515	3	3	2	2.6666666666666665	0.5773502691896258	0.2165063509461097	3	2	1
fam2516	2	3	3	2.6666666666666665	0.5773502691896258	0.2165063509461097	3	2	1
fam2517	2	3	3	2.6666666666666665	0.5773502691896258	0.2165063509461097	3	2	1
fam2518	2	3	3	2.6666666666666665	0.5773502691896258	0.2165063509461097	3	2	1
fam2519	3	2	3	2.6666666666666665	0.5773502691896258	0.2165063509461097	3	2	1
fam2520	3	3	2	2.6666666666666665	0.5773502691896258	0.2165063509461097	3	2	1
fam2521	2	3	3	2.6666666666666665	0.5773502691896258	0.2165063509461097	3	2	1
fam2522	2	3	3	2.6666666666666665	0.5773502691896258	0.2165063509461097	3	2	1
fam2523	2	3	3	2.6666666666666665	0.5773502691896258	0.2165063509461097	3	2	1
fam2524	3	3	2	2.6666666666666665	0.5773502691896258	0.2165063509461097	3	2	1
fam2525	2	3	3	2.6666666666666665	0.5773502691896258	0.2165063509461097	3	2	1
fam2526	2	3	3	2.6666666666666665	0.5773502691896258	0.2165063509461097	3	2	1
fam2527	2	3	3	2.6666666666666665	0.5773502691896258	0.2165063509461097	3	2	1
fam2528	2	3	3	2.6666666666666665	0.5773502691896258	0.2165063509461097	3	2	1
fam2529	3	3	2	2.6666666666666665	0.5773502691896258	0.2165063509461097	3	2	1
fam2530	2	3	3	2.6666666666666665	0.5773502691896258	0.2165063509461097	3	2	1
fam2531	3	3	2	2.6666666666666665	0.5773502691896258	0.2165063509461097	3	2	1
fam2532	3	3	2	2.6666666666666665	0.5773502691896258	0.2165063509461097	3	2	1
fam2533	2	3	3	2.6666666666666665	0.5773502691896258	0.2165063509461097	3	2	1
fam2534	3	3	2	2.6666666666666665	0.5773502691896258	0.2165063509461097	3	2	1
fam2535	3	2	3	2.6666666666666665	0.5773502691896258	0.2165063509461097	3	2	1
fam2536	2	3	3	2.6666666666666665	0.5773502691896258	0.2165063509461097	3	2	1
fam2537	2	3	3	2.6666666666666665	0.5773502691896258	0.2165063509461097	3	2	1
fam2538	2	3	3	2.6666666666666665	0.5773502691896258	0.2165063509461097	3	2	1
fam2539	2	3	3	2.6666666666666665	0.5773502691896258	0.2165063509461097	3	2	1
fam2540	2	3	3	2.6666666666666665	0.5773502691896258	0.2165063509461097	3	2	1
fam2541	3	2	3	2.6666666666666665	0.5773502691896258	0.2165063509461097	3	2	1
fam2542	3	2	3	2.6666666666666665	0.5773502691896258	0.2165063509461097	3	2	1
fam2543	3	2	3	2.6666666666666665	0.5773502691896258	0.2165063509461097	3	2	1
fam2544	3	3	2	2.6666666666666665	0.5773502691896258	0.2165063509461097	3	2	1
fam2545	3	2	3	2.6666666666666665	0.5773502691896258	0.2165063509461097	3	2	1
fam2546	2	3	3	2.6666666666666665	0.5773502691896258	0.2165063509461097	3	2	1
fam2547	2	3	3	2.6666666666666665	0.5773502691896258	0.2165063509461097	3	2	1
fam2548	2	3	3	2.6666666666666665	0.5773502691896258	0.2165063509461097	3	2	1
fam2549	2	3	3	2.6666666666666665	0.5773502691896258	0.2165063509461097	3	2	1
fam2550	3	3	2	2.6666666666666665	0.5773502691896258	0.2165063509461097	3	2	1
fam2551	2	3	3	2.6666666666666665	0.5773502691896258	0.2165063509461097	3	2	1
fam2552	3	2	3	2.6666666666666665	0.5773502691896258	0.2165063509461097	3	2	1
fam2553	2	3	3	2.6666666666666665	0.5773502691896258	0.2165063509461097	3	2	1
fam2554	3	3	2	2.6666666666666665	0.5773502691896258	0.2165063509461097	3	2	1
fam2555	2	3	3	2.6666666666666665	0.5773502691896258	0.2165063509461097	3	2	1
fam2556	3	2	3	2.6666666666666665	0.5773502691896258	0.2165063509461097	3	2	1
fam2557	3	3	2	2.6666666666666665	0.5773502691896258	0.2165063509461097	3	2	1
fam2558	3	3	2	2.6666666666666665	0.5773502691896258	0.2165063509461097	3	2	1
fam2559	3	3	2	2.6666666666666665	0.5773502691896258	0.2165063509461097	3	2	1
fam2560	3	2	3	2.6666666666666665	0.5773502691896258	0.2165063509461097	3	2	1
fam2561	2	3	3	2.6666666666666665	0.5773502691896258	0.2165063509461097	3	2	1
fam2562	2	3	3	2.6666666666666665	0.5773502691896258	0.2165063509461097	3	2	1
fam2563	3	3	2	2.6666666666666665	0.5773502691896258	0.2165063509461097	3	2	1
fam2564	3	3	2	2.6666666666666665	0.5773502691896258	0.2165063509461097	3	2	1
fam2565	2	3	3	2.6666666666666665	0.5773502691896258	0.2165063509461097	3	2	1
fam2566	2	3	3	2.6666666666666665	0.5773502691896258	0.2165063509461097	3	2	1
fam2567	2	3	3	2.6666666666666665	0.5773502691896258	0.2165063509461097	3	2	1
fam2568	3	3	2	2.6666666666666665	0.5773502691896258	0.2165063509461097	3	2	1
fam2569	2	3	3	2.6666666666666665	0.5773502691896258	0.2165063509461097	3	2	1
fam2570	2	3	3	2.6666666666666665	0.5773502691896258	0.2165063509461097	3	2	1
fam2571	2	3	3	2.6666666666666665	0.5773502691896258	0.2165063509461097	3	2	1
fam2572	2	3	3	2.6666666666666665	0.5773502691896258	0.2165063509461097	3	2	1
fam2573	2	3	3	2.6666666666666665	0.5773502691896258	0.2165063509461097	3	2	1
fam2574	2	3	3	2.6666666666666665	0.5773502691896258	0.2165063509461097	3	2	1
fam2575	2	3	3	2.6666666666666665	0.5773502691896258	0.2165063509461097	3	2	1
fam2576	3	3	2	2.6666666666666665	0.5773502691896258	0.2165063509461097	3	2	1
fam2577	2	3	3	2.6666666666666665	0.5773502691896258	0.2165063509461097	3	2	1
fam2578	2	3	3	2.6666666666666665	0.5773502691896258	0.2165063509461097	3	2	1
fam2579	2	3	3	2.6666666666666665	0.5773502691896258	0.2165063509461097	3	2	1
fam2580	2	3	3	2.6666666666666665	0.5773502691896258	0.2165063509461097	3	2	1
fam2581	3	3	2	2.6666666666666665	0.5773502691896258	0.2165063509461097	3	2	1
fam2582	2	3	3	2.6666666666666665	0.5773502691896258	0.2165063509461097	3	2	1
fam2583	3	3	2	2.6666666666666665	0.5773502691896258	0.2165063509461097	3	2	1
fam2584	2	3	3	2.6666666666666665	0.5773502691896258	0.2165063509461097	3	2	1
fam2585	3	2	3	2.6666666666666665	0.5773502691896258	0.2165063509461097	3	2	1
fam2586	2	3	3	2.6666666666666665	0.5773502691896258	0.2165063509461097	3	2	1
fam2587	3	2	3	2.6666666666666665	0.5773502691896258	0.2165063509461097	3	2	1
fam2588	3	2	3	2.6666666666666665	0.5773502691896258	0.2165063509461097	3	2	1
fam2589	2	3	3	2.6666666666666665	0.5773502691896258	0.2165063509461097	3	2	1
fam2590	2	3	3	2.6666666666666665	0.5773502691896258	0.2165063509461097	3	2	1
fam2591	2	4	2	2.6666666666666665	1.1547005383792515	0.4330127018922193	4	2	2
fam2592	2	4	3	3.0	1.0	0.3333333333333333	4	2	2
fam2593	2	4	3	3.0	1.0	0.3333333333333333	4	2	2
fam2594	2	4	3	3.0	1.0	0.3333333333333333	4	2	2
fam2595	2	3	4	3.0	1.0	0.3333333333333333	4	2	2
fam2596	2	4	3	3.0	1.0	0.3333333333333333	4	2	2
fam2597	2	3	4	3.0	1.0	0.3333333333333333	4	2	2
fam2598	2	4	3	3.0	1.0	0.3333333333333333	4	2	2
fam2599	2	4	3	3.0	1.0	0.3333333333333333	4	2	2
fam2600	2	4	3	3.0	1.0	0.3333333333333333	4	2	2
fam2601	2	3	4	3.0	1.0	0.3333333333333333	4	2	2
fam2602	2	2	4	2.6666666666666665	1.1547005383792515	0.4330127018922193	4	2	2
fam2603	2	4	2	2.6666666666666665	1.1547005383792515	0.4330127018922193	4	2	2
fam2604	4	3	2	3.0	1.0	0.3333333333333333	4	2	2
fam2605	2	4	3	3.0	1.0	0.3333333333333333	4	2	2
fam2606	2	3	4	3.0	1.0	0.3333333333333333	4	2	2
fam2607	2	4	2	2.6666666666666665	1.1547005383792515	0.4330127018922193	4	2	2
fam2608	2	3	4	3.0	1.0	0.3333333333333333	4	2	2
fam2609	2	4	2	2.6666666666666665	1.1547005383792515	0.4330127018922193	4	2	2
fam2610	2	4	3	3.0	1.0	0.3333333333333333	4	2	2
fam2611	2	4	2	2.6666666666666665	1.1547005383792515	0.4330127018922193	4	2	2
fam2612	2	3	4	3.0	1.0	0.3333333333333333	4	2	2
fam2613	4	2	2	2.6666666666666665	1.1547005383792515	0.4330127018922193	4	2	2
fam2614	2	3	4	3.0	1.0	0.3333333333333333	4	2	2
fam2615	2	4	3	3.0	1.0	0.3333333333333333	4	2	2
fam2616	2	3	4	3.0	1.0	0.3333333333333333	4	2	2
fam2617	2	4	2	2.6666666666666665	1.1547005383792515	0.4330127018922193	4	2	2
fam2618	2	4	3	3.0	1.0	0.3333333333333333	4	2	2
fam2619	2	3	4	3.0	1.0	0.3333333333333333	4	2	2
fam2620	2	3	4	3.0	1.0	0.3333333333333333	4	2	2
fam2621	2	2	4	2.6666666666666665	1.1547005383792515	0.4330127018922193	4	2	2
fam2622	2	4	2	2.6666666666666665	1.1547005383792515	0.4330127018922193	4	2	2
fam2623	2	2	4	2.6666666666666665	1.1547005383792515	0.4330127018922193	4	2	2
fam2624	3	2	4	3.0	1.0	0.3333333333333333	4	2	2
fam2625	2	4	2	2.6666666666666665	1.1547005383792515	0.4330127018922193	4	2	2
fam2626	2	4	2	2.6666666666666665	1.1547005383792515	0.4330127018922193	4	2	2
fam2627	2	3	4	3.0	1.0	0.3333333333333333	4	2	2
fam2628	2	4	3	3.0	1.0	0.3333333333333333	4	2	2
fam2629	2	4	2	2.6666666666666665	1.1547005383792515	0.4330127018922193	4	2	2
fam2630	2	4	2	2.6666666666666665	1.1547005383792515	0.4330127018922193	4	2	2
fam2631	2	4	3	3.0	1.0	0.3333333333333333	4	2	2
fam2632	2	4	2	2.6666666666666665	1.1547005383792515	0.4330127018922193	4	2	2
fam2633	2	4	3	3.0	1.0	0.3333333333333333	4	2	2
fam2634	2	3	4	3.0	1.0	0.3333333333333333	4	2	2
fam2635	2	4	2	2.6666666666666665	1.1547005383792515	0.4330127018922193	4	2	2
fam2636	2	3	4	3.0	1.0	0.3333333333333333	4	2	2
fam2637	2	2	4	2.6666666666666665	1.1547005383792515	0.4330127018922193	4	2	2
fam2638	2	4	3	3.0	1.0	0.3333333333333333	4	2	2
fam2639	2	3	4	3.0	1.0	0.3333333333333333	4	2	2
fam2640	2	3	4	3.0	1.0	0.3333333333333333	4	2	2
fam2641	2	4	3	3.0	1.0	0.3333333333333333	4	2	2
fam2642	2	4	3	3.0	1.0	0.3333333333333333	4	2	2
fam2643	2	3	4	3.0	1.0	0.3333333333333333	4	2	2
fam2644	2	4	3	3.0	1.0	0.3333333333333333	4	2	2
fam2645	2	4	3	3.0	1.0	0.3333333333333333	4	2	2
fam2646	3	2	4	3.0	1.0	0.3333333333333333	4	2	2
fam2647	2	3	4	3.0	1.0	0.3333333333333333	4	2	2
fam2648	2	3	4	3.0	1.0	0.3333333333333333	4	2	2
fam2649	2	4	3	3.0	1.0	0.3333333333333333	4	2	2
fam2650	2	2	4	2.6666666666666665	1.1547005383792515	0.4330127018922193	4	2	2
fam2651	2	4	3	3.0	1.0	0.3333333333333333	4	2	2
fam2652	2	3	4	3.0	1.0	0.3333333333333333	4	2	2
fam2653	2	4	2	2.6666666666666665	1.1547005383792515	0.4330127018922193	4	2	2
fam2654	2	4	3	3.0	1.0	0.3333333333333333	4	2	2
fam2655	2	4	3	3.0	1.0	0.3333333333333333	4	2	2
fam2656	2	4	2	2.6666666666666665	1.1547005383792515	0.4330127018922193	4	2	2
fam2657	4	2	2	2.6666666666666665	1.1547005383792515	0.4330127018922193	4	2	2
fam2658	2	4	3	3.0	1.0	0.3333333333333333	4	2	2
fam2659	2	4	3	3.0	1.0	0.3333333333333333	4	2	2
fam2660	2	4	2	2.6666666666666665	1.1547005383792515	0.4330127018922193	4	2	2
fam2661	3	2	4	3.0	1.0	0.3333333333333333	4	2	2
fam2662	2	4	3	3.0	1.0	0.3333333333333333	4	2	2
fam2663	2	4	3	3.0	1.0	0.3333333333333333	4	2	2
fam2664	2	4	3	3.0	1.0	0.3333333333333333	4	2	2
fam2665	2	3	4	3.0	1.0	0.3333333333333333	4	2	2
fam2666	2	4	2	2.6666666666666665	1.1547005383792515	0.4330127018922193	4	2	2
fam2667	3	2	4	3.0	1.0	0.3333333333333333	4	2	2
fam2668	2	4	3	3.0	1.0	0.3333333333333333	4	2	2
fam2669	2	4	2	2.6666666666666665	1.1547005383792515	0.4330127018922193	4	2	2
fam2670	3	2	4	3.0	1.0	0.3333333333333333	4	2	2
fam2671	2	4	2	2.6666666666666665	1.1547005383792515	0.4330127018922193	4	2	2
fam2672	2	4	3	3.0	1.0	0.3333333333333333	4	2	2
fam2673	4	2	2	2.6666666666666665	1.1547005383792515	0.4330127018922193	4	2	2
fam2674	2	4	3	3.0	1.0	0.3333333333333333	4	2	2
fam2675	2	4	3	3.0	1.0	0.3333333333333333	4	2	2
fam2676	2	3	4	3.0	1.0	0.3333333333333333	4	2	2
fam2677	2	4	3	3.0	1.0	0.3333333333333333	4	2	2
fam2678	2	2	4	2.6666666666666665	1.1547005383792515	0.4330127018922193	4	2	2
fam2679	4	3	2	3.0	1.0	0.3333333333333333	4	2	2
fam2680	2	3	4	3.0	1.0	0.3333333333333333	4	2	2
fam2681	3	2	4	3.0	1.0	0.3333333333333333	4	2	2
fam2682	2	4	3	3.0	1.0	0.3333333333333333	4	2	2
fam2683	2	4	2	2.6666666666666665	1.1547005383792515	0.4330127018922193	4	2	2
fam2684	2	4	3	3.0	1.0	0.3333333333333333	4	2	2
fam2685	2	4	3	3.0	1.0	0.3333333333333333	4	2	2
fam2686	2	3	4	3.0	1.0	0.3333333333333333	4	2	2
fam2687	2	4	2	2.6666666666666665	1.1547005383792515	0.4330127018922193	4	2	2
fam2688	2	4	2	2.6666666666666665	1.1547005383792515	0.4330127018922193	4	2	2
fam2689	2	4	2	2.6666666666666665	1.1547005383792515	0.4330127018922193	4	2	2
fam2690	2	2	4	2.6666666666666665	1.1547005383792515	0.4330127018922193	4	2	2
fam2691	3	4	2	3.0	1.0	0.3333333333333333	4	2	2
fam2692	2	4	3	3.0	1.0	0.3333333333333333	4	2	2
fam2693	2	3	4	3.0	1.0	0.3333333333333333	4	2	2
fam2694	2	4	2	2.6666666666666665	1.1547005383792515	0.4330127018922193	4	2	2
fam2695	2	3	4	3.0	1.0	0.3333333333333333	4	2	2
fam2696	2	4	3	3.0	1.0	0.3333333333333333	4	2	2
fam2697	2	4	2	2.6666666666666665	1.1547005383792515	0.4330127018922193	4	2	2
fam2698	2	4	3	3.0	1.0	0.3333333333333333	4	2	2
fam2699	4	2	2	2.6666666666666665	1.1547005383792515	0.4330127018922193	4	2	2
fam2700	2	2	4	2.6666666666666665	1.1547005383792515	0.4330127018922193	4	2	2
fam2701	2	3	4	3.0	1.0	0.3333333333333333	4	2	2
fam2702	2	4	3	3.0	1.0	0.3333333333333333	4	2	2
fam2703	4	2	2	2.6666666666666665	1.1547005383792515	0.4330127018922193	4	2	2
fam2704	2	4	3	3.0	1.0	0.3333333333333333	4	2	2
fam2705	2	4	2	2.6666666666666665	1.1547005383792515	0.4330127018922193	4	2	2
fam2706	2	4	2	2.6666666666666665	1.1547005383792515	0.4330127018922193	4	2	2
fam2707	2	4	3	3.0	1.0	0.3333333333333333	4	2	2
fam2708	2	4	2	2.6666666666666665	1.1547005383792515	0.4330127018922193	4	2	2
fam2709	2	4	2	2.6666666666666665	1.1547005383792515	0.4330127018922193	4	2	2
fam2710	2	4	3	3.0	1.0	0.3333333333333333	4	2	2
fam2711	2	3	4	3.0	1.0	0.3333333333333333	4	2	2
fam2712	4	2	3	3.0	1.0	0.3333333333333333	4	2	2
fam2713	3	4	2	3.0	1.0	0.3333333333333333	4	2	2
fam2714	2	3	4	3.0	1.0	0.3333333333333333	4	2	2
fam2715	2	4	2	2.6666666666666665	1.1547005383792515	0.4330127018922193	4	2	2
fam2716	2	4	3	3.0	1.0	0.3333333333333333	4	2	2
fam2717	2	4	3	3.0	1.0	0.3333333333333333	4	2	2
fam2718	2	2	4	2.6666666666666665	1.1547005383792515	0.4330127018922193	4	2	2
fam2719	2	4	2	2.6666666666666665	1.1547005383792515	0.4330127018922193	4	2	2
fam2720	2	2	4	2.6666666666666665	1.1547005383792515	0.4330127018922193	4	2	2
fam2721	2	4	2	2.6666666666666665	1.1547005383792515	0.4330127018922193	4	2	2
fam2722	2	3	4	3.0	1.0	0.3333333333333333	4	2	2
fam2723	3	4	2	3.0	1.0	0.3333333333333333	4	2	2
fam2724	3	2	4	3.0	1.0	0.3333333333333333	4	2	2
fam2725	4	2	2	2.6666666666666665	1.1547005383792515	0.4330127018922193	4	2	2
fam2726	2	4	3	3.0	1.0	0.3333333333333333	4	2	2
fam2727	2	4	2	2.6666666666666665	1.1547005383792515	0.4330127018922193	4	2	2
fam2728	2	3	4	3.0	1.0	0.3333333333333333	4	2	2
fam2729	2	4	2	2.6666666666666665	1.1547005383792515	0.4330127018922193	4	2	2
fam2730	2	3	4	3.0	1.0	0.3333333333333333	4	2	2
fam2731	2	2	4	2.6666666666666665	1.1547005383792515	0.4330127018922193	4	2	2
fam2732	2	4	3	3.0	1.0	0.3333333333333333	4	2	2
fam2733	2	3	4	3.0	1.0	0.3333333333333333	4	2	2
fam2734	2	4	2	2.6666666666666665	1.1547005383792515	0.4330127018922193	4	2	2
fam2735	2	2	4	2.6666666666666665	1.1547005383792515	0.4330127018922193	4	2	2
fam2736	2	4	3	3.0	1.0	0.3333333333333333	4	2	2
fam2737	4	2	2	2.6666666666666665	1.1547005383792515	0.4330127018922193	4	2	2
fam2738	2	4	3	3.0	1.0	0.3333333333333333	4	2	2
fam2739	2	4	3	3.0	1.0	0.3333333333333333	4	2	2
fam2740	2	4	2	2.6666666666666665	1.1547005383792515	0.4330127018922193	4	2	2
fam2741	2	3	4	3.0	1.0	0.3333333333333333	4	2	2
fam2742	2	4	3	3.0	1.0	0.3333333333333333	4	2	2
fam2743	4	2	2	2.6666666666666665	1.1547005383792515	0.4330127018922193	4	2	2
fam2744	2	2	4	2.6666666666666665	1.1547005383792515	0.4330127018922193	4	2	2
fam2745	2	3	4	3.0	1.0	0.3333333333333333	4	2	2
fam2746	2	4	2	2.6666666666666665	1.1547005383792515	0.4330127018922193	4	2	2
fam2747	2	3	4	3.0	1.0	0.3333333333333333	4	2	2
fam2748	2	4	3	3.0	1.0	0.3333333333333333	4	2	2
fam2749	2	4	3	3.0	1.0	0.3333333333333333	4	2	2
fam2750	2	4	3	3.0	1.0	0.3333333333333333	4	2	2
fam2751	2	4	2	2.6666666666666665	1.1547005383792515	0.4330127018922193	4	2	2
fam2752	2	4	3	3.0	1.0	0.3333333333333333	4	2	2
fam2753	2	3	4	3.0	1.0	0.3333333333333333	4	2	2
fam2754	4	2	3	3.0	1.0	0.3333333333333333	4	2	2
fam2755	2	4	3	3.0	1.0	0.3333333333333333	4	2	2
fam2756	2	4	3	3.0	1.0	0.3333333333333333	4	2	2
fam2757	2	4	3	3.0	1.0	0.3333333333333333	4	2	2
fam2758	2	2	4	2.6666666666666665	1.1547005383792515	0.4330127018922193	4	2	2
fam2759	4	2	2	2.6666666666666665	1.1547005383792515	0.4330127018922193	4	2	2
fam2760	4	2	2	2.6666666666666665	1.1547005383792515	0.4330127018922193	4	2	2
fam2761	2	4	3	3.0	1.0	0.3333333333333333	4	2	2
fam2762	2	4	3	3.0	1.0	0.3333333333333333	4	2	2
fam2763	2	4	2	2.6666666666666665	1.1547005383792515	0.4330127018922193	4	2	2
fam2764	2	3	4	3.0	1.0	0.3333333333333333	4	2	2
fam2765	2	3	4	3.0	1.0	0.3333333333333333	4	2	2
fam2766	2	3	4	3.0	1.0	0.3333333333333333	4	2	2
fam2767	2	3	4	3.0	1.0	0.3333333333333333	4	2	2
fam2768	4	2	3	3.0	1.0	0.3333333333333333	4	2	2
fam2769	4	2	2	2.6666666666666665	1.1547005383792515	0.4330127018922193	4	2	2
fam2770	2	4	2	2.6666666666666665	1.1547005383792515	0.4330127018922193	4	2	2
fam2771	2	4	3	3.0	1.0	0.3333333333333333	4	2	2
fam2772	2	3	4	3.0	1.0	0.3333333333333333	4	2	2
fam2773	2	4	2	2.6666666666666665	1.1547005383792515	0.4330127018922193	4	2	2
fam2774	2	4	2	2.6666666666666665	1.1547005383792515	0.4330127018922193	4	2	2
fam2775	2	4	3	3.0	1.0	0.3333333333333333	4	2	2
fam2776	2	4	2	2.6666666666666665	1.1547005383792515	0.4330127018922193	4	2	2
fam2777	4	2	2	2.6666666666666665	1.1547005383792515	0.4330127018922193	4	2	2
fam2778	2	4	2	2.6666666666666665	1.1547005383792515	0.4330127018922193	4	2	2
fam2779	2	4	3	3.0	1.0	0.3333333333333333	4	2	2
fam2780	2	4	3	3.0	1.0	0.3333333333333333	4	2	2
fam2781	2	4	2	2.6666666666666665	1.1547005383792515	0.4330127018922193	4	2	2
fam2782	2	2	4	2.6666666666666665	1.1547005383792515	0.4330127018922193	4	2	2
fam2783	2	4	3	3.0	1.0	0.3333333333333333	4	2	2
fam2784	2	3	4	3.0	1.0	0.3333333333333333	4	2	2
fam2785	2	3	4	3.0	1.0	0.3333333333333333	4	2	2
fam2786	2	3	4	3.0	1.0	0.3333333333333333	4	2	2
fam2787	2	2	4	2.6666666666666665	1.1547005383792515	0.4330127018922193	4	2	2
fam2788	2	4	2	2.6666666666666665	1.1547005383792515	0.4330127018922193	4	2	2
fam2789	2	4	3	3.0	1.0	0.3333333333333333	4	2	2
fam2790	2	4	3	3.0	1.0	0.3333333333333333	4	2	2
fam2791	2	4	3	3.0	1.0	0.3333333333333333	4	2	2
fam2792	2	3	4	3.0	1.0	0.3333333333333333	4	2	2
fam2793	3	4	2	3.0	1.0	0.3333333333333333	4	2	2
fam2794	2	4	2	2.6666666666666665	1.1547005383792515	0.4330127018922193	4	2	2
fam2795	2	4	3	3.0	1.0	0.3333333333333333	4	2	2
fam2796	2	4	3	3.0	1.0	0.3333333333333333	4	2	2
fam2797	2	4	3	3.0	1.0	0.3333333333333333	4	2	2
fam2798	2	4	3	3.0	1.0	0.3333333333333333	4	2	2
fam2799	2	4	3	3.0	1.0	0.3333333333333333	4	2	2
fam2800	2	4	3	3.0	1.0	0.3333333333333333	4	2	2
fam2801	2	3	4	3.0	1.0	0.3333333333333333	4	2	2
fam2802	2	4	3	3.0	1.0	0.3333333333333333	4	2	2
fam2803	2	4	3	3.0	1.0	0.3333333333333333	4	2	2
fam2804	2	2	4	2.6666666666666665	1.1547005383792515	0.4330127018922193	4	2	2
fam2805	2	4	3	3.0	1.0	0.3333333333333333	4	2	2
fam2806	2	3	4	3.0	1.0	0.3333333333333333	4	2	2
fam2807	2	4	3	3.0	1.0	0.3333333333333333	4	2	2
fam2808	2	3	4	3.0	1.0	0.3333333333333333	4	2	2
fam2809	2	4	3	3.0	1.0	0.3333333333333333	4	2	2
fam2810	2	3	4	3.0	1.0	0.3333333333333333	4	2	2
fam2811	2	4	3	3.0	1.0	0.3333333333333333	4	2	2
fam2812	2	4	3	3.0	1.0	0.3333333333333333	4	2	2
fam2813	2	4	3	3.0	1.0	0.3333333333333333	4	2	2
fam2814	4	2	2	2.6666666666666665	1.1547005383792515	0.4330127018922193	4	2	2
fam2815	2	2	4	2.6666666666666665	1.1547005383792515	0.4330127018922193	4	2	2
fam2816	2	2	4	2.6666666666666665	1.1547005383792515	0.4330127018922193	4	2	2
fam2817	2	4	2	2.6666666666666665	1.1547005383792515	0.4330127018922193	4	2	2
fam2818	2	4	2	2.6666666666666665	1.1547005383792515	0.4330127018922193	4	2	2
fam2819	2	4	2	2.6666666666666665	1.1547005383792515	0.4330127018922193	4	2	2
fam2820	2	4	2	2.6666666666666665	1.1547005383792515	0.4330127018922193	4	2	2
fam2821	2	4	3	3.0	1.0	0.3333333333333333	4	2	2
fam2822	2	4	3	3.0	1.0	0.3333333333333333	4	2	2
fam2823	2	2	4	2.6666666666666665	1.1547005383792515	0.4330127018922193	4	2	2
fam2824	2	2	4	2.6666666666666665	1.1547005383792515	0.4330127018922193	4	2	2
fam2825	2	4	3	3.0	1.0	0.3333333333333333	4	2	2
fam2826	2	3	4	3.0	1.0	0.3333333333333333	4	2	2
fam2827	2	2	4	2.6666666666666665	1.1547005383792515	0.4330127018922193	4	2	2
fam2828	2	3	4	3.0	1.0	0.3333333333333333	4	2	2
fam2829	2	3	4	3.0	1.0	0.3333333333333333	4	2	2
fam2830	2	4	2	2.6666666666666665	1.1547005383792515	0.4330127018922193	4	2	2
fam2831	2	3	4	3.0	1.0	0.3333333333333333	4	2	2
fam2832	2	4	3	3.0	1.0	0.3333333333333333	4	2	2
fam2833	2	4	3	3.0	1.0	0.3333333333333333	4	2	2
fam2834	2	4	3	3.0	1.0	0.3333333333333333	4	2	2
fam2835	2	3	4	3.0	1.0	0.3333333333333333	4	2	2
fam2836	2	3	4	3.0	1.0	0.3333333333333333	4	2	2
fam2837	2	4	3	3.0	1.0	0.3333333333333333	4	2	2
fam2838	2	4	3	3.0	1.0	0.3333333333333333	4	2	2
fam2839	2	4	3	3.0	1.0	0.3333333333333333	4	2	2
fam2840	4	2	2	2.6666666666666665	1.1547005383792515	0.4330127018922193	4	2	2
fam2841	2	3	4	3.0	1.0	0.3333333333333333	4	2	2
fam2842	3	2	3	2.6666666666666665	0.5773502691896258	0.2165063509461097	3	2	1
fam2843	2	3	3	2.6666666666666665	0.5773502691896258	0.2165063509461097	3	2	1
fam2844	3	3	2	2.6666666666666665	0.5773502691896258	0.2165063509461097	3	2	1
fam2845	3	3	2	2.6666666666666665	0.5773502691896258	0.2165063509461097	3	2	1
fam2846	3	2	3	2.6666666666666665	0.5773502691896258	0.2165063509461097	3	2	1
fam2847	2	5	2	3.0	1.7320508075688772	0.5773502691896257	5	2	3
fam2848	2	5	2	3.0	1.7320508075688772	0.5773502691896257	5	2	3
fam2849	2	5	2	3.0	1.7320508075688772	0.5773502691896257	5	2	3
fam2850	2	2	5	3.0	1.7320508075688772	0.5773502691896257	5	2	3
fam2851	2	5	2	3.0	1.7320508075688772	0.5773502691896257	5	2	3
fam2852	5	2	2	3.0	1.7320508075688772	0.5773502691896257	5	2	3
fam2853	2	5	2	3.0	1.7320508075688772	0.5773502691896257	5	2	3
fam2854	2	5	2	3.0	1.7320508075688772	0.5773502691896257	5	2	3
fam2855	2	3	3	2.6666666666666665	0.5773502691896258	0.2165063509461097	3	2	1
fam2856	3	2	3	2.6666666666666665	0.5773502691896258	0.2165063509461097	3	2	1
fam2857	2	5	2	3.0	1.7320508075688772	0.5773502691896257	5	2	3
fam2858	2	5	2	3.0	1.7320508075688772	0.5773502691896257	5	2	3
fam2859	2	2	5	3.0	1.7320508075688772	0.5773502691896257	5	2	3
fam2860	2	5	2	3.0	1.7320508075688772	0.5773502691896257	5	2	3
fam2861	2	5	2	3.0	1.7320508075688772	0.5773502691896257	5	2	3
fam2862	4	2	3	3.0	1.0	0.3333333333333333	4	2	2
fam2863	5	2	2	3.0	1.7320508075688772	0.5773502691896257	5	2	3
fam2864	2	5	2	3.0	1.7320508075688772	0.5773502691896257	5	2	3
fam2865	2	5	2	3.0	1.7320508075688772	0.5773502691896257	5	2	3
fam2866	2	3	4	3.0	1.0	0.3333333333333333	4	2	2
fam2867	2	5	2	3.0	1.7320508075688772	0.5773502691896257	5	2	3
fam2868	2	2	5	3.0	1.7320508075688772	0.5773502691896257	5	2	3
fam2869	2	5	2	3.0	1.7320508075688772	0.5773502691896257	5	2	3
fam2870	2	5	2	3.0	1.7320508075688772	0.5773502691896257	5	2	3
fam2871	2	2	5	3.0	1.7320508075688772	0.5773502691896257	5	2	3
fam2872	2	5	2	3.0	1.7320508075688772	0.5773502691896257	5	2	3
fam2873	2	3	3	2.6666666666666665	0.5773502691896258	0.2165063509461097	3	2	1
fam2874	2	5	2	3.0	1.7320508075688772	0.5773502691896257	5	2	3
fam2875	2	5	2	3.0	1.7320508075688772	0.5773502691896257	5	2	3
fam2876	2	3	3	2.6666666666666665	0.5773502691896258	0.2165063509461097	3	2	1
fam2877	5	2	2	3.0	1.7320508075688772	0.5773502691896257	5	2	3
fam2878	2	5	2	3.0	1.7320508075688772	0.5773502691896257	5	2	3
fam2879	2	2	5	3.0	1.7320508075688772	0.5773502691896257	5	2	3
fam2880	2	5	2	3.0	1.7320508075688772	0.5773502691896257	5	2	3
fam2881	2	5	2	3.0	1.7320508075688772	0.5773502691896257	5	2	3
fam2882	2	5	2	3.0	1.7320508075688772	0.5773502691896257	5	2	3
fam2883	2	5	2	3.0	1.7320508075688772	0.5773502691896257	5	2	3
fam2884	2	5	2	3.0	1.7320508075688772	0.5773502691896257	5	2	3
fam2885	2	5	2	3.0	1.7320508075688772	0.5773502691896257	5	2	3
fam2886	2	5	2	3.0	1.7320508075688772	0.5773502691896257	5	2	3
fam2887	2	5	2	3.0	1.7320508075688772	0.5773502691896257	5	2	3
fam2888	2	5	2	3.0	1.7320508075688772	0.5773502691896257	5	2	3
fam2889	2	2	5	3.0	1.7320508075688772	0.5773502691896257	5	2	3
fam2890	2	5	2	3.0	1.7320508075688772	0.5773502691896257	5	2	3
fam2891	5	2	2	3.0	1.7320508075688772	0.5773502691896257	5	2	3
fam2892	2	5	2	3.0	1.7320508075688772	0.5773502691896257	5	2	3
fam2893	2	5	2	3.0	1.7320508075688772	0.5773502691896257	5	2	3
fam2894	2	5	2	3.0	1.7320508075688772	0.5773502691896257	5	2	3
fam2895	2	5	2	3.0	1.7320508075688772	0.5773502691896257	5	2	3
fam2896	2	3	3	2.6666666666666665	0.5773502691896258	0.2165063509461097	3	2	1
fam2897	2	5	2	3.0	1.7320508075688772	0.5773502691896257	5	2	3
fam2898	2	3	3	2.6666666666666665	0.5773502691896258	0.2165063509461097	3	2	1
fam2899	2	5	2	3.0	1.7320508075688772	0.5773502691896257	5	2	3
fam2900	2	5	2	3.0	1.7320508075688772	0.5773502691896257	5	2	3
fam2901	2	5	2	3.0	1.7320508075688772	0.5773502691896257	5	2	3
fam2902	2	2	5	3.0	1.7320508075688772	0.5773502691896257	5	2	3
fam2903	2	5	2	3.0	1.7320508075688772	0.5773502691896257	5	2	3
fam2904	5	2	2	3.0	1.7320508075688772	0.5773502691896257	5	2	3
fam2905	2	2	5	3.0	1.7320508075688772	0.5773502691896257	5	2	3
fam2906	2	5	2	3.0	1.7320508075688772	0.5773502691896257	5	2	3
fam2907	5	2	2	3.0	1.7320508075688772	0.5773502691896257	5	2	3
fam2908	2	2	5	3.0	1.7320508075688772	0.5773502691896257	5	2	3
fam2909	2	5	2	3.0	1.7320508075688772	0.5773502691896257	5	2	3
fam2910	2	5	2	3.0	1.7320508075688772	0.5773502691896257	5	2	3
fam2911	2	5	2	3.0	1.7320508075688772	0.5773502691896257	5	2	3
fam2912	2	5	2	3.0	1.7320508075688772	0.5773502691896257	5	2	3
fam2913	2	2	5	3.0	1.7320508075688772	0.5773502691896257	5	2	3
fam2914	2	5	2	3.0	1.7320508075688772	0.5773502691896257	5	2	3
fam2915	2	5	2	3.0	1.7320508075688772	0.5773502691896257	5	2	3
fam2916	2	5	2	3.0	1.7320508075688772	0.5773502691896257	5	2	3
fam2917	2	5	2	3.0	1.7320508075688772	0.5773502691896257	5	2	3
fam2918	2	2	5	3.0	1.7320508075688772	0.5773502691896257	5	2	3
fam2919	2	5	2	3.0	1.7320508075688772	0.5773502691896257	5	2	3
fam2920	2	3	3	2.6666666666666665	0.5773502691896258	0.2165063509461097	3	2	1
fam2921	2	5	2	3.0	1.7320508075688772	0.5773502691896257	5	2	3
fam2922	2	2	5	3.0	1.7320508075688772	0.5773502691896257	5	2	3
fam2923	2	3	4	3.0	1.0	0.3333333333333333	4	2	2
fam2924	2	5	2	3.0	1.7320508075688772	0.5773502691896257	5	2	3
fam2925	2	2	5	3.0	1.7320508075688772	0.5773502691896257	5	2	3
fam2926	2	5	2	3.0	1.7320508075688772	0.5773502691896257	5	2	3
fam2927	2	5	2	3.0	1.7320508075688772	0.5773502691896257	5	2	3
fam2928	2	2	5	3.0	1.7320508075688772	0.5773502691896257	5	2	3
fam2929	2	5	2	3.0	1.7320508075688772	0.5773502691896257	5	2	3
fam2930	2	5	2	3.0	1.7320508075688772	0.5773502691896257	5	2	3
fam2931	2	5	2	3.0	1.7320508075688772	0.5773502691896257	5	2	3
fam2932	2	2	5	3.0	1.7320508075688772	0.5773502691896257	5	2	3
fam2933	2	5	2	3.0	1.7320508075688772	0.5773502691896257	5	2	3
fam2934	2	4	3	3.0	1.0	0.3333333333333333	4	2	2
fam2935	2	3	4	3.0	1.0	0.3333333333333333	4	2	2
fam2936	2	5	2	3.0	1.7320508075688772	0.5773502691896257	5	2	3
fam2937	2	5	2	3.0	1.7320508075688772	0.5773502691896257	5	2	3
fam2938	5	2	2	3.0	1.7320508075688772	0.5773502691896257	5	2	3
fam2939	5	2	2	3.0	1.7320508075688772	0.5773502691896257	5	2	3
fam2940	2	5	2	3.0	1.7320508075688772	0.5773502691896257	5	2	3
fam2941	2	5	2	3.0	1.7320508075688772	0.5773502691896257	5	2	3
fam2942	2	5	2	3.0	1.7320508075688772	0.5773502691896257	5	2	3
fam2943	2	2	5	3.0	1.7320508075688772	0.5773502691896257	5	2	3
fam2944	2	5	2	3.0	1.7320508075688772	0.5773502691896257	5	2	3
fam2945	2	2	5	3.0	1.7320508075688772	0.5773502691896257	5	2	3
fam2946	3	3	2	2.6666666666666665	0.5773502691896258	0.2165063509461097	3	2	1
fam2947	2	4	3	3.0	1.0	0.3333333333333333	4	2	2
fam2948	2	4	3	3.0	1.0	0.3333333333333333	4	2	2
fam2949	2	4	3	3.0	1.0	0.3333333333333333	4	2	2
fam2950	2	4	3	3.0	1.0	0.3333333333333333	4	2	2
fam2951	2	4	2	2.6666666666666665	1.1547005383792515	0.4330127018922193	4	2	2
fam2952	2	2	4	2.6666666666666665	1.1547005383792515	0.4330127018922193	4	2	2
fam2953	3	3	2	2.6666666666666665	0.5773502691896258	0.2165063509461097	3	2	1
fam2954	3	3	2	2.6666666666666665	0.5773502691896258	0.2165063509461097	3	2	1
fam2955	2	3	3	2.6666666666666665	0.5773502691896258	0.2165063509461097	3	2	1
fam2956	2	3	4	3.0	1.0	0.3333333333333333	4	2	2
fam2957	2	4	3	3.0	1.0	0.3333333333333333	4	2	2
fam2958	2	3	4	3.0	1.0	0.3333333333333333	4	2	2
fam2959	2	4	3	3.0	1.0	0.3333333333333333	4	2	2
fam2960	3	4	2	3.0	1.0	0.3333333333333333	4	2	2
fam2961	2	4	3	3.0	1.0	0.3333333333333333	4	2	2
fam2962	4	2	2	2.6666666666666665	1.1547005383792515	0.4330127018922193	4	2	2
fam2963	2	4	3	3.0	1.0	0.3333333333333333	4	2	2
fam2964	2	3	3	2.6666666666666665	0.5773502691896258	0.2165063509461097	3	2	1
fam2965	2	6	2	3.3333333333333335	2.3094010767585034	0.692820323027551	6	2	4
fam2966	3	3	2	2.6666666666666665	0.5773502691896258	0.2165063509461097	3	2	1
fam2967	2	6	2	3.3333333333333335	2.3094010767585034	0.692820323027551	6	2	4
fam2968	2	6	2	3.3333333333333335	2.3094010767585034	0.692820323027551	6	2	4
fam2969	2	2	6	3.3333333333333335	2.3094010767585034	0.692820323027551	6	2	4
fam2970	2	6	2	3.3333333333333335	2.3094010767585034	0.692820323027551	6	2	4
fam2971	2	6	2	3.3333333333333335	2.3094010767585034	0.692820323027551	6	2	4
fam2972	2	3	3	2.6666666666666665	0.5773502691896258	0.2165063509461097	3	2	1
fam2973	2	3	3	2.6666666666666665	0.5773502691896258	0.2165063509461097	3	2	1
fam2974	2	6	2	3.3333333333333335	2.3094010767585034	0.692820323027551	6	2	4
fam2975	2	6	2	3.3333333333333335	2.3094010767585034	0.692820323027551	6	2	4
fam2976	2	6	2	3.3333333333333335	2.3094010767585034	0.692820323027551	6	2	4
fam2977	2	6	2	3.3333333333333335	2.3094010767585034	0.692820323027551	6	2	4
fam2978	2	6	2	3.3333333333333335	2.3094010767585034	0.692820323027551	6	2	4
fam2979	2	3	3	2.6666666666666665	0.5773502691896258	0.2165063509461097	3	2	1
fam2980	2	6	2	3.3333333333333335	2.3094010767585034	0.692820323027551	6	2	4
fam2981	2	6	2	3.3333333333333335	2.3094010767585034	0.692820323027551	6	2	4
fam2982	2	6	2	3.3333333333333335	2.3094010767585034	0.692820323027551	6	2	4
fam2983	2	6	2	3.3333333333333335	2.3094010767585034	0.692820323027551	6	2	4
fam2984	2	6	2	3.3333333333333335	2.3094010767585034	0.692820323027551	6	2	4
fam2985	2	6	2	3.3333333333333335	2.3094010767585034	0.692820323027551	6	2	4
fam2986	2	6	2	3.3333333333333335	2.3094010767585034	0.692820323027551	6	2	4
fam2987	2	6	2	3.3333333333333335	2.3094010767585034	0.692820323027551	6	2	4
fam2988	2	6	2	3.3333333333333335	2.3094010767585034	0.692820323027551	6	2	4
fam2989	2	2	6	3.3333333333333335	2.3094010767585034	0.692820323027551	6	2	4
fam2990	2	2	6	3.3333333333333335	2.3094010767585034	0.692820323027551	6	2	4
fam2991	2	6	2	3.3333333333333335	2.3094010767585034	0.692820323027551	6	2	4
fam2992	2	6	2	3.3333333333333335	2.3094010767585034	0.692820323027551	6	2	4
fam2993	2	6	2	3.3333333333333335	2.3094010767585034	0.692820323027551	6	2	4
fam2994	2	4	2	2.6666666666666665	1.1547005383792515	0.4330127018922193	4	2	2
fam2995	2	2	6	3.3333333333333335	2.3094010767585034	0.692820323027551	6	2	4
fam2996	2	6	2	3.3333333333333335	2.3094010767585034	0.692820323027551	6	2	4
fam2997	2	4	2	2.6666666666666665	1.1547005383792515	0.4330127018922193	4	2	2
fam2998	2	5	2	3.0	1.7320508075688772	0.5773502691896257	5	2	3
fam2999	2	2	6	3.3333333333333335	2.3094010767585034	0.692820323027551	6	2	4
fam3000	2	6	2	3.3333333333333335	2.3094010767585034	0.692820323027551	6	2	4
fam3001	2	6	2	3.3333333333333335	2.3094010767585034	0.692820323027551	6	2	4
fam3002	2	2	6	3.3333333333333335	2.3094010767585034	0.692820323027551	6	2	4
fam3003	2	6	2	3.3333333333333335	2.3094010767585034	0.692820323027551	6	2	4
fam3004	2	6	2	3.3333333333333335	2.3094010767585034	0.692820323027551	6	2	4
fam3005	2	6	2	3.3333333333333335	2.3094010767585034	0.692820323027551	6	2	4
fam3006	2	6	2	3.3333333333333335	2.3094010767585034	0.692820323027551	6	2	4
fam3007	2	6	2	3.3333333333333335	2.3094010767585034	0.692820323027551	6	2	4
fam3008	2	6	2	3.3333333333333335	2.3094010767585034	0.692820323027551	6	2	4
fam3009	2	6	2	3.3333333333333335	2.3094010767585034	0.692820323027551	6	2	4
fam3010	2	6	2	3.3333333333333335	2.3094010767585034	0.692820323027551	6	2	4
fam3011	2	2	6	3.3333333333333335	2.3094010767585034	0.692820323027551	6	2	4
fam3012	2	6	2	3.3333333333333335	2.3094010767585034	0.692820323027551	6	2	4
fam3013	2	6	2	3.3333333333333335	2.3094010767585034	0.692820323027551	6	2	4
fam3014	2	6	2	3.3333333333333335	2.3094010767585034	0.692820323027551	6	2	4
fam3015	2	6	2	3.3333333333333335	2.3094010767585034	0.692820323027551	6	2	4
fam3016	2	6	2	3.3333333333333335	2.3094010767585034	0.692820323027551	6	2	4
fam3017	2	3	3	2.6666666666666665	0.5773502691896258	0.2165063509461097	3	2	1
fam3018	2	6	2	3.3333333333333335	2.3094010767585034	0.692820323027551	6	2	4
fam3019	2	6	2	3.3333333333333335	2.3094010767585034	0.692820323027551	6	2	4
fam3020	6	2	2	3.3333333333333335	2.3094010767585034	0.692820323027551	6	2	4
fam3021	2	5	2	3.0	1.7320508075688772	0.5773502691896257	5	2	3
fam3022	2	6	2	3.3333333333333335	2.3094010767585034	0.692820323027551	6	2	4
fam3023	2	2	6	3.3333333333333335	2.3094010767585034	0.692820323027551	6	2	4
fam3024	2	3	3	2.6666666666666665	0.5773502691896258	0.2165063509461097	3	2	1
fam3025	2	6	2	3.3333333333333335	2.3094010767585034	0.692820323027551	6	2	4
fam3026	2	6	2	3.3333333333333335	2.3094010767585034	0.692820323027551	6	2	4
fam3027	2	6	2	3.3333333333333335	2.3094010767585034	0.692820323027551	6	2	4
fam3028	2	6	2	3.3333333333333335	2.3094010767585034	0.692820323027551	6	2	4
fam3029	2	6	2	3.3333333333333335	2.3094010767585034	0.692820323027551	6	2	4
fam3030	6	2	2	3.3333333333333335	2.3094010767585034	0.692820323027551	6	2	4
fam3031	2	6	2	3.3333333333333335	2.3094010767585034	0.692820323027551	6	2	4
fam3032	2	6	2	3.3333333333333335	2.3094010767585034	0.692820323027551	6	2	4
fam3033	2	5	2	3.0	1.7320508075688772	0.5773502691896257	5	2	3
fam3034	2	6	2	3.3333333333333335	2.3094010767585034	0.692820323027551	6	2	4
fam3035	2	2	6	3.3333333333333335	2.3094010767585034	0.692820323027551	6	2	4
fam3036	2	6	2	3.3333333333333335	2.3094010767585034	0.692820323027551	6	2	4
fam3037	2	4	3	3.0	1.0	0.3333333333333333	4	2	2
fam3038	2	4	3	3.0	1.0	0.3333333333333333	4	2	2
fam3039	2	3	4	3.0	1.0	0.3333333333333333	4	2	2
fam3040	2	3	3	2.6666666666666665	0.5773502691896258	0.2165063509461097	3	2	1
fam3041	2	3	3	2.6666666666666665	0.5773502691896258	0.2165063509461097	3	2	1
fam3042	2	5	2	3.0	1.7320508075688772	0.5773502691896257	5	2	3
fam3043	2	2	5	3.0	1.7320508075688772	0.5773502691896257	5	2	3
fam3044	2	5	2	3.0	1.7320508075688772	0.5773502691896257	5	2	3
fam3045	2	4	2	2.6666666666666665	1.1547005383792515	0.4330127018922193	4	2	2
fam3046	2	4	2	2.6666666666666665	1.1547005383792515	0.4330127018922193	4	2	2
fam3047	2	4	2	2.6666666666666665	1.1547005383792515	0.4330127018922193	4	2	2
fam3048	2	4	2	2.6666666666666665	1.1547005383792515	0.4330127018922193	4	2	2
fam3049	2	5	2	3.0	1.7320508075688772	0.5773502691896257	5	2	3
fam3050	2	4	3	3.0	1.0	0.3333333333333333	4	2	2
fam3051	3	3	2	2.6666666666666665	0.5773502691896258	0.2165063509461097	3	2	1
fam3052	2	4	3	3.0	1.0	0.3333333333333333	4	2	2
fam3053	3	2	3	2.6666666666666665	0.5773502691896258	0.2165063509461097	3	2	1
fam3054	2	3	4	3.0	1.0	0.3333333333333333	4	2	2
fam3055	2	4	3	3.0	1.0	0.3333333333333333	4	2	2
fam3056	2	5	2	3.0	1.7320508075688772	0.5773502691896257	5	2	3
fam3057	2	3	4	3.0	1.0	0.3333333333333333	4	2	2
fam3058	2	5	2	3.0	1.7320508075688772	0.5773502691896257	5	2	3
fam3059	2	4	3	3.0	1.0	0.3333333333333333	4	2	2
fam3060	2	4	3	3.0	1.0	0.3333333333333333	4	2	2
fam3061	2	4	2	2.6666666666666665	1.1547005383792515	0.4330127018922193	4	2	2
fam3062	2	5	2	3.0	1.7320508075688772	0.5773502691896257	5	2	3
fam3063	2	4	2	2.6666666666666665	1.1547005383792515	0.4330127018922193	4	2	2
fam3064	3	2	3	2.6666666666666665	0.5773502691896258	0.2165063509461097	3	2	1
fam3065	2	4	3	3.0	1.0	0.3333333333333333	4	2	2
fam3066	2	3	3	2.6666666666666665	0.5773502691896258	0.2165063509461097	3	2	1
fam3067	2	3	3	2.6666666666666665	0.5773502691896258	0.2165063509461097	3	2	1
fam3068	2	5	2	3.0	1.7320508075688772	0.5773502691896257	5	2	3
fam3069	2	4	3	3.0	1.0	0.3333333333333333	4	2	2
fam3070	2	2	4	2.6666666666666665	1.1547005383792515	0.4330127018922193	4	2	2
fam3071	3	3	2	2.6666666666666665	0.5773502691896258	0.2165063509461097	3	2	1
fam3072	2	5	2	3.0	1.7320508075688772	0.5773502691896257	5	2	3
fam3073	3	4	2	3.0	1.0	0.3333333333333333	4	2	2
fam3074	2	3	4	3.0	1.0	0.3333333333333333	4	2	2
fam3075	3	4	2	3.0	1.0	0.3333333333333333	4	2	2
fam3076	5	2	2	3.0	1.7320508075688772	0.5773502691896257	5	2	3
fam3077	2	3	4	3.0	1.0	0.3333333333333333	4	2	2
fam3078	2	3	4	3.0	1.0	0.3333333333333333	4	2	2
fam3079	2	3	4	3.0	1.0	0.3333333333333333	4	2	2
fam3080	3	2	4	3.0	1.0	0.3333333333333333	4	2	2
fam3081	2	6	2	3.3333333333333335	2.3094010767585034	0.692820323027551	6	2	4
fam3082	2	3	4	3.0	1.0	0.3333333333333333	4	2	2
fam3083	2	4	3	3.0	1.0	0.3333333333333333	4	2	2
fam3084	4	3	2	3.0	1.0	0.3333333333333333	4	2	2
fam3085	2	6	2	3.3333333333333335	2.3094010767585034	0.692820323027551	6	2	4
fam3086	2	3	4	3.0	1.0	0.3333333333333333	4	2	2
fam3087	2	6	2	3.3333333333333335	2.3094010767585034	0.692820323027551	6	2	4
fam3088	2	6	2	3.3333333333333335	2.3094010767585034	0.692820323027551	6	2	4
fam3089	2	5	2	3.0	1.7320508075688772	0.5773502691896257	5	2	3
fam3090	2	6	2	3.3333333333333335	2.3094010767585034	0.692820323027551	6	2	4
fam3091	5	2	2	3.0	1.7320508075688772	0.5773502691896257	5	2	3
fam3092	2	5	2	3.0	1.7320508075688772	0.5773502691896257	5	2	3
fam3093	2	3	4	3.0	1.0	0.3333333333333333	4	2	2
fam3094	2	4	3	3.0	1.0	0.3333333333333333	4	2	2
fam3095	2	3	4	3.0	1.0	0.3333333333333333	4	2	2
fam3096	2	5	2	3.0	1.7320508075688772	0.5773502691896257	5	2	3
fam3097	2	4	3	3.0	1.0	0.3333333333333333	4	2	2
fam3098	2	6	2	3.3333333333333335	2.3094010767585034	0.692820323027551	6	2	4
fam3099	2	5	2	3.0	1.7320508075688772	0.5773502691896257	5	2	3
fam3100	3	4	2	3.0	1.0	0.3333333333333333	4	2	2
fam3101	2	4	3	3.0	1.0	0.3333333333333333	4	2	2
fam3102	2	4	3	3.0	1.0	0.3333333333333333	4	2	2
fam3103	2	4	3	3.0	1.0	0.3333333333333333	4	2	2
fam3104	2	5	2	3.0	1.7320508075688772	0.5773502691896257	5	2	3
fam3105	2	6	2	3.3333333333333335	2.3094010767585034	0.692820323027551	6	2	4
fam3106	2	3	4	3.0	1.0	0.3333333333333333	4	2	2
fam3107	2	6	2	3.3333333333333335	2.3094010767585034	0.692820323027551	6	2	4
fam3108	2	6	2	3.3333333333333335	2.3094010767585034	0.692820323027551	6	2	4
fam3109	2	4	3	3.0	1.0	0.3333333333333333	4	2	2
fam3110	2	4	3	3.0	1.0	0.3333333333333333	4	2	2
fam3111	2	6	2	3.3333333333333335	2.3094010767585034	0.692820323027551	6	2	4
fam3112	2	4	3	3.0	1.0	0.3333333333333333	4	2	2
fam3113	2	4	3	3.0	1.0	0.3333333333333333	4	2	2
fam3114	2	5	2	3.0	1.7320508075688772	0.5773502691896257	5	2	3
fam3115	2	4	3	3.0	1.0	0.3333333333333333	4	2	2
fam3116	2	5	2	3.0	1.7320508075688772	0.5773502691896257	5	2	3
fam3117	2	5	2	3.0	1.7320508075688772	0.5773502691896257	5	2	3
fam3118	2	6	2	3.3333333333333335	2.3094010767585034	0.692820323027551	6	2	4
fam3119	2	6	2	3.3333333333333335	2.3094010767585034	0.692820323027551	6	2	4
fam3120	2	4	3	3.0	1.0	0.3333333333333333	4	2	2
fam3121	2	5	2	3.0	1.7320508075688772	0.5773502691896257	5	2	3
fam3122	5	2	2	3.0	1.7320508075688772	0.5773502691896257	5	2	3
fam3123	2	2	5	3.0	1.7320508075688772	0.5773502691896257	5	2	3
fam3124	2	6	2	3.3333333333333335	2.3094010767585034	0.692820323027551	6	2	4
fam3125	2	2	5	3.0	1.7320508075688772	0.5773502691896257	5	2	3
fam3126	2	5	2	3.0	1.7320508075688772	0.5773502691896257	5	2	3
fam3127	2	5	2	3.0	1.7320508075688772	0.5773502691896257	5	2	3
fam3128	2	4	3	3.0	1.0	0.3333333333333333	4	2	2
fam3129	2	4	3	3.0	1.0	0.3333333333333333	4	2	2
fam3130	3	2	3	2.6666666666666665	0.5773502691896258	0.2165063509461097	3	2	1
fam3131	3	2	3	2.6666666666666665	0.5773502691896258	0.2165063509461097	3	2	1
fam3132	2	4	2	2.6666666666666665	1.1547005383792515	0.4330127018922193	4	2	2
fam3133	2	4	3	3.0	1.0	0.3333333333333333	4	2	2
fam3134	3	2	3	2.6666666666666665	0.5773502691896258	0.2165063509461097	3	2	1
fam3135	2	3	4	3.0	1.0	0.3333333333333333	4	2	2
fam3136	2	3	4	3.0	1.0	0.3333333333333333	4	2	2
fam3137	2	4	3	3.0	1.0	0.3333333333333333	4	2	2
fam3138	2	3	3	2.6666666666666665	0.5773502691896258	0.2165063509461097	3	2	1
fam3139	2	3	4	3.0	1.0	0.3333333333333333	4	2	2
fam3140	3	3	2	2.6666666666666665	0.5773502691896258	0.2165063509461097	3	2	1
fam3141	2	3	3	2.6666666666666665	0.5773502691896258	0.2165063509461097	3	2	1
fam3142	2	2	5	3.0	1.7320508075688772	0.5773502691896257	5	2	3
fam3143	2	5	2	3.0	1.7320508075688772	0.5773502691896257	5	2	3
fam3144	2	4	2	2.6666666666666665	1.1547005383792515	0.4330127018922193	4	2	2
fam3145	3	3	2	2.6666666666666665	0.5773502691896258	0.2165063509461097	3	2	1
fam3146	2	3	2	2.3333333333333335	0.5773502691896258	0.24743582965269678	3	2	1
fam3147	2	2	3	2.3333333333333335	0.5773502691896258	0.24743582965269678	3	2	1
fam3148	2	3	3	2.6666666666666665	0.5773502691896258	0.2165063509461097	3	2	1
fam3149	2	2	3	2.3333333333333335	0.5773502691896258	0.24743582965269678	3	2	1
fam3150	2	3	3	2.6666666666666665	0.5773502691896258	0.2165063509461097	3	2	1
fam3151	2	2	3	2.3333333333333335	0.5773502691896258	0.24743582965269678	3	2	1
fam3152	2	3	2	2.3333333333333335	0.5773502691896258	0.24743582965269678	3	2	1
fam3153	2	3	3	2.6666666666666665	0.5773502691896258	0.2165063509461097	3	2	1
fam3154	2	3	3	2.6666666666666665	0.5773502691896258	0.2165063509461097	3	2	1
fam3155	3	3	2	2.6666666666666665	0.5773502691896258	0.2165063509461097	3	2	1
fam3156	3	2	2	2.3333333333333335	0.5773502691896258	0.24743582965269678	3	2	1
fam3157	2	3	3	2.6666666666666665	0.5773502691896258	0.2165063509461097	3	2	1
fam3158	3	3	2	2.6666666666666665	0.5773502691896258	0.2165063509461097	3	2	1
fam3159	2	2	3	2.3333333333333335	0.5773502691896258	0.24743582965269678	3	2	1
fam3160	3	3	2	2.6666666666666665	0.5773502691896258	0.2165063509461097	3	2	1
fam3161	3	2	2	2.3333333333333335	0.5773502691896258	0.24743582965269678	3	2	1
fam3162	2	2	3	2.3333333333333335	0.5773502691896258	0.24743582965269678	3	2	1
fam3163	2	3	2	2.3333333333333335	0.5773502691896258	0.24743582965269678	3	2	1
fam3164	2	3	2	2.3333333333333335	0.5773502691896258	0.24743582965269678	3	2	1
fam3165	2	2	3	2.3333333333333335	0.5773502691896258	0.24743582965269678	3	2	1
fam3166	2	3	2	2.3333333333333335	0.5773502691896258	0.24743582965269678	3	2	1
fam3167	3	2	3	2.6666666666666665	0.5773502691896258	0.2165063509461097	3	2	1
fam3168	3	2	2	2.3333333333333335	0.5773502691896258	0.24743582965269678	3	2	1
fam3169	3	3	2	2.6666666666666665	0.5773502691896258	0.2165063509461097	3	2	1
fam3170	2	3	2	2.3333333333333335	0.5773502691896258	0.24743582965269678	3	2	1
fam3171	2	3	2	2.3333333333333335	0.5773502691896258	0.24743582965269678	3	2	1
fam3172	2	3	3	2.6666666666666665	0.5773502691896258	0.2165063509461097	3	2	1
fam3173	2	3	3	2.6666666666666665	0.5773502691896258	0.2165063509461097	3	2	1
fam3174	2	3	2	2.3333333333333335	0.5773502691896258	0.24743582965269678	3	2	1
fam3175	2	3	3	2.6666666666666665	0.5773502691896258	0.2165063509461097	3	2	1
fam3176	2	3	2	2.3333333333333335	0.5773502691896258	0.24743582965269678	3	2	1
fam3177	2	3	2	2.3333333333333335	0.5773502691896258	0.24743582965269678	3	2	1
fam3178	2	3	2	2.3333333333333335	0.5773502691896258	0.24743582965269678	3	2	1
fam3179	2	2	3	2.3333333333333335	0.5773502691896258	0.24743582965269678	3	2	1
fam3180	2	3	2	2.3333333333333335	0.5773502691896258	0.24743582965269678	3	2	1
fam3181	3	2	2	2.3333333333333335	0.5773502691896258	0.24743582965269678	3	2	1
fam3182	3	2	2	2.3333333333333335	0.5773502691896258	0.24743582965269678	3	2	1
fam3183	2	3	3	2.6666666666666665	0.5773502691896258	0.2165063509461097	3	2	1
fam3184	2	3	3	2.6666666666666665	0.5773502691896258	0.2165063509461097	3	2	1
fam3185	3	2	2	2.3333333333333335	0.5773502691896258	0.24743582965269678	3	2	1
fam3186	2	3	3	2.6666666666666665	0.5773502691896258	0.2165063509461097	3	2	1
fam3187	2	3	3	2.6666666666666665	0.5773502691896258	0.2165063509461097	3	2	1
fam3188	2	3	3	2.6666666666666665	0.5773502691896258	0.2165063509461097	3	2	1
fam3189	2	3	3	2.6666666666666665	0.5773502691896258	0.2165063509461097	3	2	1
fam3190	2	3	3	2.6666666666666665	0.5773502691896258	0.2165063509461097	3	2	1
fam3191	3	2	3	2.6666666666666665	0.5773502691896258	0.2165063509461097	3	2	1
fam3192	2	3	3	2.6666666666666665	0.5773502691896258	0.2165063509461097	3	2	1
fam3193	2	3	3	2.6666666666666665	0.5773502691896258	0.2165063509461097	3	2	1
fam3194	2	3	2	2.3333333333333335	0.5773502691896258	0.24743582965269678	3	2	1
fam3195	3	2	2	2.3333333333333335	0.5773502691896258	0.24743582965269678	3	2	1
fam3196	2	3	3	2.6666666666666665	0.5773502691896258	0.2165063509461097	3	2	1
fam3197	2	3	2	2.3333333333333335	0.5773502691896258	0.24743582965269678	3	2	1
fam3198	2	3	2	2.3333333333333335	0.5773502691896258	0.24743582965269678	3	2	1
fam3199	2	2	3	2.3333333333333335	0.5773502691896258	0.24743582965269678	3	2	1
fam3200	2	2	3	2.3333333333333335	0.5773502691896258	0.24743582965269678	3	2	1
fam3201	2	3	3	2.6666666666666665	0.5773502691896258	0.2165063509461097	3	2	1
fam3202	2	3	3	2.6666666666666665	0.5773502691896258	0.2165063509461097	3	2	1
fam3203	3	2	2	2.3333333333333335	0.5773502691896258	0.24743582965269678	3	2	1
fam3204	3	3	2	2.6666666666666665	0.5773502691896258	0.2165063509461097	3	2	1
fam3205	2	3	2	2.3333333333333335	0.5773502691896258	0.24743582965269678	3	2	1
fam3206	2	3	3	2.6666666666666665	0.5773502691896258	0.2165063509461097	3	2	1
fam3207	2	3	2	2.3333333333333335	0.5773502691896258	0.24743582965269678	3	2	1
fam3208	2	3	3	2.6666666666666665	0.5773502691896258	0.2165063509461097	3	2	1
fam3209	3	2	2	2.3333333333333335	0.5773502691896258	0.24743582965269678	3	2	1
fam3210	2	3	3	2.6666666666666665	0.5773502691896258	0.2165063509461097	3	2	1
fam3211	2	3	2	2.3333333333333335	0.5773502691896258	0.24743582965269678	3	2	1
fam3212	2	3	3	2.6666666666666665	0.5773502691896258	0.2165063509461097	3	2	1
fam3213	3	3	2	2.6666666666666665	0.5773502691896258	0.2165063509461097	3	2	1
fam3214	2	3	2	2.3333333333333335	0.5773502691896258	0.24743582965269678	3	2	1
fam3215	2	3	3	2.6666666666666665	0.5773502691896258	0.2165063509461097	3	2	1
fam3216	2	3	2	2.3333333333333335	0.5773502691896258	0.24743582965269678	3	2	1
fam3217	2	2	3	2.3333333333333335	0.5773502691896258	0.24743582965269678	3	2	1
fam3218	2	3	3	2.6666666666666665	0.5773502691896258	0.2165063509461097	3	2	1
fam3219	2	3	3	2.6666666666666665	0.5773502691896258	0.2165063509461097	3	2	1
fam3220	2	3	3	2.6666666666666665	0.5773502691896258	0.2165063509461097	3	2	1
fam3221	3	2	2	2.3333333333333335	0.5773502691896258	0.24743582965269678	3	2	1
fam3222	2	3	2	2.3333333333333335	0.5773502691896258	0.24743582965269678	3	2	1
fam3223	2	2	3	2.3333333333333335	0.5773502691896258	0.24743582965269678	3	2	1
fam3224	2	3	3	2.6666666666666665	0.5773502691896258	0.2165063509461097	3	2	1
fam3225	2	3	3	2.6666666666666665	0.5773502691896258	0.2165063509461097	3	2	1
fam3226	3	2	2	2.3333333333333335	0.5773502691896258	0.24743582965269678	3	2	1
fam3227	2	3	3	2.6666666666666665	0.5773502691896258	0.2165063509461097	3	2	1
fam3228	2	3	3	2.6666666666666665	0.5773502691896258	0.2165063509461097	3	2	1
fam3229	2	3	3	2.6666666666666665	0.5773502691896258	0.2165063509461097	3	2	1
fam3230	2	3	2	2.3333333333333335	0.5773502691896258	0.24743582965269678	3	2	1
fam3231	2	3	3	2.6666666666666665	0.5773502691896258	0.2165063509461097	3	2	1
fam3232	2	3	2	2.3333333333333335	0.5773502691896258	0.24743582965269678	3	2	1
fam3233	2	3	3	2.6666666666666665	0.5773502691896258	0.2165063509461097	3	2	1
fam3234	3	2	2	2.3333333333333335	0.5773502691896258	0.24743582965269678	3	2	1
fam3235	2	3	3	2.6666666666666665	0.5773502691896258	0.2165063509461097	3	2	1
fam3236	2	2	3	2.3333333333333335	0.5773502691896258	0.24743582965269678	3	2	1
fam3237	2	3	2	2.3333333333333335	0.5773502691896258	0.24743582965269678	3	2	1
fam3238	2	3	2	2.3333333333333335	0.5773502691896258	0.24743582965269678	3	2	1
fam3239	2	3	2	2.3333333333333335	0.5773502691896258	0.24743582965269678	3	2	1
fam3240	3	2	2	2.3333333333333335	0.5773502691896258	0.24743582965269678	3	2	1
fam3241	2	2	3	2.3333333333333335	0.5773502691896258	0.24743582965269678	3	2	1
fam3242	2	3	2	2.3333333333333335	0.5773502691896258	0.24743582965269678	3	2	1
fam3243	2	3	2	2.3333333333333335	0.5773502691896258	0.24743582965269678	3	2	1
fam3244	2	3	3	2.6666666666666665	0.5773502691896258	0.2165063509461097	3	2	1
fam3245	3	2	2	2.3333333333333335	0.5773502691896258	0.24743582965269678	3	2	1
fam3246	2	3	3	2.6666666666666665	0.5773502691896258	0.2165063509461097	3	2	1
fam3247	2	3	2	2.3333333333333335	0.5773502691896258	0.24743582965269678	3	2	1
fam3248	2	3	3	2.6666666666666665	0.5773502691896258	0.2165063509461097	3	2	1
fam3249	2	3	3	2.6666666666666665	0.5773502691896258	0.2165063509461097	3	2	1
fam3250	2	3	2	2.3333333333333335	0.5773502691896258	0.24743582965269678	3	2	1
fam3251	2	3	2	2.3333333333333335	0.5773502691896258	0.24743582965269678	3	2	1
fam3252	3	2	2	2.3333333333333335	0.5773502691896258	0.24743582965269678	3	2	1
fam3253	2	3	3	2.6666666666666665	0.5773502691896258	0.2165063509461097	3	2	1
fam3254	2	3	2	2.3333333333333335	0.5773502691896258	0.24743582965269678	3	2	1
fam3255	2	3	3	2.6666666666666665	0.5773502691896258	0.2165063509461097	3	2	1
fam3256	2	3	3	2.6666666666666665	0.5773502691896258	0.2165063509461097	3	2	1
fam3257	2	3	3	2.6666666666666665	0.5773502691896258	0.2165063509461097	3	2	1
fam3258	2	3	2	2.3333333333333335	0.5773502691896258	0.24743582965269678	3	2	1
fam3259	2	3	2	2.3333333333333335	0.5773502691896258	0.24743582965269678	3	2	1
fam3260	3	2	2	2.3333333333333335	0.5773502691896258	0.24743582965269678	3	2	1
fam3261	3	2	2	2.3333333333333335	0.5773502691896258	0.24743582965269678	3	2	1
fam3262	2	3	3	2.6666666666666665	0.5773502691896258	0.2165063509461097	3	2	1
fam3263	2	3	3	2.6666666666666665	0.5773502691896258	0.2165063509461097	3	2	1
fam3264	2	3	3	2.6666666666666665	0.5773502691896258	0.2165063509461097	3	2	1
fam3265	2	2	3	2.3333333333333335	0.5773502691896258	0.24743582965269678	3	2	1
fam3266	3	3	2	2.6666666666666665	0.5773502691896258	0.2165063509461097	3	2	1
fam3267	3	2	2	2.3333333333333335	0.5773502691896258	0.24743582965269678	3	2	1
fam3268	2	3	3	2.6666666666666665	0.5773502691896258	0.2165063509461097	3	2	1
fam3269	2	3	2	2.3333333333333335	0.5773502691896258	0.24743582965269678	3	2	1
fam3270	2	3	3	2.6666666666666665	0.5773502691896258	0.2165063509461097	3	2	1
fam3271	2	3	3	2.6666666666666665	0.5773502691896258	0.2165063509461097	3	2	1
fam3272	2	3	3	2.6666666666666665	0.5773502691896258	0.2165063509461097	3	2	1
fam3273	2	3	3	2.6666666666666665	0.5773502691896258	0.2165063509461097	3	2	1
fam3274	2	3	3	2.6666666666666665	0.5773502691896258	0.2165063509461097	3	2	1
fam3275	2	3	2	2.3333333333333335	0.5773502691896258	0.24743582965269678	3	2	1
fam3276	2	3	2	2.3333333333333335	0.5773502691896258	0.24743582965269678	3	2	1
fam3277	2	3	3	2.6666666666666665	0.5773502691896258	0.2165063509461097	3	2	1
fam3278	3	2	2	2.3333333333333335	0.5773502691896258	0.24743582965269678	3	2	1
fam3279	2	3	2	2.3333333333333335	0.5773502691896258	0.24743582965269678	3	2	1
fam3280	2	3	3	2.6666666666666665	0.5773502691896258	0.2165063509461097	3	2	1
fam3281	2	3	3	2.6666666666666665	0.5773502691896258	0.2165063509461097	3	2	1
fam3282	2	3	2	2.3333333333333335	0.5773502691896258	0.24743582965269678	3	2	1
fam3283	2	3	3	2.6666666666666665	0.5773502691896258	0.2165063509461097	3	2	1
fam3284	2	3	2	2.3333333333333335	0.5773502691896258	0.24743582965269678	3	2	1
fam3285	3	2	2	2.3333333333333335	0.5773502691896258	0.24743582965269678	3	2	1
fam3286	2	3	3	2.6666666666666665	0.5773502691896258	0.2165063509461097	3	2	1
fam3287	2	3	3	2.6666666666666665	0.5773502691896258	0.2165063509461097	3	2	1
fam3288	2	3	3	2.6666666666666665	0.5773502691896258	0.2165063509461097	3	2	1
fam3289	2	3	2	2.3333333333333335	0.5773502691896258	0.24743582965269678	3	2	1
fam3290	3	2	2	2.3333333333333335	0.5773502691896258	0.24743582965269678	3	2	1
fam3291	2	2	3	2.3333333333333335	0.5773502691896258	0.24743582965269678	3	2	1
fam3292	2	2	3	2.3333333333333335	0.5773502691896258	0.24743582965269678	3	2	1
fam3293	2	3	3	2.6666666666666665	0.5773502691896258	0.2165063509461097	3	2	1
fam3294	2	3	2	2.3333333333333335	0.5773502691896258	0.24743582965269678	3	2	1
fam3295	2	2	3	2.3333333333333335	0.5773502691896258	0.24743582965269678	3	2	1
fam3296	3	3	2	2.6666666666666665	0.5773502691896258	0.2165063509461097	3	2	1
fam3297	2	3	3	2.6666666666666665	0.5773502691896258	0.2165063509461097	3	2	1
fam3298	2	3	3	2.6666666666666665	0.5773502691896258	0.2165063509461097	3	2	1
fam3299	2	3	3	2.6666666666666665	0.5773502691896258	0.2165063509461097	3	2	1
fam3300	2	2	3	2.3333333333333335	0.5773502691896258	0.24743582965269678	3	2	1
fam3301	2	3	3	2.6666666666666665	0.5773502691896258	0.2165063509461097	3	2	1
fam3302	2	3	3	2.6666666666666665	0.5773502691896258	0.2165063509461097	3	2	1
fam3303	2	2	3	2.3333333333333335	0.5773502691896258	0.24743582965269678	3	2	1
fam3304	2	3	2	2.3333333333333335	0.5773502691896258	0.24743582965269678	3	2	1
fam3305	3	3	2	2.6666666666666665	0.5773502691896258	0.2165063509461097	3	2	1
fam3306	3	2	2	2.3333333333333335	0.5773502691896258	0.24743582965269678	3	2	1
fam3307	3	2	2	2.3333333333333335	0.5773502691896258	0.24743582965269678	3	2	1
fam3308	3	2	2	2.3333333333333335	0.5773502691896258	0.24743582965269678	3	2	1
fam3309	2	2	3	2.3333333333333335	0.5773502691896258	0.24743582965269678	3	2	1
fam3310	3	2	2	2.3333333333333335	0.5773502691896258	0.24743582965269678	3	2	1
fam3311	3	3	2	2.6666666666666665	0.5773502691896258	0.2165063509461097	3	2	1
fam3312	3	2	2	2.3333333333333335	0.5773502691896258	0.24743582965269678	3	2	1
fam3313	2	3	3	2.6666666666666665	0.5773502691896258	0.2165063509461097	3	2	1
fam3314	3	3	2	2.6666666666666665	0.5773502691896258	0.2165063509461097	3	2	1
fam3315	3	2	2	2.3333333333333335	0.5773502691896258	0.24743582965269678	3	2	1
fam3316	2	3	3	2.6666666666666665	0.5773502691896258	0.2165063509461097	3	2	1
fam3317	2	3	2	2.3333333333333335	0.5773502691896258	0.24743582965269678	3	2	1
fam3318	2	3	2	2.3333333333333335	0.5773502691896258	0.24743582965269678	3	2	1
fam3319	2	3	2	2.3333333333333335	0.5773502691896258	0.24743582965269678	3	2	1
fam3320	3	2	3	2.6666666666666665	0.5773502691896258	0.2165063509461097	3	2	1
fam3321	3	2	2	2.3333333333333335	0.5773502691896258	0.24743582965269678	3	2	1
fam3322	2	3	3	2.6666666666666665	0.5773502691896258	0.2165063509461097	3	2	1
fam3323	3	2	3	2.6666666666666665	0.5773502691896258	0.2165063509461097	3	2	1
fam3324	2	3	2	2.3333333333333335	0.5773502691896258	0.24743582965269678	3	2	1
fam3325	2	3	3	2.6666666666666665	0.5773502691896258	0.2165063509461097	3	2	1
fam3326	2	3	3	2.6666666666666665	0.5773502691896258	0.2165063509461097	3	2	1
fam3327	2	3	2	2.3333333333333335	0.5773502691896258	0.24743582965269678	3	2	1
fam3328	2	2	3	2.3333333333333335	0.5773502691896258	0.24743582965269678	3	2	1
fam3329	2	3	3	2.6666666666666665	0.5773502691896258	0.2165063509461097	3	2	1
fam3330	3	2	2	2.3333333333333335	0.5773502691896258	0.24743582965269678	3	2	1
fam3331	2	3	3	2.6666666666666665	0.5773502691896258	0.2165063509461097	3	2	1
fam3332	2	3	3	2.6666666666666665	0.5773502691896258	0.2165063509461097	3	2	1
fam3333	2	3	3	2.6666666666666665	0.5773502691896258	0.2165063509461097	3	2	1
fam3334	2	3	2	2.3333333333333335	0.5773502691896258	0.24743582965269678	3	2	1
fam3335	2	3	3	2.6666666666666665	0.5773502691896258	0.2165063509461097	3	2	1
fam3336	3	2	2	2.3333333333333335	0.5773502691896258	0.24743582965269678	3	2	1
fam3337	2	3	3	2.6666666666666665	0.5773502691896258	0.2165063509461097	3	2	1
fam3338	2	3	3	2.6666666666666665	0.5773502691896258	0.2165063509461097	3	2	1
fam3339	2	3	2	2.3333333333333335	0.5773502691896258	0.24743582965269678	3	2	1
fam3340	2	3	3	2.6666666666666665	0.5773502691896258	0.2165063509461097	3	2	1
fam3341	2	3	2	2.3333333333333335	0.5773502691896258	0.24743582965269678	3	2	1
fam3342	3	2	2	2.3333333333333335	0.5773502691896258	0.24743582965269678	3	2	1
fam3343	3	2	2	2.3333333333333335	0.5773502691896258	0.24743582965269678	3	2	1
fam3344	2	2	3	2.3333333333333335	0.5773502691896258	0.24743582965269678	3	2	1
fam3345	3	3	2	2.6666666666666665	0.5773502691896258	0.2165063509461097	3	2	1
fam3346	3	2	2	2.3333333333333335	0.5773502691896258	0.24743582965269678	3	2	1
fam3347	3	3	2	2.6666666666666665	0.5773502691896258	0.2165063509461097	3	2	1
fam3348	3	2	2	2.3333333333333335	0.5773502691896258	0.24743582965269678	3	2	1
fam3349	2	3	2	2.3333333333333335	0.5773502691896258	0.24743582965269678	3	2	1
fam3350	2	2	3	2.3333333333333335	0.5773502691896258	0.24743582965269678	3	2	1
fam3351	2	3	2	2.3333333333333335	0.5773502691896258	0.24743582965269678	3	2	1
fam3352	2	3	2	2.3333333333333335	0.5773502691896258	0.24743582965269678	3	2	1
fam3353	2	3	2	2.3333333333333335	0.5773502691896258	0.24743582965269678	3	2	1
fam3354	2	3	3	2.6666666666666665	0.5773502691896258	0.2165063509461097	3	2	1
fam3355	2	3	3	2.6666666666666665	0.5773502691896258	0.2165063509461097	3	2	1
fam3356	3	2	2	2.3333333333333335	0.5773502691896258	0.24743582965269678	3	2	1
fam3357	2	3	2	2.3333333333333335	0.5773502691896258	0.24743582965269678	3	2	1
fam3358	3	3	2	2.6666666666666665	0.5773502691896258	0.2165063509461097	3	2	1
fam3359	2	2	3	2.3333333333333335	0.5773502691896258	0.24743582965269678	3	2	1
fam3360	2	3	3	2.6666666666666665	0.5773502691896258	0.2165063509461097	3	2	1
fam3361	2	3	3	2.6666666666666665	0.5773502691896258	0.2165063509461097	3	2	1
fam3362	2	3	3	2.6666666666666665	0.5773502691896258	0.2165063509461097	3	2	1
fam3363	2	3	2	2.3333333333333335	0.5773502691896258	0.24743582965269678	3	2	1
fam3364	3	2	2	2.3333333333333335	0.5773502691896258	0.24743582965269678	3	2	1
fam3365	3	2	2	2.3333333333333335	0.5773502691896258	0.24743582965269678	3	2	1
fam3366	2	2	3	2.3333333333333335	0.5773502691896258	0.24743582965269678	3	2	1
fam3367	2	3	2	2.3333333333333335	0.5773502691896258	0.24743582965269678	3	2	1
fam3368	2	3	2	2.3333333333333335	0.5773502691896258	0.24743582965269678	3	2	1
fam3369	2	3	3	2.6666666666666665	0.5773502691896258	0.2165063509461097	3	2	1
fam3370	2	3	3	2.6666666666666665	0.5773502691896258	0.2165063509461097	3	2	1
fam3371	2	3	3	2.6666666666666665	0.5773502691896258	0.2165063509461097	3	2	1
fam3372	2	3	3	2.6666666666666665	0.5773502691896258	0.2165063509461097	3	2	1
fam3373	2	3	3	2.6666666666666665	0.5773502691896258	0.2165063509461097	3	2	1
fam3374	2	3	3	2.6666666666666665	0.5773502691896258	0.2165063509461097	3	2	1
fam3375	2	3	2	2.3333333333333335	0.5773502691896258	0.24743582965269678	3	2	1
fam3376	2	3	3	2.6666666666666665	0.5773502691896258	0.2165063509461097	3	2	1
fam3377	2	3	2	2.3333333333333335	0.5773502691896258	0.24743582965269678	3	2	1
fam3378	2	3	3	2.6666666666666665	0.5773502691896258	0.2165063509461097	3	2	1
fam3379	2	3	3	2.6666666666666665	0.5773502691896258	0.2165063509461097	3	2	1
fam3380	2	3	3	2.6666666666666665	0.5773502691896258	0.2165063509461097	3	2	1
fam3381	2	3	3	2.6666666666666665	0.5773502691896258	0.2165063509461097	3	2	1
fam3382	2	3	2	2.3333333333333335	0.5773502691896258	0.24743582965269678	3	2	1
fam3383	3	2	2	2.3333333333333335	0.5773502691896258	0.24743582965269678	3	2	1
fam3384	2	3	2	2.3333333333333335	0.5773502691896258	0.24743582965269678	3	2	1
fam3385	3	2	2	2.3333333333333335	0.5773502691896258	0.24743582965269678	3	2	1
fam3386	2	3	2	2.3333333333333335	0.5773502691896258	0.24743582965269678	3	2	1
fam3387	2	2	3	2.3333333333333335	0.5773502691896258	0.24743582965269678	3	2	1
fam3388	2	3	3	2.6666666666666665	0.5773502691896258	0.2165063509461097	3	2	1
fam3389	2	3	3	2.6666666666666665	0.5773502691896258	0.2165063509461097	3	2	1
fam3390	3	2	2	2.3333333333333335	0.5773502691896258	0.24743582965269678	3	2	1
fam3391	2	3	3	2.6666666666666665	0.5773502691896258	0.2165063509461097	3	2	1
fam3392	2	2	3	2.3333333333333335	0.5773502691896258	0.24743582965269678	3	2	1
fam3393	2	2	3	2.3333333333333335	0.5773502691896258	0.24743582965269678	3	2	1
fam3394	3	2	3	2.6666666666666665	0.5773502691896258	0.2165063509461097	3	2	1
fam3395	3	3	2	2.6666666666666665	0.5773502691896258	0.2165063509461097	3	2	1
fam3396	3	2	2	2.3333333333333335	0.5773502691896258	0.24743582965269678	3	2	1
fam3397	2	3	2	2.3333333333333335	0.5773502691896258	0.24743582965269678	3	2	1
fam3398	2	3	3	2.6666666666666665	0.5773502691896258	0.2165063509461097	3	2	1
fam3399	2	3	2	2.3333333333333335	0.5773502691896258	0.24743582965269678	3	2	1
fam3400	2	3	2	2.3333333333333335	0.5773502691896258	0.24743582965269678	3	2	1
fam3401	2	3	2	2.3333333333333335	0.5773502691896258	0.24743582965269678	3	2	1
fam3402	2	3	3	2.6666666666666665	0.5773502691896258	0.2165063509461097	3	2	1
fam3403	3	2	2	2.3333333333333335	0.5773502691896258	0.24743582965269678	3	2	1
fam3404	3	2	2	2.3333333333333335	0.5773502691896258	0.24743582965269678	3	2	1
fam3405	2	3	2	2.3333333333333335	0.5773502691896258	0.24743582965269678	3	2	1
fam3406	2	3	3	2.6666666666666665	0.5773502691896258	0.2165063509461097	3	2	1
fam3407	3	3	2	2.6666666666666665	0.5773502691896258	0.2165063509461097	3	2	1
fam3408	2	3	3	2.6666666666666665	0.5773502691896258	0.2165063509461097	3	2	1
fam3409	2	3	2	2.3333333333333335	0.5773502691896258	0.24743582965269678	3	2	1
fam3410	3	2	2	2.3333333333333335	0.5773502691896258	0.24743582965269678	3	2	1
fam3411	2	2	3	2.3333333333333335	0.5773502691896258	0.24743582965269678	3	2	1
fam3412	2	3	3	2.6666666666666665	0.5773502691896258	0.2165063509461097	3	2	1
fam3413	2	3	2	2.3333333333333335	0.5773502691896258	0.24743582965269678	3	2	1
fam3414	2	3	3	2.6666666666666665	0.5773502691896258	0.2165063509461097	3	2	1
fam3415	3	3	2	2.6666666666666665	0.5773502691896258	0.2165063509461097	3	2	1
fam3416	3	2	2	2.3333333333333335	0.5773502691896258	0.24743582965269678	3	2	1
fam3417	2	3	3	2.6666666666666665	0.5773502691896258	0.2165063509461097	3	2	1
fam3418	2	3	3	2.6666666666666665	0.5773502691896258	0.2165063509461097	3	2	1
fam3419	2	3	2	2.3333333333333335	0.5773502691896258	0.24743582965269678	3	2	1
fam3420	2	3	2	2.3333333333333335	0.5773502691896258	0.24743582965269678	3	2	1
fam3421	2	3	3	2.6666666666666665	0.5773502691896258	0.2165063509461097	3	2	1
fam3422	2	3	3	2.6666666666666665	0.5773502691896258	0.2165063509461097	3	2	1
fam3423	2	3	3	2.6666666666666665	0.5773502691896258	0.2165063509461097	3	2	1
fam3424	3	2	2	2.3333333333333335	0.5773502691896258	0.24743582965269678	3	2	1
fam3425	3	2	3	2.6666666666666665	0.5773502691896258	0.2165063509461097	3	2	1
fam3426	2	3	3	2.6666666666666665	0.5773502691896258	0.2165063509461097	3	2	1
fam3427	2	2	3	2.3333333333333335	0.5773502691896258	0.24743582965269678	3	2	1
fam3428	2	3	2	2.3333333333333335	0.5773502691896258	0.24743582965269678	3	2	1
fam3429	2	3	3	2.6666666666666665	0.5773502691896258	0.2165063509461097	3	2	1
fam3430	2	3	3	2.6666666666666665	0.5773502691896258	0.2165063509461097	3	2	1
fam3431	2	3	2	2.3333333333333335	0.5773502691896258	0.24743582965269678	3	2	1
fam3432	3	2	3	2.6666666666666665	0.5773502691896258	0.2165063509461097	3	2	1
fam3433	3	2	2	2.3333333333333335	0.5773502691896258	0.24743582965269678	3	2	1
fam3434	3	3	2	2.6666666666666665	0.5773502691896258	0.2165063509461097	3	2	1
fam3435	2	3	2	2.3333333333333335	0.5773502691896258	0.24743582965269678	3	2	1
fam3436	2	3	2	2.3333333333333335	0.5773502691896258	0.24743582965269678	3	2	1
fam3437	3	3	2	2.6666666666666665	0.5773502691896258	0.2165063509461097	3	2	1
fam3438	3	2	2	2.3333333333333335	0.5773502691896258	0.24743582965269678	3	2	1
fam3439	2	3	3	2.6666666666666665	0.5773502691896258	0.2165063509461097	3	2	1
fam3440	3	2	2	2.3333333333333335	0.5773502691896258	0.24743582965269678	3	2	1
fam3441	2	3	3	2.6666666666666665	0.5773502691896258	0.2165063509461097	3	2	1
fam3442	2	3	2	2.3333333333333335	0.5773502691896258	0.24743582965269678	3	2	1
fam3443	3	2	2	2.3333333333333335	0.5773502691896258	0.24743582965269678	3	2	1
fam3444	3	2	2	2.3333333333333335	0.5773502691896258	0.24743582965269678	3	2	1
fam3445	3	2	2	2.3333333333333335	0.5773502691896258	0.24743582965269678	3	2	1
fam3446	2	3	3	2.6666666666666665	0.5773502691896258	0.2165063509461097	3	2	1
fam3447	3	2	3	2.6666666666666665	0.5773502691896258	0.2165063509461097	3	2	1
fam3448	3	2	2	2.3333333333333335	0.5773502691896258	0.24743582965269678	3	2	1
fam3449	2	3	3	2.6666666666666665	0.5773502691896258	0.2165063509461097	3	2	1
fam3450	2	2	3	2.3333333333333335	0.5773502691896258	0.24743582965269678	3	2	1
fam3451	2	3	2	2.3333333333333335	0.5773502691896258	0.24743582965269678	3	2	1
fam3452	3	2	2	2.3333333333333335	0.5773502691896258	0.24743582965269678	3	2	1
fam3453	3	2	2	2.3333333333333335	0.5773502691896258	0.24743582965269678	3	2	1
fam3454	2	3	3	2.6666666666666665	0.5773502691896258	0.2165063509461097	3	2	1
fam3455	2	3	2	2.3333333333333335	0.5773502691896258	0.24743582965269678	3	2	1
fam3456	2	2	3	2.3333333333333335	0.5773502691896258	0.24743582965269678	3	2	1
fam3457	2	3	3	2.6666666666666665	0.5773502691896258	0.2165063509461097	3	2	1
fam3458	3	2	3	2.6666666666666665	0.5773502691896258	0.2165063509461097	3	2	1
fam3459	2	3	3	2.6666666666666665	0.5773502691896258	0.2165063509461097	3	2	1
fam3460	2	3	3	2.6666666666666665	0.5773502691896258	0.2165063509461097	3	2	1
fam3461	3	3	2	2.6666666666666665	0.5773502691896258	0.2165063509461097	3	2	1
fam3462	2	2	3	2.3333333333333335	0.5773502691896258	0.24743582965269678	3	2	1
fam3463	2	3	3	2.6666666666666665	0.5773502691896258	0.2165063509461097	3	2	1
fam3464	3	3	2	2.6666666666666665	0.5773502691896258	0.2165063509461097	3	2	1
fam3465	2	3	2	2.3333333333333335	0.5773502691896258	0.24743582965269678	3	2	1
fam3466	2	3	3	2.6666666666666665	0.5773502691896258	0.2165063509461097	3	2	1
fam3467	2	3	2	2.3333333333333335	0.5773502691896258	0.24743582965269678	3	2	1
fam3468	2	2	3	2.3333333333333335	0.5773502691896258	0.24743582965269678	3	2	1
fam3469	2	3	3	2.6666666666666665	0.5773502691896258	0.2165063509461097	3	2	1
fam3470	2	2	3	2.3333333333333335	0.5773502691896258	0.24743582965269678	3	2	1
fam3471	2	3	3	2.6666666666666665	0.5773502691896258	0.2165063509461097	3	2	1
fam3472	3	2	3	2.6666666666666665	0.5773502691896258	0.2165063509461097	3	2	1
fam3473	2	3	2	2.3333333333333335	0.5773502691896258	0.24743582965269678	3	2	1
fam3474	3	2	2	2.3333333333333335	0.5773502691896258	0.24743582965269678	3	2	1
fam3475	2	3	3	2.6666666666666665	0.5773502691896258	0.2165063509461097	3	2	1
fam3476	2	3	3	2.6666666666666665	0.5773502691896258	0.2165063509461097	3	2	1
fam3477	2	3	2	2.3333333333333335	0.5773502691896258	0.24743582965269678	3	2	1
fam3478	2	3	2	2.3333333333333335	0.5773502691896258	0.24743582965269678	3	2	1
fam3479	2	2	3	2.3333333333333335	0.5773502691896258	0.24743582965269678	3	2	1
fam3480	2	3	2	2.3333333333333335	0.5773502691896258	0.24743582965269678	3	2	1
fam3481	2	3	3	2.6666666666666665	0.5773502691896258	0.2165063509461097	3	2	1
fam3482	3	3	2	2.6666666666666665	0.5773502691896258	0.2165063509461097	3	2	1
fam3483	2	2	3	2.3333333333333335	0.5773502691896258	0.24743582965269678	3	2	1
fam3484	2	3	3	2.6666666666666665	0.5773502691896258	0.2165063509461097	3	2	1
fam3485	2	3	2	2.3333333333333335	0.5773502691896258	0.24743582965269678	3	2	1
fam3486	2	3	2	2.3333333333333335	0.5773502691896258	0.24743582965269678	3	2	1
fam3487	2	2	3	2.3333333333333335	0.5773502691896258	0.24743582965269678	3	2	1
fam3488	3	2	2	2.3333333333333335	0.5773502691896258	0.24743582965269678	3	2	1
fam3489	2	3	2	2.3333333333333335	0.5773502691896258	0.24743582965269678	3	2	1
fam3490	2	2	3	2.3333333333333335	0.5773502691896258	0.24743582965269678	3	2	1
fam3491	2	3	3	2.6666666666666665	0.5773502691896258	0.2165063509461097	3	2	1
fam3492	2	3	3	2.6666666666666665	0.5773502691896258	0.2165063509461097	3	2	1
fam3493	2	3	3	2.6666666666666665	0.5773502691896258	0.2165063509461097	3	2	1
fam3494	2	3	3	2.6666666666666665	0.5773502691896258	0.2165063509461097	3	2	1
fam3495	2	3	2	2.3333333333333335	0.5773502691896258	0.24743582965269678	3	2	1
fam3496	2	3	2	2.3333333333333335	0.5773502691896258	0.24743582965269678	3	2	1
fam3497	3	2	2	2.3333333333333335	0.5773502691896258	0.24743582965269678	3	2	1
fam3498	2	3	2	2.3333333333333335	0.5773502691896258	0.24743582965269678	3	2	1
fam3499	2	3	2	2.3333333333333335	0.5773502691896258	0.24743582965269678	3	2	1
fam3500	2	3	3	2.6666666666666665	0.5773502691896258	0.2165063509461097	3	2	1
fam3501	2	2	3	2.3333333333333335	0.5773502691896258	0.24743582965269678	3	2	1
fam3502	2	3	3	2.6666666666666665	0.5773502691896258	0.2165063509461097	3	2	1
fam3503	2	3	3	2.6666666666666665	0.5773502691896258	0.2165063509461097	3	2	1
fam3504	2	3	2	2.3333333333333335	0.5773502691896258	0.24743582965269678	3	2	1
fam3505	2	3	3	2.6666666666666665	0.5773502691896258	0.2165063509461097	3	2	1
fam3506	2	2	3	2.3333333333333335	0.5773502691896258	0.24743582965269678	3	2	1
fam3507	3	3	2	2.6666666666666665	0.5773502691896258	0.2165063509461097	3	2	1
fam3508	2	3	2	2.3333333333333335	0.5773502691896258	0.24743582965269678	3	2	1
fam3509	2	3	3	2.6666666666666665	0.5773502691896258	0.2165063509461097	3	2	1
fam3510	3	2	2	2.3333333333333335	0.5773502691896258	0.24743582965269678	3	2	1
fam3511	2	3	3	2.6666666666666665	0.5773502691896258	0.2165063509461097	3	2	1
fam3512	2	3	3	2.6666666666666665	0.5773502691896258	0.2165063509461097	3	2	1
fam3513	2	3	3	2.6666666666666665	0.5773502691896258	0.2165063509461097	3	2	1
fam3514	2	3	2	2.3333333333333335	0.5773502691896258	0.24743582965269678	3	2	1
fam3515	2	3	3	2.6666666666666665	0.5773502691896258	0.2165063509461097	3	2	1
fam3516	2	3	2	2.3333333333333335	0.5773502691896258	0.24743582965269678	3	2	1
fam3517	3	2	2	2.3333333333333335	0.5773502691896258	0.24743582965269678	3	2	1
fam3518	2	3	3	2.6666666666666665	0.5773502691896258	0.2165063509461097	3	2	1
fam3519	3	3	2	2.6666666666666665	0.5773502691896258	0.2165063509461097	3	2	1
fam3520	2	3	3	2.6666666666666665	0.5773502691896258	0.2165063509461097	3	2	1
fam3521	3	2	2	2.3333333333333335	0.5773502691896258	0.24743582965269678	3	2	1
fam3522	2	3	3	2.6666666666666665	0.5773502691896258	0.2165063509461097	3	2	1
fam3523	2	3	2	2.3333333333333335	0.5773502691896258	0.24743582965269678	3	2	1
fam3524	2	3	3	2.6666666666666665	0.5773502691896258	0.2165063509461097	3	2	1
fam3525	2	3	3	2.6666666666666665	0.5773502691896258	0.2165063509461097	3	2	1
fam3526	3	3	2	2.6666666666666665	0.5773502691896258	0.2165063509461097	3	2	1
fam3527	2	3	3	2.6666666666666665	0.5773502691896258	0.2165063509461097	3	2	1
fam3528	2	3	2	2.3333333333333335	0.5773502691896258	0.24743582965269678	3	2	1
fam3529	2	3	3	2.6666666666666665	0.5773502691896258	0.2165063509461097	3	2	1
fam3530	3	3	2	2.6666666666666665	0.5773502691896258	0.2165063509461097	3	2	1
fam3531	2	3	3	2.6666666666666665	0.5773502691896258	0.2165063509461097	3	2	1
fam3532	2	3	2	2.3333333333333335	0.5773502691896258	0.24743582965269678	3	2	1
fam3533	3	2	2	2.3333333333333335	0.5773502691896258	0.24743582965269678	3	2	1
fam3534	2	4	2	2.6666666666666665	1.1547005383792515	0.4330127018922193	4	2	2
fam3535	2	4	2	2.6666666666666665	1.1547005383792515	0.4330127018922193	4	2	2
fam3536	2	4	2	2.6666666666666665	1.1547005383792515	0.4330127018922193	4	2	2
fam3537	2	4	2	2.6666666666666665	1.1547005383792515	0.4330127018922193	4	2	2
fam3538	2	4	2	2.6666666666666665	1.1547005383792515	0.4330127018922193	4	2	2
fam3539	2	4	2	2.6666666666666665	1.1547005383792515	0.4330127018922193	4	2	2
fam3540	2	4	2	2.6666666666666665	1.1547005383792515	0.4330127018922193	4	2	2
fam3541	2	2	4	2.6666666666666665	1.1547005383792515	0.4330127018922193	4	2	2
fam3542	2	4	2	2.6666666666666665	1.1547005383792515	0.4330127018922193	4	2	2
fam3543	2	2	4	2.6666666666666665	1.1547005383792515	0.4330127018922193	4	2	2
fam3544	2	4	2	2.6666666666666665	1.1547005383792515	0.4330127018922193	4	2	2
fam3545	2	2	4	2.6666666666666665	1.1547005383792515	0.4330127018922193	4	2	2
fam3546	2	4	2	2.6666666666666665	1.1547005383792515	0.4330127018922193	4	2	2
fam3547	2	2	4	2.6666666666666665	1.1547005383792515	0.4330127018922193	4	2	2
fam3548	2	4	2	2.6666666666666665	1.1547005383792515	0.4330127018922193	4	2	2
fam3549	2	2	4	2.6666666666666665	1.1547005383792515	0.4330127018922193	4	2	2
fam3550	2	4	2	2.6666666666666665	1.1547005383792515	0.4330127018922193	4	2	2
fam3551	2	4	2	2.6666666666666665	1.1547005383792515	0.4330127018922193	4	2	2
fam3552	2	4	2	2.6666666666666665	1.1547005383792515	0.4330127018922193	4	2	2
fam3553	2	2	4	2.6666666666666665	1.1547005383792515	0.4330127018922193	4	2	2
fam3554	2	4	2	2.6666666666666665	1.1547005383792515	0.4330127018922193	4	2	2
fam3555	2	2	4	2.6666666666666665	1.1547005383792515	0.4330127018922193	4	2	2
fam3556	2	4	2	2.6666666666666665	1.1547005383792515	0.4330127018922193	4	2	2
fam3557	2	4	2	2.6666666666666665	1.1547005383792515	0.4330127018922193	4	2	2
fam3558	4	2	2	2.6666666666666665	1.1547005383792515	0.4330127018922193	4	2	2
fam3559	2	4	2	2.6666666666666665	1.1547005383792515	0.4330127018922193	4	2	2
fam3560	2	4	2	2.6666666666666665	1.1547005383792515	0.4330127018922193	4	2	2
fam3561	2	4	2	2.6666666666666665	1.1547005383792515	0.4330127018922193	4	2	2
fam3562	2	4	2	2.6666666666666665	1.1547005383792515	0.4330127018922193	4	2	2
fam3563	2	4	2	2.6666666666666665	1.1547005383792515	0.4330127018922193	4	2	2
fam3564	2	4	2	2.6666666666666665	1.1547005383792515	0.4330127018922193	4	2	2
fam3565	2	2	4	2.6666666666666665	1.1547005383792515	0.4330127018922193	4	2	2
fam3566	2	2	4	2.6666666666666665	1.1547005383792515	0.4330127018922193	4	2	2
fam3567	2	2	4	2.6666666666666665	1.1547005383792515	0.4330127018922193	4	2	2
fam3568	2	2	4	2.6666666666666665	1.1547005383792515	0.4330127018922193	4	2	2
fam3569	2	2	4	2.6666666666666665	1.1547005383792515	0.4330127018922193	4	2	2
fam3570	2	4	2	2.6666666666666665	1.1547005383792515	0.4330127018922193	4	2	2
fam3571	2	4	2	2.6666666666666665	1.1547005383792515	0.4330127018922193	4	2	2
fam3572	2	4	2	2.6666666666666665	1.1547005383792515	0.4330127018922193	4	2	2
fam3573	2	2	4	2.6666666666666665	1.1547005383792515	0.4330127018922193	4	2	2
fam3574	2	4	2	2.6666666666666665	1.1547005383792515	0.4330127018922193	4	2	2
fam3575	2	2	4	2.6666666666666665	1.1547005383792515	0.4330127018922193	4	2	2
fam3576	2	2	4	2.6666666666666665	1.1547005383792515	0.4330127018922193	4	2	2
fam3577	2	4	2	2.6666666666666665	1.1547005383792515	0.4330127018922193	4	2	2
fam3578	2	4	2	2.6666666666666665	1.1547005383792515	0.4330127018922193	4	2	2
fam3579	2	2	4	2.6666666666666665	1.1547005383792515	0.4330127018922193	4	2	2
fam3580	2	4	2	2.6666666666666665	1.1547005383792515	0.4330127018922193	4	2	2
fam3581	2	4	2	2.6666666666666665	1.1547005383792515	0.4330127018922193	4	2	2
fam3582	2	4	2	2.6666666666666665	1.1547005383792515	0.4330127018922193	4	2	2
fam3583	2	3	3	2.6666666666666665	0.5773502691896258	0.2165063509461097	3	2	1
fam3584	2	4	2	2.6666666666666665	1.1547005383792515	0.4330127018922193	4	2	2
fam3585	2	4	2	2.6666666666666665	1.1547005383792515	0.4330127018922193	4	2	2
fam3586	2	4	2	2.6666666666666665	1.1547005383792515	0.4330127018922193	4	2	2
fam3587	2	2	4	2.6666666666666665	1.1547005383792515	0.4330127018922193	4	2	2
fam3588	2	2	4	2.6666666666666665	1.1547005383792515	0.4330127018922193	4	2	2
fam3589	2	4	2	2.6666666666666665	1.1547005383792515	0.4330127018922193	4	2	2
fam3590	2	2	4	2.6666666666666665	1.1547005383792515	0.4330127018922193	4	2	2
fam3591	2	4	2	2.6666666666666665	1.1547005383792515	0.4330127018922193	4	2	2
fam3592	2	4	2	2.6666666666666665	1.1547005383792515	0.4330127018922193	4	2	2
fam3593	2	3	3	2.6666666666666665	0.5773502691896258	0.2165063509461097	3	2	1
fam3594	2	3	3	2.6666666666666665	0.5773502691896258	0.2165063509461097	3	2	1
fam3595	2	4	2	2.6666666666666665	1.1547005383792515	0.4330127018922193	4	2	2
fam3596	2	4	2	2.6666666666666665	1.1547005383792515	0.4330127018922193	4	2	2
fam3597	2	4	2	2.6666666666666665	1.1547005383792515	0.4330127018922193	4	2	2
fam3598	2	2	4	2.6666666666666665	1.1547005383792515	0.4330127018922193	4	2	2
fam3599	2	4	2	2.6666666666666665	1.1547005383792515	0.4330127018922193	4	2	2
fam3600	2	4	2	2.6666666666666665	1.1547005383792515	0.4330127018922193	4	2	2
fam3601	2	4	2	2.6666666666666665	1.1547005383792515	0.4330127018922193	4	2	2
fam3602	2	4	2	2.6666666666666665	1.1547005383792515	0.4330127018922193	4	2	2
fam3603	2	4	2	2.6666666666666665	1.1547005383792515	0.4330127018922193	4	2	2
fam3604	2	4	2	2.6666666666666665	1.1547005383792515	0.4330127018922193	4	2	2
fam3605	2	4	2	2.6666666666666665	1.1547005383792515	0.4330127018922193	4	2	2
fam3606	2	2	4	2.6666666666666665	1.1547005383792515	0.4330127018922193	4	2	2
fam3607	2	2	4	2.6666666666666665	1.1547005383792515	0.4330127018922193	4	2	2
fam3608	2	4	2	2.6666666666666665	1.1547005383792515	0.4330127018922193	4	2	2
fam3609	2	4	2	2.6666666666666665	1.1547005383792515	0.4330127018922193	4	2	2
fam3610	2	2	4	2.6666666666666665	1.1547005383792515	0.4330127018922193	4	2	2
fam3611	2	4	2	2.6666666666666665	1.1547005383792515	0.4330127018922193	4	2	2
fam3612	2	4	2	2.6666666666666665	1.1547005383792515	0.4330127018922193	4	2	2
fam3613	2	4	2	2.6666666666666665	1.1547005383792515	0.4330127018922193	4	2	2
fam3614	2	4	2	2.6666666666666665	1.1547005383792515	0.4330127018922193	4	2	2
fam3615	2	4	2	2.6666666666666665	1.1547005383792515	0.4330127018922193	4	2	2
fam3616	2	4	2	2.6666666666666665	1.1547005383792515	0.4330127018922193	4	2	2
fam3617	2	4	2	2.6666666666666665	1.1547005383792515	0.4330127018922193	4	2	2
fam3618	2	4	2	2.6666666666666665	1.1547005383792515	0.4330127018922193	4	2	2
fam3619	2	4	2	2.6666666666666665	1.1547005383792515	0.4330127018922193	4	2	2
fam3620	2	4	2	2.6666666666666665	1.1547005383792515	0.4330127018922193	4	2	2
fam3621	2	4	2	2.6666666666666665	1.1547005383792515	0.4330127018922193	4	2	2
fam3622	2	4	2	2.6666666666666665	1.1547005383792515	0.4330127018922193	4	2	2
fam3623	2	4	2	2.6666666666666665	1.1547005383792515	0.4330127018922193	4	2	2
fam3624	2	4	2	2.6666666666666665	1.1547005383792515	0.4330127018922193	4	2	2
fam3625	2	4	2	2.6666666666666665	1.1547005383792515	0.4330127018922193	4	2	2
fam3626	2	4	2	2.6666666666666665	1.1547005383792515	0.4330127018922193	4	2	2
fam3627	2	2	4	2.6666666666666665	1.1547005383792515	0.4330127018922193	4	2	2
fam3628	2	2	4	2.6666666666666665	1.1547005383792515	0.4330127018922193	4	2	2
fam3629	2	4	2	2.6666666666666665	1.1547005383792515	0.4330127018922193	4	2	2
fam3630	2	4	2	2.6666666666666665	1.1547005383792515	0.4330127018922193	4	2	2
fam3631	2	4	2	2.6666666666666665	1.1547005383792515	0.4330127018922193	4	2	2
fam3632	2	4	2	2.6666666666666665	1.1547005383792515	0.4330127018922193	4	2	2
fam3633	2	2	4	2.6666666666666665	1.1547005383792515	0.4330127018922193	4	2	2
fam3634	2	4	2	2.6666666666666665	1.1547005383792515	0.4330127018922193	4	2	2
fam3635	2	4	2	2.6666666666666665	1.1547005383792515	0.4330127018922193	4	2	2
fam3636	2	4	2	2.6666666666666665	1.1547005383792515	0.4330127018922193	4	2	2
fam3637	2	3	2	2.3333333333333335	0.5773502691896258	0.24743582965269678	3	2	1
fam3638	2	4	2	2.6666666666666665	1.1547005383792515	0.4330127018922193	4	2	2
fam3639	2	4	2	2.6666666666666665	1.1547005383792515	0.4330127018922193	4	2	2
fam3640	2	2	4	2.6666666666666665	1.1547005383792515	0.4330127018922193	4	2	2
fam3641	2	2	4	2.6666666666666665	1.1547005383792515	0.4330127018922193	4	2	2
fam3642	2	3	3	2.6666666666666665	0.5773502691896258	0.2165063509461097	3	2	1
fam3643	2	4	2	2.6666666666666665	1.1547005383792515	0.4330127018922193	4	2	2
fam3644	4	2	2	2.6666666666666665	1.1547005383792515	0.4330127018922193	4	2	2
fam3645	2	2	4	2.6666666666666665	1.1547005383792515	0.4330127018922193	4	2	2
fam3646	2	4	2	2.6666666666666665	1.1547005383792515	0.4330127018922193	4	2	2
fam3647	2	4	2	2.6666666666666665	1.1547005383792515	0.4330127018922193	4	2	2
fam3648	2	2	4	2.6666666666666665	1.1547005383792515	0.4330127018922193	4	2	2
fam3649	2	2	4	2.6666666666666665	1.1547005383792515	0.4330127018922193	4	2	2
fam3650	2	4	2	2.6666666666666665	1.1547005383792515	0.4330127018922193	4	2	2
fam3651	2	2	4	2.6666666666666665	1.1547005383792515	0.4330127018922193	4	2	2
fam3652	3	3	2	2.6666666666666665	0.5773502691896258	0.2165063509461097	3	2	1
fam3653	2	4	2	2.6666666666666665	1.1547005383792515	0.4330127018922193	4	2	2
fam3654	2	2	4	2.6666666666666665	1.1547005383792515	0.4330127018922193	4	2	2
fam3655	2	3	3	2.6666666666666665	0.5773502691896258	0.2165063509461097	3	2	1
fam3656	2	4	2	2.6666666666666665	1.1547005383792515	0.4330127018922193	4	2	2
fam3657	4	2	2	2.6666666666666665	1.1547005383792515	0.4330127018922193	4	2	2
fam3658	2	2	4	2.6666666666666665	1.1547005383792515	0.4330127018922193	4	2	2
fam3659	2	2	4	2.6666666666666665	1.1547005383792515	0.4330127018922193	4	2	2
fam3660	2	2	4	2.6666666666666665	1.1547005383792515	0.4330127018922193	4	2	2
fam3661	2	4	2	2.6666666666666665	1.1547005383792515	0.4330127018922193	4	2	2
fam3662	2	4	2	2.6666666666666665	1.1547005383792515	0.4330127018922193	4	2	2
fam3663	2	4	2	2.6666666666666665	1.1547005383792515	0.4330127018922193	4	2	2
fam3664	2	4	2	2.6666666666666665	1.1547005383792515	0.4330127018922193	4	2	2
fam3665	2	4	2	2.6666666666666665	1.1547005383792515	0.4330127018922193	4	2	2
fam3666	2	4	2	2.6666666666666665	1.1547005383792515	0.4330127018922193	4	2	2
fam3667	2	4	2	2.6666666666666665	1.1547005383792515	0.4330127018922193	4	2	2
fam3668	2	4	2	2.6666666666666665	1.1547005383792515	0.4330127018922193	4	2	2
fam3669	2	4	2	2.6666666666666665	1.1547005383792515	0.4330127018922193	4	2	2
fam3670	2	4	2	2.6666666666666665	1.1547005383792515	0.4330127018922193	4	2	2
fam3671	2	4	2	2.6666666666666665	1.1547005383792515	0.4330127018922193	4	2	2
fam3672	2	4	2	2.6666666666666665	1.1547005383792515	0.4330127018922193	4	2	2
fam3673	2	4	2	2.6666666666666665	1.1547005383792515	0.4330127018922193	4	2	2
fam3674	2	4	2	2.6666666666666665	1.1547005383792515	0.4330127018922193	4	2	2
fam3675	4	2	2	2.6666666666666665	1.1547005383792515	0.4330127018922193	4	2	2
fam3676	2	2	4	2.6666666666666665	1.1547005383792515	0.4330127018922193	4	2	2
fam3677	2	2	4	2.6666666666666665	1.1547005383792515	0.4330127018922193	4	2	2
fam3678	2	4	2	2.6666666666666665	1.1547005383792515	0.4330127018922193	4	2	2
fam3679	2	2	4	2.6666666666666665	1.1547005383792515	0.4330127018922193	4	2	2
fam3680	2	2	4	2.6666666666666665	1.1547005383792515	0.4330127018922193	4	2	2
fam3681	2	4	2	2.6666666666666665	1.1547005383792515	0.4330127018922193	4	2	2
fam3682	2	4	2	2.6666666666666665	1.1547005383792515	0.4330127018922193	4	2	2
fam3683	2	2	4	2.6666666666666665	1.1547005383792515	0.4330127018922193	4	2	2
fam3684	2	2	4	2.6666666666666665	1.1547005383792515	0.4330127018922193	4	2	2
fam3685	2	4	2	2.6666666666666665	1.1547005383792515	0.4330127018922193	4	2	2
fam3686	2	2	4	2.6666666666666665	1.1547005383792515	0.4330127018922193	4	2	2
fam3687	2	2	4	2.6666666666666665	1.1547005383792515	0.4330127018922193	4	2	2
fam3688	2	4	2	2.6666666666666665	1.1547005383792515	0.4330127018922193	4	2	2
fam3689	2	4	2	2.6666666666666665	1.1547005383792515	0.4330127018922193	4	2	2
fam3690	2	2	4	2.6666666666666665	1.1547005383792515	0.4330127018922193	4	2	2
fam3691	2	4	2	2.6666666666666665	1.1547005383792515	0.4330127018922193	4	2	2
fam3692	3	2	2	2.3333333333333335	0.5773502691896258	0.24743582965269678	3	2	1
fam3693	2	2	4	2.6666666666666665	1.1547005383792515	0.4330127018922193	4	2	2
fam3694	2	2	4	2.6666666666666665	1.1547005383792515	0.4330127018922193	4	2	2
fam3695	2	2	4	2.6666666666666665	1.1547005383792515	0.4330127018922193	4	2	2
fam3696	2	2	4	2.6666666666666665	1.1547005383792515	0.4330127018922193	4	2	2
fam3697	2	4	2	2.6666666666666665	1.1547005383792515	0.4330127018922193	4	2	2
fam3698	2	2	4	2.6666666666666665	1.1547005383792515	0.4330127018922193	4	2	2
fam3699	2	2	4	2.6666666666666665	1.1547005383792515	0.4330127018922193	4	2	2
fam3700	2	4	2	2.6666666666666665	1.1547005383792515	0.4330127018922193	4	2	2
fam3701	2	4	2	2.6666666666666665	1.1547005383792515	0.4330127018922193	4	2	2
fam3702	4	2	2	2.6666666666666665	1.1547005383792515	0.4330127018922193	4	2	2
fam3703	2	4	2	2.6666666666666665	1.1547005383792515	0.4330127018922193	4	2	2
fam3704	2	2	4	2.6666666666666665	1.1547005383792515	0.4330127018922193	4	2	2
fam3705	2	4	2	2.6666666666666665	1.1547005383792515	0.4330127018922193	4	2	2
fam3706	2	4	2	2.6666666666666665	1.1547005383792515	0.4330127018922193	4	2	2
fam3707	2	2	4	2.6666666666666665	1.1547005383792515	0.4330127018922193	4	2	2
fam3708	2	2	4	2.6666666666666665	1.1547005383792515	0.4330127018922193	4	2	2
fam3709	2	4	2	2.6666666666666665	1.1547005383792515	0.4330127018922193	4	2	2
fam3710	2	4	2	2.6666666666666665	1.1547005383792515	0.4330127018922193	4	2	2
fam3711	2	2	4	2.6666666666666665	1.1547005383792515	0.4330127018922193	4	2	2
fam3712	2	2	4	2.6666666666666665	1.1547005383792515	0.4330127018922193	4	2	2
fam3713	2	4	2	2.6666666666666665	1.1547005383792515	0.4330127018922193	4	2	2
fam3714	2	4	2	2.6666666666666665	1.1547005383792515	0.4330127018922193	4	2	2
fam3715	2	4	2	2.6666666666666665	1.1547005383792515	0.4330127018922193	4	2	2
fam3716	2	2	4	2.6666666666666665	1.1547005383792515	0.4330127018922193	4	2	2
fam3717	2	4	2	2.6666666666666665	1.1547005383792515	0.4330127018922193	4	2	2
fam3718	2	4	2	2.6666666666666665	1.1547005383792515	0.4330127018922193	4	2	2
fam3719	2	4	2	2.6666666666666665	1.1547005383792515	0.4330127018922193	4	2	2
fam3720	2	4	2	2.6666666666666665	1.1547005383792515	0.4330127018922193	4	2	2
fam3721	2	2	4	2.6666666666666665	1.1547005383792515	0.4330127018922193	4	2	2
fam3722	2	2	4	2.6666666666666665	1.1547005383792515	0.4330127018922193	4	2	2
fam3723	2	4	2	2.6666666666666665	1.1547005383792515	0.4330127018922193	4	2	2
fam3724	2	4	2	2.6666666666666665	1.1547005383792515	0.4330127018922193	4	2	2
fam3725	2	4	2	2.6666666666666665	1.1547005383792515	0.4330127018922193	4	2	2
fam3726	2	2	4	2.6666666666666665	1.1547005383792515	0.4330127018922193	4	2	2
fam3727	2	4	2	2.6666666666666665	1.1547005383792515	0.4330127018922193	4	2	2
fam3728	4	2	2	2.6666666666666665	1.1547005383792515	0.4330127018922193	4	2	2
fam3729	2	4	2	2.6666666666666665	1.1547005383792515	0.4330127018922193	4	2	2
fam3730	2	4	2	2.6666666666666665	1.1547005383792515	0.4330127018922193	4	2	2
fam3731	2	2	4	2.6666666666666665	1.1547005383792515	0.4330127018922193	4	2	2
fam3732	2	2	4	2.6666666666666665	1.1547005383792515	0.4330127018922193	4	2	2
fam3733	2	4	2	2.6666666666666665	1.1547005383792515	0.4330127018922193	4	2	2
fam3734	2	4	2	2.6666666666666665	1.1547005383792515	0.4330127018922193	4	2	2
fam3735	2	2	4	2.6666666666666665	1.1547005383792515	0.4330127018922193	4	2	2
fam3736	2	2	4	2.6666666666666665	1.1547005383792515	0.4330127018922193	4	2	2
fam3737	2	4	2	2.6666666666666665	1.1547005383792515	0.4330127018922193	4	2	2
fam3738	2	4	2	2.6666666666666665	1.1547005383792515	0.4330127018922193	4	2	2
fam3739	2	4	2	2.6666666666666665	1.1547005383792515	0.4330127018922193	4	2	2
fam3740	2	2	4	2.6666666666666665	1.1547005383792515	0.4330127018922193	4	2	2
fam3741	2	4	2	2.6666666666666665	1.1547005383792515	0.4330127018922193	4	2	2
fam3742	2	2	4	2.6666666666666665	1.1547005383792515	0.4330127018922193	4	2	2
fam3743	2	4	2	2.6666666666666665	1.1547005383792515	0.4330127018922193	4	2	2
fam3744	2	4	2	2.6666666666666665	1.1547005383792515	0.4330127018922193	4	2	2
fam3745	2	4	2	2.6666666666666665	1.1547005383792515	0.4330127018922193	4	2	2
fam3746	2	4	2	2.6666666666666665	1.1547005383792515	0.4330127018922193	4	2	2
fam3747	2	2	4	2.6666666666666665	1.1547005383792515	0.4330127018922193	4	2	2
fam3748	2	4	2	2.6666666666666665	1.1547005383792515	0.4330127018922193	4	2	2
fam3749	2	4	2	2.6666666666666665	1.1547005383792515	0.4330127018922193	4	2	2
fam3750	2	2	4	2.6666666666666665	1.1547005383792515	0.4330127018922193	4	2	2
fam3751	2	4	2	2.6666666666666665	1.1547005383792515	0.4330127018922193	4	2	2
fam3752	2	2	4	2.6666666666666665	1.1547005383792515	0.4330127018922193	4	2	2
fam3753	2	4	2	2.6666666666666665	1.1547005383792515	0.4330127018922193	4	2	2
fam3754	2	2	4	2.6666666666666665	1.1547005383792515	0.4330127018922193	4	2	2
fam3755	2	4	2	2.6666666666666665	1.1547005383792515	0.4330127018922193	4	2	2
fam3756	2	2	4	2.6666666666666665	1.1547005383792515	0.4330127018922193	4	2	2
fam3757	2	2	4	2.6666666666666665	1.1547005383792515	0.4330127018922193	4	2	2
fam3758	2	4	2	2.6666666666666665	1.1547005383792515	0.4330127018922193	4	2	2
fam3759	2	4	2	2.6666666666666665	1.1547005383792515	0.4330127018922193	4	2	2
fam3760	2	4	2	2.6666666666666665	1.1547005383792515	0.4330127018922193	4	2	2
fam3761	2	4	2	2.6666666666666665	1.1547005383792515	0.4330127018922193	4	2	2
fam3762	2	4	2	2.6666666666666665	1.1547005383792515	0.4330127018922193	4	2	2
fam3763	2	2	4	2.6666666666666665	1.1547005383792515	0.4330127018922193	4	2	2
fam3764	2	2	4	2.6666666666666665	1.1547005383792515	0.4330127018922193	4	2	2
fam3765	2	2	4	2.6666666666666665	1.1547005383792515	0.4330127018922193	4	2	2
fam3766	2	4	2	2.6666666666666665	1.1547005383792515	0.4330127018922193	4	2	2
fam3767	2	4	2	2.6666666666666665	1.1547005383792515	0.4330127018922193	4	2	2
fam3768	2	4	2	2.6666666666666665	1.1547005383792515	0.4330127018922193	4	2	2
fam3769	2	4	2	2.6666666666666665	1.1547005383792515	0.4330127018922193	4	2	2
fam3770	2	4	2	2.6666666666666665	1.1547005383792515	0.4330127018922193	4	2	2
fam3771	2	4	2	2.6666666666666665	1.1547005383792515	0.4330127018922193	4	2	2
fam3772	2	4	2	2.6666666666666665	1.1547005383792515	0.4330127018922193	4	2	2
fam3773	2	4	2	2.6666666666666665	1.1547005383792515	0.4330127018922193	4	2	2
fam3774	2	4	2	2.6666666666666665	1.1547005383792515	0.4330127018922193	4	2	2
fam3775	2	4	2	2.6666666666666665	1.1547005383792515	0.4330127018922193	4	2	2
fam3776	2	4	2	2.6666666666666665	1.1547005383792515	0.4330127018922193	4	2	2
fam3777	2	2	3	2.3333333333333335	0.5773502691896258	0.24743582965269678	3	2	1
fam3778	2	3	2	2.3333333333333335	0.5773502691896258	0.24743582965269678	3	2	1
fam3779	2	3	2	2.3333333333333335	0.5773502691896258	0.24743582965269678	3	2	1
fam3780	2	3	2	2.3333333333333335	0.5773502691896258	0.24743582965269678	3	2	1
fam3781	2	3	2	2.3333333333333335	0.5773502691896258	0.24743582965269678	3	2	1
fam3782	2	2	3	2.3333333333333335	0.5773502691896258	0.24743582965269678	3	2	1
fam3783	2	3	3	2.6666666666666665	0.5773502691896258	0.2165063509461097	3	2	1
fam3784	2	3	3	2.6666666666666665	0.5773502691896258	0.2165063509461097	3	2	1
fam3785	2	3	3	2.6666666666666665	0.5773502691896258	0.2165063509461097	3	2	1
fam3786	2	3	3	2.6666666666666665	0.5773502691896258	0.2165063509461097	3	2	1
fam3787	2	3	3	2.6666666666666665	0.5773502691896258	0.2165063509461097	3	2	1
fam3788	2	3	2	2.3333333333333335	0.5773502691896258	0.24743582965269678	3	2	1
fam3789	2	3	2	2.3333333333333335	0.5773502691896258	0.24743582965269678	3	2	1
fam3790	2	3	2	2.3333333333333335	0.5773502691896258	0.24743582965269678	3	2	1
fam3791	2	4	2	2.6666666666666665	1.1547005383792515	0.4330127018922193	4	2	2
fam3792	2	5	2	3.0	1.7320508075688772	0.5773502691896257	5	2	3
fam3793	2	5	2	3.0	1.7320508075688772	0.5773502691896257	5	2	3
fam3794	2	4	2	2.6666666666666665	1.1547005383792515	0.4330127018922193	4	2	2
fam3795	2	2	5	3.0	1.7320508075688772	0.5773502691896257	5	2	3
fam3796	2	5	2	3.0	1.7320508075688772	0.5773502691896257	5	2	3
fam3797	5	2	2	3.0	1.7320508075688772	0.5773502691896257	5	2	3
fam3798	2	5	2	3.0	1.7320508075688772	0.5773502691896257	5	2	3
fam3799	2	2	5	3.0	1.7320508075688772	0.5773502691896257	5	2	3
fam3800	2	2	4	2.6666666666666665	1.1547005383792515	0.4330127018922193	4	2	2
fam3801	2	5	2	3.0	1.7320508075688772	0.5773502691896257	5	2	3
fam3802	2	5	2	3.0	1.7320508075688772	0.5773502691896257	5	2	3
fam3803	2	2	5	3.0	1.7320508075688772	0.5773502691896257	5	2	3
fam3804	2	5	2	3.0	1.7320508075688772	0.5773502691896257	5	2	3
fam3805	2	5	2	3.0	1.7320508075688772	0.5773502691896257	5	2	3
fam3806	2	5	2	3.0	1.7320508075688772	0.5773502691896257	5	2	3
fam3807	2	5	2	3.0	1.7320508075688772	0.5773502691896257	5	2	3
fam3808	2	2	5	3.0	1.7320508075688772	0.5773502691896257	5	2	3
fam3809	2	5	2	3.0	1.7320508075688772	0.5773502691896257	5	2	3
fam3810	5	2	2	3.0	1.7320508075688772	0.5773502691896257	5	2	3
fam3811	2	4	2	2.6666666666666665	1.1547005383792515	0.4330127018922193	4	2	2
fam3812	2	2	4	2.6666666666666665	1.1547005383792515	0.4330127018922193	4	2	2
fam3813	5	2	2	3.0	1.7320508075688772	0.5773502691896257	5	2	3
fam3814	5	2	2	3.0	1.7320508075688772	0.5773502691896257	5	2	3
fam3815	2	5	2	3.0	1.7320508075688772	0.5773502691896257	5	2	3
fam3816	2	5	2	3.0	1.7320508075688772	0.5773502691896257	5	2	3
fam3817	2	5	2	3.0	1.7320508075688772	0.5773502691896257	5	2	3
fam3818	2	5	2	3.0	1.7320508075688772	0.5773502691896257	5	2	3
fam3819	2	2	5	3.0	1.7320508075688772	0.5773502691896257	5	2	3
fam3820	2	5	2	3.0	1.7320508075688772	0.5773502691896257	5	2	3
fam3821	2	4	2	2.6666666666666665	1.1547005383792515	0.4330127018922193	4	2	2
fam3822	2	2	3	2.3333333333333335	0.5773502691896258	0.24743582965269678	3	2	1
fam3823	2	5	2	3.0	1.7320508075688772	0.5773502691896257	5	2	3
fam3824	2	5	2	3.0	1.7320508075688772	0.5773502691896257	5	2	3
fam3825	2	5	2	3.0	1.7320508075688772	0.5773502691896257	5	2	3
fam3826	2	5	2	3.0	1.7320508075688772	0.5773502691896257	5	2	3
fam3827	2	5	2	3.0	1.7320508075688772	0.5773502691896257	5	2	3
fam3828	2	5	2	3.0	1.7320508075688772	0.5773502691896257	5	2	3
fam3829	2	5	2	3.0	1.7320508075688772	0.5773502691896257	5	2	3
fam3830	2	3	2	2.3333333333333335	0.5773502691896258	0.24743582965269678	3	2	1
fam3831	2	5	2	3.0	1.7320508075688772	0.5773502691896257	5	2	3
fam3832	2	5	2	3.0	1.7320508075688772	0.5773502691896257	5	2	3
fam3833	5	2	2	3.0	1.7320508075688772	0.5773502691896257	5	2	3
fam3834	2	5	2	3.0	1.7320508075688772	0.5773502691896257	5	2	3
fam3835	2	5	2	3.0	1.7320508075688772	0.5773502691896257	5	2	3
fam3836	2	5	2	3.0	1.7320508075688772	0.5773502691896257	5	2	3
fam3837	2	5	2	3.0	1.7320508075688772	0.5773502691896257	5	2	3
fam3838	2	2	5	3.0	1.7320508075688772	0.5773502691896257	5	2	3
fam3839	2	5	2	3.0	1.7320508075688772	0.5773502691896257	5	2	3
fam3840	2	5	2	3.0	1.7320508075688772	0.5773502691896257	5	2	3
fam3841	2	2	5	3.0	1.7320508075688772	0.5773502691896257	5	2	3
fam3842	2	5	2	3.0	1.7320508075688772	0.5773502691896257	5	2	3
fam3843	2	5	2	3.0	1.7320508075688772	0.5773502691896257	5	2	3
fam3844	2	5	2	3.0	1.7320508075688772	0.5773502691896257	5	2	3
fam3845	2	5	2	3.0	1.7320508075688772	0.5773502691896257	5	2	3
fam3846	2	5	2	3.0	1.7320508075688772	0.5773502691896257	5	2	3
fam3847	2	5	2	3.0	1.7320508075688772	0.5773502691896257	5	2	3
fam3848	2	5	2	3.0	1.7320508075688772	0.5773502691896257	5	2	3
fam3849	2	5	2	3.0	1.7320508075688772	0.5773502691896257	5	2	3
fam3850	2	5	2	3.0	1.7320508075688772	0.5773502691896257	5	2	3
fam3851	2	5	2	3.0	1.7320508075688772	0.5773502691896257	5	2	3
fam3852	2	5	2	3.0	1.7320508075688772	0.5773502691896257	5	2	3
fam3853	2	5	2	3.0	1.7320508075688772	0.5773502691896257	5	2	3
fam3854	2	5	2	3.0	1.7320508075688772	0.5773502691896257	5	2	3
fam3855	2	5	2	3.0	1.7320508075688772	0.5773502691896257	5	2	3
fam3856	2	5	2	3.0	1.7320508075688772	0.5773502691896257	5	2	3
fam3857	2	2	3	2.3333333333333335	0.5773502691896258	0.24743582965269678	3	2	1
fam3858	2	5	2	3.0	1.7320508075688772	0.5773502691896257	5	2	3
fam3859	2	5	2	3.0	1.7320508075688772	0.5773502691896257	5	2	3
fam3860	2	2	5	3.0	1.7320508075688772	0.5773502691896257	5	2	3
fam3861	2	5	2	3.0	1.7320508075688772	0.5773502691896257	5	2	3
fam3862	2	5	2	3.0	1.7320508075688772	0.5773502691896257	5	2	3
fam3863	2	5	2	3.0	1.7320508075688772	0.5773502691896257	5	2	3
fam3864	2	2	5	3.0	1.7320508075688772	0.5773502691896257	5	2	3
fam3865	2	2	5	3.0	1.7320508075688772	0.5773502691896257	5	2	3
fam3866	2	5	2	3.0	1.7320508075688772	0.5773502691896257	5	2	3
fam3867	2	5	2	3.0	1.7320508075688772	0.5773502691896257	5	2	3
fam3868	2	2	5	3.0	1.7320508075688772	0.5773502691896257	5	2	3
fam3869	2	5	2	3.0	1.7320508075688772	0.5773502691896257	5	2	3
fam3870	2	5	2	3.0	1.7320508075688772	0.5773502691896257	5	2	3
fam3871	2	5	2	3.0	1.7320508075688772	0.5773502691896257	5	2	3
fam3872	2	3	3	2.6666666666666665	0.5773502691896258	0.2165063509461097	3	2	1
fam3873	2	5	2	3.0	1.7320508075688772	0.5773502691896257	5	2	3
fam3874	2	2	3	2.3333333333333335	0.5773502691896258	0.24743582965269678	3	2	1
fam3875	2	5	2	3.0	1.7320508075688772	0.5773502691896257	5	2	3
fam3876	2	5	2	3.0	1.7320508075688772	0.5773502691896257	5	2	3
fam3877	2	5	2	3.0	1.7320508075688772	0.5773502691896257	5	2	3
fam3878	2	5	2	3.0	1.7320508075688772	0.5773502691896257	5	2	3
fam3879	2	2	5	3.0	1.7320508075688772	0.5773502691896257	5	2	3
fam3880	2	5	2	3.0	1.7320508075688772	0.5773502691896257	5	2	3
fam3881	2	4	2	2.6666666666666665	1.1547005383792515	0.4330127018922193	4	2	2
fam3882	2	2	5	3.0	1.7320508075688772	0.5773502691896257	5	2	3
fam3883	2	5	2	3.0	1.7320508075688772	0.5773502691896257	5	2	3
fam3884	2	5	2	3.0	1.7320508075688772	0.5773502691896257	5	2	3
fam3885	2	2	5	3.0	1.7320508075688772	0.5773502691896257	5	2	3
fam3886	5	2	2	3.0	1.7320508075688772	0.5773502691896257	5	2	3
fam3887	2	5	2	3.0	1.7320508075688772	0.5773502691896257	5	2	3
fam3888	2	5	2	3.0	1.7320508075688772	0.5773502691896257	5	2	3
fam3889	2	5	2	3.0	1.7320508075688772	0.5773502691896257	5	2	3
fam3890	2	5	2	3.0	1.7320508075688772	0.5773502691896257	5	2	3
fam3891	2	5	2	3.0	1.7320508075688772	0.5773502691896257	5	2	3
fam3892	2	5	2	3.0	1.7320508075688772	0.5773502691896257	5	2	3
fam3893	2	5	2	3.0	1.7320508075688772	0.5773502691896257	5	2	3
fam3894	2	5	2	3.0	1.7320508075688772	0.5773502691896257	5	2	3
fam3895	2	5	2	3.0	1.7320508075688772	0.5773502691896257	5	2	3
fam3896	2	5	2	3.0	1.7320508075688772	0.5773502691896257	5	2	3
fam3897	2	3	3	2.6666666666666665	0.5773502691896258	0.2165063509461097	3	2	1
fam3898	2	2	4	2.6666666666666665	1.1547005383792515	0.4330127018922193	4	2	2
fam3899	2	3	3	2.6666666666666665	0.5773502691896258	0.2165063509461097	3	2	1
fam3900	2	5	2	3.0	1.7320508075688772	0.5773502691896257	5	2	3
fam3901	2	5	2	3.0	1.7320508075688772	0.5773502691896257	5	2	3
fam3902	2	5	2	3.0	1.7320508075688772	0.5773502691896257	5	2	3
fam3903	2	5	2	3.0	1.7320508075688772	0.5773502691896257	5	2	3
fam3904	2	5	2	3.0	1.7320508075688772	0.5773502691896257	5	2	3
fam3905	2	5	2	3.0	1.7320508075688772	0.5773502691896257	5	2	3
fam3906	2	5	2	3.0	1.7320508075688772	0.5773502691896257	5	2	3
fam3907	2	2	5	3.0	1.7320508075688772	0.5773502691896257	5	2	3
fam3908	2	2	5	3.0	1.7320508075688772	0.5773502691896257	5	2	3
fam3909	2	5	2	3.0	1.7320508075688772	0.5773502691896257	5	2	3
fam3910	2	2	4	2.6666666666666665	1.1547005383792515	0.4330127018922193	4	2	2
fam3911	2	5	2	3.0	1.7320508075688772	0.5773502691896257	5	2	3
fam3912	2	5	2	3.0	1.7320508075688772	0.5773502691896257	5	2	3
fam3913	2	5	2	3.0	1.7320508075688772	0.5773502691896257	5	2	3
fam3914	2	3	2	2.3333333333333335	0.5773502691896258	0.24743582965269678	3	2	1
fam3915	3	3	2	2.6666666666666665	0.5773502691896258	0.2165063509461097	3	2	1
fam3916	2	5	2	3.0	1.7320508075688772	0.5773502691896257	5	2	3
fam3917	2	2	5	3.0	1.7320508075688772	0.5773502691896257	5	2	3
fam3918	2	5	2	3.0	1.7320508075688772	0.5773502691896257	5	2	3
fam3919	2	5	2	3.0	1.7320508075688772	0.5773502691896257	5	2	3
fam3920	2	4	2	2.6666666666666665	1.1547005383792515	0.4330127018922193	4	2	2
fam3921	2	4	2	2.6666666666666665	1.1547005383792515	0.4330127018922193	4	2	2
fam3922	2	4	2	2.6666666666666665	1.1547005383792515	0.4330127018922193	4	2	2
fam3923	2	4	2	2.6666666666666665	1.1547005383792515	0.4330127018922193	4	2	2
fam3924	2	2	4	2.6666666666666665	1.1547005383792515	0.4330127018922193	4	2	2
fam3925	2	3	2	2.3333333333333335	0.5773502691896258	0.24743582965269678	3	2	1
fam3926	2	3	2	2.3333333333333335	0.5773502691896258	0.24743582965269678	3	2	1
fam3927	2	3	2	2.3333333333333335	0.5773502691896258	0.24743582965269678	3	2	1
fam3928	3	2	2	2.3333333333333335	0.5773502691896258	0.24743582965269678	3	2	1
fam3929	2	4	2	2.6666666666666665	1.1547005383792515	0.4330127018922193	4	2	2
fam3930	2	3	3	2.6666666666666665	0.5773502691896258	0.2165063509461097	3	2	1
fam3931	2	3	3	2.6666666666666665	0.5773502691896258	0.2165063509461097	3	2	1
fam3932	2	3	2	2.3333333333333335	0.5773502691896258	0.24743582965269678	3	2	1
fam3933	2	3	3	2.6666666666666665	0.5773502691896258	0.2165063509461097	3	2	1
fam3934	2	3	2	2.3333333333333335	0.5773502691896258	0.24743582965269678	3	2	1
fam3935	3	2	2	2.3333333333333335	0.5773502691896258	0.24743582965269678	3	2	1
fam3936	2	3	2	2.3333333333333335	0.5773502691896258	0.24743582965269678	3	2	1
fam3937	2	3	2	2.3333333333333335	0.5773502691896258	0.24743582965269678	3	2	1
fam3938	3	2	2	2.3333333333333335	0.5773502691896258	0.24743582965269678	3	2	1
fam3939	4	2	2	2.6666666666666665	1.1547005383792515	0.4330127018922193	4	2	2
fam3940	3	2	2	2.3333333333333335	0.5773502691896258	0.24743582965269678	3	2	1
fam3941	2	3	3	2.6666666666666665	0.5773502691896258	0.2165063509461097	3	2	1
fam3942	2	2	4	2.6666666666666665	1.1547005383792515	0.4330127018922193	4	2	2
fam3943	2	4	2	2.6666666666666665	1.1547005383792515	0.4330127018922193	4	2	2
fam3944	3	2	2	2.3333333333333335	0.5773502691896258	0.24743582965269678	3	2	1
fam3945	2	3	3	2.6666666666666665	0.5773502691896258	0.2165063509461097	3	2	1
fam3946	2	3	3	2.6666666666666665	0.5773502691896258	0.2165063509461097	3	2	1
fam3947	2	3	3	2.6666666666666665	0.5773502691896258	0.2165063509461097	3	2	1
fam3948	2	3	3	2.6666666666666665	0.5773502691896258	0.2165063509461097	3	2	1
fam3949	2	5	2	3.0	1.7320508075688772	0.5773502691896257	5	2	3
fam3950	2	4	2	2.6666666666666665	1.1547005383792515	0.4330127018922193	4	2	2
fam3951	2	2	4	2.6666666666666665	1.1547005383792515	0.4330127018922193	4	2	2
fam3952	2	3	3	2.6666666666666665	0.5773502691896258	0.2165063509461097	3	2	1
fam3953	4	2	2	2.6666666666666665	1.1547005383792515	0.4330127018922193	4	2	2
fam3954	2	3	3	2.6666666666666665	0.5773502691896258	0.2165063509461097	3	2	1
fam3955	2	4	2	2.6666666666666665	1.1547005383792515	0.4330127018922193	4	2	2
fam3956	2	2	4	2.6666666666666665	1.1547005383792515	0.4330127018922193	4	2	2
fam3957	2	5	2	3.0	1.7320508075688772	0.5773502691896257	5	2	3
fam3958	2	4	2	2.6666666666666665	1.1547005383792515	0.4330127018922193	4	2	2
fam3959	2	5	2	3.0	1.7320508075688772	0.5773502691896257	5	2	3
fam3960	2	4	2	2.6666666666666665	1.1547005383792515	0.4330127018922193	4	2	2
fam3961	2	3	3	2.6666666666666665	0.5773502691896258	0.2165063509461097	3	2	1
fam3962	2	2	4	2.6666666666666665	1.1547005383792515	0.4330127018922193	4	2	2
fam3963	2	5	2	3.0	1.7320508075688772	0.5773502691896257	5	2	3
fam3964	2	5	2	3.0	1.7320508075688772	0.5773502691896257	5	2	3
fam3965	2	3	3	2.6666666666666665	0.5773502691896258	0.2165063509461097	3	2	1
fam3966	3	3	2	2.6666666666666665	0.5773502691896258	0.2165063509461097	3	2	1
fam3967	2	5	2	3.0	1.7320508075688772	0.5773502691896257	5	2	3
fam3968	2	4	2	2.6666666666666665	1.1547005383792515	0.4330127018922193	4	2	2
fam3969	2	2	4	2.6666666666666665	1.1547005383792515	0.4330127018922193	4	2	2
fam3970	2	2	4	2.6666666666666665	1.1547005383792515	0.4330127018922193	4	2	2
fam3971	4	2	2	2.6666666666666665	1.1547005383792515	0.4330127018922193	4	2	2
fam3972	2	3	3	2.6666666666666665	0.5773502691896258	0.2165063509461097	3	2	1
fam3973	2	3	3	2.6666666666666665	0.5773502691896258	0.2165063509461097	3	2	1
fam3974	2	5	2	3.0	1.7320508075688772	0.5773502691896257	5	2	3
fam3975	2	4	2	2.6666666666666665	1.1547005383792515	0.4330127018922193	4	2	2
fam3976	2	3	3	2.6666666666666665	0.5773502691896258	0.2165063509461097	3	2	1
fam3977	2	2	5	3.0	1.7320508075688772	0.5773502691896257	5	2	3
fam3978	3	2	3	2.6666666666666665	0.5773502691896258	0.2165063509461097	3	2	1
fam3979	2	2	4	2.6666666666666665	1.1547005383792515	0.4330127018922193	4	2	2
fam3980	2	3	3	2.6666666666666665	0.5773502691896258	0.2165063509461097	3	2	1
fam3981	2	3	3	2.6666666666666665	0.5773502691896258	0.2165063509461097	3	2	1
fam3982	2	2	4	2.6666666666666665	1.1547005383792515	0.4330127018922193	4	2	2
fam3983	2	3	3	2.6666666666666665	0.5773502691896258	0.2165063509461097	3	2	1
fam3984	2	2	5	3.0	1.7320508075688772	0.5773502691896257	5	2	3
fam3985	2	5	2	3.0	1.7320508075688772	0.5773502691896257	5	2	3
fam3986	2	4	2	2.6666666666666665	1.1547005383792515	0.4330127018922193	4	2	2
fam3987	2	5	2	3.0	1.7320508075688772	0.5773502691896257	5	2	3
fam3988	2	3	3	2.6666666666666665	0.5773502691896258	0.2165063509461097	3	2	1
fam3989	2	5	2	3.0	1.7320508075688772	0.5773502691896257	5	2	3
fam3990	2	5	2	3.0	1.7320508075688772	0.5773502691896257	5	2	3
fam3991	2	5	2	3.0	1.7320508075688772	0.5773502691896257	5	2	3
fam3992	2	5	2	3.0	1.7320508075688772	0.5773502691896257	5	2	3
fam3993	2	3	3	2.6666666666666665	0.5773502691896258	0.2165063509461097	3	2	1
fam3994	2	3	3	2.6666666666666665	0.5773502691896258	0.2165063509461097	3	2	1
fam3995	2	4	2	2.6666666666666665	1.1547005383792515	0.4330127018922193	4	2	2
fam3996	2	5	2	3.0	1.7320508075688772	0.5773502691896257	5	2	3
fam3997	2	5	2	3.0	1.7320508075688772	0.5773502691896257	5	2	3
fam3998	2	4	2	2.6666666666666665	1.1547005383792515	0.4330127018922193	4	2	2
fam3999	2	4	2	2.6666666666666665	1.1547005383792515	0.4330127018922193	4	2	2
fam4000	2	4	2	2.6666666666666665	1.1547005383792515	0.4330127018922193	4	2	2
fam4001	2	5	2	3.0	1.7320508075688772	0.5773502691896257	5	2	3
fam4002	2	3	3	2.6666666666666665	0.5773502691896258	0.2165063509461097	3	2	1
fam4003	4	2	2	2.6666666666666665	1.1547005383792515	0.4330127018922193	4	2	2
fam4004	2	3	3	2.6666666666666665	0.5773502691896258	0.2165063509461097	3	2	1
fam4005	2	5	2	3.0	1.7320508075688772	0.5773502691896257	5	2	3
fam4006	2	5	2	3.0	1.7320508075688772	0.5773502691896257	5	2	3
fam4007	2	3	3	2.6666666666666665	0.5773502691896258	0.2165063509461097	3	2	1
fam4008	2	4	2	2.6666666666666665	1.1547005383792515	0.4330127018922193	4	2	2
fam4009	2	5	2	3.0	1.7320508075688772	0.5773502691896257	5	2	3
fam4010	2	5	2	3.0	1.7320508075688772	0.5773502691896257	5	2	3
fam4011	2	4	2	2.6666666666666665	1.1547005383792515	0.4330127018922193	4	2	2
fam4012	3	3	2	2.6666666666666665	0.5773502691896258	0.2165063509461097	3	2	1
fam4013	2	5	2	3.0	1.7320508075688772	0.5773502691896257	5	2	3
fam4014	3	3	2	2.6666666666666665	0.5773502691896258	0.2165063509461097	3	2	1
fam4015	2	2	4	2.6666666666666665	1.1547005383792515	0.4330127018922193	4	2	2
fam4016	2	3	3	2.6666666666666665	0.5773502691896258	0.2165063509461097	3	2	1
fam4017	2	5	2	3.0	1.7320508075688772	0.5773502691896257	5	2	3
fam4018	2	3	3	2.6666666666666665	0.5773502691896258	0.2165063509461097	3	2	1
fam4019	5	2	2	3.0	1.7320508075688772	0.5773502691896257	5	2	3
fam4020	2	4	2	2.6666666666666665	1.1547005383792515	0.4330127018922193	4	2	2
fam4021	2	4	2	2.6666666666666665	1.1547005383792515	0.4330127018922193	4	2	2
fam4022	2	5	2	3.0	1.7320508075688772	0.5773502691896257	5	2	3
fam4023	2	2	4	2.6666666666666665	1.1547005383792515	0.4330127018922193	4	2	2
fam4024	2	2	5	3.0	1.7320508075688772	0.5773502691896257	5	2	3
fam4025	2	4	2	2.6666666666666665	1.1547005383792515	0.4330127018922193	4	2	2
fam4026	2	4	2	2.6666666666666665	1.1547005383792515	0.4330127018922193	4	2	2
fam4027	2	4	2	2.6666666666666665	1.1547005383792515	0.4330127018922193	4	2	2
fam4028	2	4	2	2.6666666666666665	1.1547005383792515	0.4330127018922193	4	2	2
fam4029	2	4	2	2.6666666666666665	1.1547005383792515	0.4330127018922193	4	2	2
fam4030	2	4	2	2.6666666666666665	1.1547005383792515	0.4330127018922193	4	2	2
fam4031	2	4	2	2.6666666666666665	1.1547005383792515	0.4330127018922193	4	2	2
fam4032	2	4	2	2.6666666666666665	1.1547005383792515	0.4330127018922193	4	2	2
fam4033	2	4	2	2.6666666666666665	1.1547005383792515	0.4330127018922193	4	2	2
fam4034	2	4	2	2.6666666666666665	1.1547005383792515	0.4330127018922193	4	2	2
fam4035	2	5	2	3.0	1.7320508075688772	0.5773502691896257	5	2	3
fam4036	2	4	2	2.6666666666666665	1.1547005383792515	0.4330127018922193	4	2	2
fam4037	2	4	2	2.6666666666666665	1.1547005383792515	0.4330127018922193	4	2	2
fam4038	2	4	2	2.6666666666666665	1.1547005383792515	0.4330127018922193	4	2	2
fam4039	2	3	2	2.3333333333333335	0.5773502691896258	0.24743582965269678	3	2	1
fam4040	2	3	3	2.6666666666666665	0.5773502691896258	0.2165063509461097	3	2	1
fam4041	2	3	3	2.6666666666666665	0.5773502691896258	0.2165063509461097	3	2	1
fam4042	2	2	4	2.6666666666666665	1.1547005383792515	0.4330127018922193	4	2	2
fam4043	2	3	3	2.6666666666666665	0.5773502691896258	0.2165063509461097	3	2	1
fam4044	2	3	3	2.6666666666666665	0.5773502691896258	0.2165063509461097	3	2	1
fam4045	2	4	2	2.6666666666666665	1.1547005383792515	0.4330127018922193	4	2	2
fam4046	2	3	2	2.3333333333333335	0.5773502691896258	0.24743582965269678	3	2	1
fam4047	3	2	2	2.3333333333333335	0.5773502691896258	0.24743582965269678	3	2	1
fam4048	2	2	4	2.6666666666666665	1.1547005383792515	0.4330127018922193	4	2	2
fam4049	2	3	2	2.3333333333333335	0.5773502691896258	0.24743582965269678	3	2	1
fam4050	2	3	2	2.3333333333333335	0.5773502691896258	0.24743582965269678	3	2	1
fam4051	2	2	3	2.3333333333333335	0.5773502691896258	0.24743582965269678	3	2	1
fam4052	2	4	2	2.6666666666666665	1.1547005383792515	0.4330127018922193	4	2	2
fam4053	2	2	4	2.6666666666666665	1.1547005383792515	0.4330127018922193	4	2	2
fam4054	4	2	2	2.6666666666666665	1.1547005383792515	0.4330127018922193	4	2	2
fam4055	2	4	2	2.6666666666666665	1.1547005383792515	0.4330127018922193	4	2	2
fam4056	2	3	2	2.3333333333333335	0.5773502691896258	0.24743582965269678	3	2	1
fam4057	2	5	2	3.0	1.7320508075688772	0.5773502691896257	5	2	3
fam4058	2	5	2	3.0	1.7320508075688772	0.5773502691896257	5	2	3
fam4059	2	3	2	2.3333333333333335	0.5773502691896258	0.24743582965269678	3	2	1
fam4060	2	2	3	2.3333333333333335	0.5773502691896258	0.24743582965269678	3	2	1
fam4061	3	2	2	2.3333333333333335	0.5773502691896258	0.24743582965269678	3	2	1
fam4062	3	2	2	2.3333333333333335	0.5773502691896258	0.24743582965269678	3	2	1
fam4063	2	4	2	2.6666666666666665	1.1547005383792515	0.4330127018922193	4	2	2
fam4064	2	3	2	2.3333333333333335	0.5773502691896258	0.24743582965269678	3	2	1
fam4065	2	4	2	2.6666666666666665	1.1547005383792515	0.4330127018922193	4	2	2
fam4066	2	4	2	2.6666666666666665	1.1547005383792515	0.4330127018922193	4	2	2
fam4067	3	3	2	2.6666666666666665	0.5773502691896258	0.2165063509461097	3	2	1
fam4068	2	5	2	3.0	1.7320508075688772	0.5773502691896257	5	2	3
fam4069	2	5	2	3.0	1.7320508075688772	0.5773502691896257	5	2	3
fam4070	2	5	2	3.0	1.7320508075688772	0.5773502691896257	5	2	3
fam4071	2	2	2	2.0	0.0	0.0	2	2	0
fam4072	2	2	2	2.0	0.0	0.0	2	2	0
fam4073	2	2	2	2.0	0.0	0.0	2	2	0
fam4074	2	2	2	2.0	0.0	0.0	2	2	0
fam4075	2	2	2	2.0	0.0	0.0	2	2	0
fam4076	2	2	2	2.0	0.0	0.0	2	2	0
fam4077	2	2	2	2.0	0.0	0.0	2	2	0
fam4078	2	2	2	2.0	0.0	0.0	2	2	0
fam4079	2	2	2	2.0	0.0	0.0	2	2	0
fam4080	2	2	2	2.0	0.0	0.0	2	2	0
fam4081	2	2	2	2.0	0.0	0.0	2	2	0
fam4082	2	2	2	2.0	0.0	0.0	2	2	0
fam4083	2	2	2	2.0	0.0	0.0	2	2	0
fam4084	2	2	2	2.0	0.0	0.0	2	2	0
fam4085	2	2	2	2.0	0.0	0.0	2	2	0
fam4086	2	2	2	2.0	0.0	0.0	2	2	0
fam4087	2	2	2	2.0	0.0	0.0	2	2	0
fam4088	2	2	2	2.0	0.0	0.0	2	2	0
fam4089	2	2	2	2.0	0.0	0.0	2	2	0
fam4090	2	2	2	2.0	0.0	0.0	2	2	0
fam4091	2	2	2	2.0	0.0	0.0	2	2	0
fam4092	2	2	2	2.0	0.0	0.0	2	2	0
fam4093	2	2	2	2.0	0.0	0.0	2	2	0
fam4094	2	2	2	2.0	0.0	0.0	2	2	0
fam4095	2	2	2	2.0	0.0	0.0	2	2	0
fam4096	2	2	2	2.0	0.0	0.0	2	2	0
fam4097	2	2	2	2.0	0.0	0.0	2	2	0
fam4098	2	2	2	2.0	0.0	0.0	2	2	0
fam4099	2	2	2	2.0	0.0	0.0	2	2	0
fam4100	2	2	2	2.0	0.0	0.0	2	2	0
fam4101	2	2	2	2.0	0.0	0.0	2	2	0
fam4102	2	2	2	2.0	0.0	0.0	2	2	0
fam4103	2	2	2	2.0	0.0	0.0	2	2	0
fam4104	2	2	2	2.0	0.0	0.0	2	2	0
fam4105	2	2	2	2.0	0.0	0.0	2	2	0
fam4106	2	2	2	2.0	0.0	0.0	2	2	0
fam4107	2	2	2	2.0	0.0	0.0	2	2	0
fam4108	2	2	2	2.0	0.0	0.0	2	2	0
fam4109	2	2	2	2.0	0.0	0.0	2	2	0
fam4110	2	2	2	2.0	0.0	0.0	2	2	0
fam4111	2	2	2	2.0	0.0	0.0	2	2	0
fam4112	2	2	2	2.0	0.0	0.0	2	2	0
fam4113	2	2	2	2.0	0.0	0.0	2	2	0
fam4114	2	2	2	2.0	0.0	0.0	2	2	0
fam4115	2	2	2	2.0	0.0	0.0	2	2	0
fam4116	2	2	2	2.0	0.0	0.0	2	2	0
fam4117	2	2	2	2.0	0.0	0.0	2	2	0
fam4118	2	2	2	2.0	0.0	0.0	2	2	0
fam4119	2	2	2	2.0	0.0	0.0	2	2	0
fam4120	2	2	2	2.0	0.0	0.0	2	2	0
fam4121	2	2	2	2.0	0.0	0.0	2	2	0
fam4122	2	2	2	2.0	0.0	0.0	2	2	0
fam4123	2	2	2	2.0	0.0	0.0	2	2	0
fam4124	2	2	2	2.0	0.0	0.0	2	2	0
fam4125	2	2	2	2.0	0.0	0.0	2	2	0
fam4126	2	2	2	2.0	0.0	0.0	2	2	0
fam4127	2	2	2	2.0	0.0	0.0	2	2	0
fam4128	2	2	2	2.0	0.0	0.0	2	2	0
fam4129	2	2	2	2.0	0.0	0.0	2	2	0
fam4130	2	2	2	2.0	0.0	0.0	2	2	0
fam4131	2	2	2	2.0	0.0	0.0	2	2	0
fam4132	2	2	2	2.0	0.0	0.0	2	2	0
fam4133	2	2	2	2.0	0.0	0.0	2	2	0
fam4134	2	2	2	2.0	0.0	0.0	2	2	0
fam4135	2	2	2	2.0	0.0	0.0	2	2	0
fam4136	2	2	2	2.0	0.0	0.0	2	2	0
fam4137	2	2	2	2.0	0.0	0.0	2	2	0
fam4138	2	2	2	2.0	0.0	0.0	2	2	0
fam4139	2	2	2	2.0	0.0	0.0	2	2	0
fam4140	2	2	2	2.0	0.0	0.0	2	2	0
fam4141	2	2	2	2.0	0.0	0.0	2	2	0
fam4142	2	2	2	2.0	0.0	0.0	2	2	0
fam4143	2	2	2	2.0	0.0	0.0	2	2	0
fam4144	2	2	2	2.0	0.0	0.0	2	2	0
fam4145	2	2	2	2.0	0.0	0.0	2	2	0
fam4146	2	2	2	2.0	0.0	0.0	2	2	0
fam4147	2	2	2	2.0	0.0	0.0	2	2	0
fam4148	2	2	2	2.0	0.0	0.0	2	2	0
fam4149	2	2	2	2.0	0.0	0.0	2	2	0
fam4150	2	2	2	2.0	0.0	0.0	2	2	0
fam4151	2	2	2	2.0	0.0	0.0	2	2	0
fam4152	2	2	2	2.0	0.0	0.0	2	2	0
fam4153	2	2	2	2.0	0.0	0.0	2	2	0
fam4154	2	2	2	2.0	0.0	0.0	2	2	0
fam4155	2	2	2	2.0	0.0	0.0	2	2	0
fam4156	2	2	2	2.0	0.0	0.0	2	2	0
fam4157	2	2	2	2.0	0.0	0.0	2	2	0
fam4158	2	2	2	2.0	0.0	0.0	2	2	0
fam4159	2	2	2	2.0	0.0	0.0	2	2	0
fam4160	2	2	2	2.0	0.0	0.0	2	2	0
fam4161	2	2	2	2.0	0.0	0.0	2	2	0
fam4162	2	2	2	2.0	0.0	0.0	2	2	0
fam4163	2	2	2	2.0	0.0	0.0	2	2	0
fam4164	2	2	2	2.0	0.0	0.0	2	2	0
fam4165	2	2	2	2.0	0.0	0.0	2	2	0
fam4166	2	2	2	2.0	0.0	0.0	2	2	0
fam4167	2	2	2	2.0	0.0	0.0	2	2	0
fam4168	2	2	2	2.0	0.0	0.0	2	2	0
fam4169	2	2	2	2.0	0.0	0.0	2	2	0
fam4170	2	2	2	2.0	0.0	0.0	2	2	0
fam4171	2	2	2	2.0	0.0	0.0	2	2	0
fam4172	2	2	2	2.0	0.0	0.0	2	2	0
fam4173	2	2	2	2.0	0.0	0.0	2	2	0
fam4174	2	2	2	2.0	0.0	0.0	2	2	0
fam4175	2	2	2	2.0	0.0	0.0	2	2	0
fam4176	2	2	2	2.0	0.0	0.0	2	2	0
fam4177	2	2	2	2.0	0.0	0.0	2	2	0
fam4178	2	2	2	2.0	0.0	0.0	2	2	0
fam4179	2	2	2	2.0	0.0	0.0	2	2	0
fam4180	2	2	2	2.0	0.0	0.0	2	2	0
fam4181	2	2	2	2.0	0.0	0.0	2	2	0
fam4182	2	2	2	2.0	0.0	0.0	2	2	0
fam4183	2	2	2	2.0	0.0	0.0	2	2	0
fam4184	2	2	2	2.0	0.0	0.0	2	2	0
fam4185	2	2	2	2.0	0.0	0.0	2	2	0
fam4186	2	2	2	2.0	0.0	0.0	2	2	0
fam4187	2	2	2	2.0	0.0	0.0	2	2	0
fam4188	2	2	2	2.0	0.0	0.0	2	2	0
fam4189	2	2	2	2.0	0.0	0.0	2	2	0
fam4190	2	2	2	2.0	0.0	0.0	2	2	0
fam4191	2	2	2	2.0	0.0	0.0	2	2	0
fam4192	2	2	2	2.0	0.0	0.0	2	2	0
fam4193	2	2	2	2.0	0.0	0.0	2	2	0
fam4194	2	2	2	2.0	0.0	0.0	2	2	0
fam4195	2	2	2	2.0	0.0	0.0	2	2	0
fam4196	2	2	2	2.0	0.0	0.0	2	2	0
fam4197	2	2	2	2.0	0.0	0.0	2	2	0
fam4198	2	2	2	2.0	0.0	0.0	2	2	0
fam4199	2	2	2	2.0	0.0	0.0	2	2	0
fam4200	2	2	2	2.0	0.0	0.0	2	2	0
fam4201	2	2	2	2.0	0.0	0.0	2	2	0
fam4202	2	2	2	2.0	0.0	0.0	2	2	0
fam4203	2	2	2	2.0	0.0	0.0	2	2	0
fam4204	2	2	2	2.0	0.0	0.0	2	2	0
fam4205	2	2	2	2.0	0.0	0.0	2	2	0
fam4206	2	2	2	2.0	0.0	0.0	2	2	0
fam4207	2	2	2	2.0	0.0	0.0	2	2	0
fam4208	2	2	2	2.0	0.0	0.0	2	2	0
fam4209	2	2	2	2.0	0.0	0.0	2	2	0
fam4210	2	2	2	2.0	0.0	0.0	2	2	0
fam4211	2	2	2	2.0	0.0	0.0	2	2	0
fam4212	2	2	2	2.0	0.0	0.0	2	2	0
fam4213	2	2	2	2.0	0.0	0.0	2	2	0
fam4214	2	2	2	2.0	0.0	0.0	2	2	0
fam4215	2	2	2	2.0	0.0	0.0	2	2	0
fam4216	2	2	2	2.0	0.0	0.0	2	2	0
fam4217	2	2	2	2.0	0.0	0.0	2	2	0
fam4218	2	2	2	2.0	0.0	0.0	2	2	0
fam4219	2	2	2	2.0	0.0	0.0	2	2	0
fam4220	2	2	2	2.0	0.0	0.0	2	2	0
fam4221	2	2	2	2.0	0.0	0.0	2	2	0
fam4222	2	2	2	2.0	0.0	0.0	2	2	0
fam4223	2	2	2	2.0	0.0	0.0	2	2	0
fam4224	2	2	2	2.0	0.0	0.0	2	2	0
fam4225	2	2	2	2.0	0.0	0.0	2	2	0
fam4226	2	2	2	2.0	0.0	0.0	2	2	0
fam4227	2	2	2	2.0	0.0	0.0	2	2	0
fam4228	2	2	2	2.0	0.0	0.0	2	2	0
fam4229	2	2	2	2.0	0.0	0.0	2	2	0
fam4230	2	2	2	2.0	0.0	0.0	2	2	0
fam4231	2	2	2	2.0	0.0	0.0	2	2	0
fam4232	2	2	2	2.0	0.0	0.0	2	2	0
fam4233	2	2	2	2.0	0.0	0.0	2	2	0
fam4234	2	2	2	2.0	0.0	0.0	2	2	0
fam4235	2	2	2	2.0	0.0	0.0	2	2	0
fam4236	2	2	2	2.0	0.0	0.0	2	2	0
fam4237	2	2	2	2.0	0.0	0.0	2	2	0
fam4238	2	2	2	2.0	0.0	0.0	2	2	0
fam4239	2	2	2	2.0	0.0	0.0	2	2	0
fam4240	2	2	2	2.0	0.0	0.0	2	2	0
fam4241	2	2	2	2.0	0.0	0.0	2	2	0
fam4242	2	2	2	2.0	0.0	0.0	2	2	0
fam4243	2	2	2	2.0	0.0	0.0	2	2	0
fam4244	2	2	2	2.0	0.0	0.0	2	2	0
fam4245	2	2	2	2.0	0.0	0.0	2	2	0
fam4246	2	2	2	2.0	0.0	0.0	2	2	0
fam4247	2	2	2	2.0	0.0	0.0	2	2	0
fam4248	2	2	2	2.0	0.0	0.0	2	2	0
fam4249	2	2	2	2.0	0.0	0.0	2	2	0
fam4250	2	2	2	2.0	0.0	0.0	2	2	0
fam4251	2	2	2	2.0	0.0	0.0	2	2	0
fam4252	2	2	2	2.0	0.0	0.0	2	2	0
fam4253	2	2	2	2.0	0.0	0.0	2	2	0
fam4254	2	2	2	2.0	0.0	0.0	2	2	0
fam4255	2	2	2	2.0	0.0	0.0	2	2	0
fam4256	2	2	2	2.0	0.0	0.0	2	2	0
fam4257	2	2	2	2.0	0.0	0.0	2	2	0
fam4258	2	2	2	2.0	0.0	0.0	2	2	0
fam4259	2	2	2	2.0	0.0	0.0	2	2	0
fam4260	2	2	2	2.0	0.0	0.0	2	2	0
fam4261	2	2	2	2.0	0.0	0.0	2	2	0
fam4262	2	2	2	2.0	0.0	0.0	2	2	0
fam4263	2	2	2	2.0	0.0	0.0	2	2	0
fam4264	2	2	2	2.0	0.0	0.0	2	2	0
fam4265	2	2	2	2.0	0.0	0.0	2	2	0
fam4266	2	2	2	2.0	0.0	0.0	2	2	0
fam4267	2	2	2	2.0	0.0	0.0	2	2	0
fam4268	2	2	2	2.0	0.0	0.0	2	2	0
fam4269	2	2	2	2.0	0.0	0.0	2	2	0
fam4270	2	2	2	2.0	0.0	0.0	2	2	0
fam4271	2	2	2	2.0	0.0	0.0	2	2	0
fam4272	2	2	2	2.0	0.0	0.0	2	2	0
fam4273	2	2	2	2.0	0.0	0.0	2	2	0
fam4274	2	2	2	2.0	0.0	0.0	2	2	0
fam4275	2	2	2	2.0	0.0	0.0	2	2	0
fam4276	2	2	2	2.0	0.0	0.0	2	2	0
fam4277	2	2	2	2.0	0.0	0.0	2	2	0
fam4278	2	2	2	2.0	0.0	0.0	2	2	0
fam4279	2	2	2	2.0	0.0	0.0	2	2	0
fam4280	2	2	2	2.0	0.0	0.0	2	2	0
fam4281	2	2	2	2.0	0.0	0.0	2	2	0
fam4282	2	2	2	2.0	0.0	0.0	2	2	0
fam4283	2	2	2	2.0	0.0	0.0	2	2	0
fam4284	2	2	2	2.0	0.0	0.0	2	2	0
fam4285	2	2	2	2.0	0.0	0.0	2	2	0
fam4286	2	2	2	2.0	0.0	0.0	2	2	0
fam4287	2	2	2	2.0	0.0	0.0	2	2	0
fam4288	2	2	2	2.0	0.0	0.0	2	2	0
fam4289	2	2	2	2.0	0.0	0.0	2	2	0
fam4290	2	2	2	2.0	0.0	0.0	2	2	0
fam4291	2	2	2	2.0	0.0	0.0	2	2	0
fam4292	2	2	2	2.0	0.0	0.0	2	2	0
fam4293	2	2	2	2.0	0.0	0.0	2	2	0
fam4294	2	2	2	2.0	0.0	0.0	2	2	0
fam4295	2	2	2	2.0	0.0	0.0	2	2	0
fam4296	2	2	2	2.0	0.0	0.0	2	2	0
fam4297	2	2	2	2.0	0.0	0.0	2	2	0
fam4298	2	2	2	2.0	0.0	0.0	2	2	0
fam4299	2	2	2	2.0	0.0	0.0	2	2	0
fam4300	2	2	2	2.0	0.0	0.0	2	2	0
fam4301	2	2	2	2.0	0.0	0.0	2	2	0
fam4302	2	2	2	2.0	0.0	0.0	2	2	0
fam4303	2	2	2	2.0	0.0	0.0	2	2	0
fam4304	2	2	2	2.0	0.0	0.0	2	2	0
fam4305	2	2	2	2.0	0.0	0.0	2	2	0
fam4306	2	2	2	2.0	0.0	0.0	2	2	0
fam4307	2	2	2	2.0	0.0	0.0	2	2	0
fam4308	2	2	2	2.0	0.0	0.0	2	2	0
fam4309	2	2	2	2.0	0.0	0.0	2	2	0
fam4310	2	2	2	2.0	0.0	0.0	2	2	0
fam4311	2	2	2	2.0	0.0	0.0	2	2	0
fam4312	2	2	2	2.0	0.0	0.0	2	2	0
fam4313	2	2	2	2.0	0.0	0.0	2	2	0
fam4314	2	2	2	2.0	0.0	0.0	2	2	0
fam4315	2	2	2	2.0	0.0	0.0	2	2	0
fam4316	2	2	2	2.0	0.0	0.0	2	2	0
fam4317	2	2	2	2.0	0.0	0.0	2	2	0
fam4318	2	2	2	2.0	0.0	0.0	2	2	0
fam4319	2	2	2	2.0	0.0	0.0	2	2	0
fam4320	2	2	2	2.0	0.0	0.0	2	2	0
fam4321	2	2	2	2.0	0.0	0.0	2	2	0
fam4322	2	2	2	2.0	0.0	0.0	2	2	0
fam4323	2	2	2	2.0	0.0	0.0	2	2	0
fam4324	2	2	2	2.0	0.0	0.0	2	2	0
fam4325	2	2	2	2.0	0.0	0.0	2	2	0
fam4326	2	2	2	2.0	0.0	0.0	2	2	0
fam4327	2	2	2	2.0	0.0	0.0	2	2	0
fam4328	2	2	2	2.0	0.0	0.0	2	2	0
fam4329	2	2	2	2.0	0.0	0.0	2	2	0
fam4330	2	2	2	2.0	0.0	0.0	2	2	0
fam4331	2	2	2	2.0	0.0	0.0	2	2	0
fam4332	2	2	2	2.0	0.0	0.0	2	2	0
fam4333	2	2	2	2.0	0.0	0.0	2	2	0
fam4334	2	2	2	2.0	0.0	0.0	2	2	0
fam4335	2	2	2	2.0	0.0	0.0	2	2	0
fam4336	2	2	2	2.0	0.0	0.0	2	2	0
fam4337	2	2	2	2.0	0.0	0.0	2	2	0
fam4338	2	2	2	2.0	0.0	0.0	2	2	0
fam4339	2	2	2	2.0	0.0	0.0	2	2	0
fam4340	2	2	2	2.0	0.0	0.0	2	2	0
fam4341	2	2	2	2.0	0.0	0.0	2	2	0
fam4342	2	2	2	2.0	0.0	0.0	2	2	0
fam4343	2	2	2	2.0	0.0	0.0	2	2	0
fam4344	2	2	2	2.0	0.0	0.0	2	2	0
fam4345	2	2	2	2.0	0.0	0.0	2	2	0
fam4346	2	2	2	2.0	0.0	0.0	2	2	0
fam4347	2	2	2	2.0	0.0	0.0	2	2	0
fam4348	2	2	2	2.0	0.0	0.0	2	2	0
fam4349	2	2	2	2.0	0.0	0.0	2	2	0
fam4350	2	2	2	2.0	0.0	0.0	2	2	0
fam4351	2	2	2	2.0	0.0	0.0	2	2	0
fam4352	2	2	2	2.0	0.0	0.0	2	2	0
fam4353	2	2	2	2.0	0.0	0.0	2	2	0
fam4354	2	2	2	2.0	0.0	0.0	2	2	0
fam4355	2	2	2	2.0	0.0	0.0	2	2	0
fam4356	2	2	2	2.0	0.0	0.0	2	2	0
fam4357	2	2	2	2.0	0.0	0.0	2	2	0
fam4358	2	2	2	2.0	0.0	0.0	2	2	0
fam4359	2	2	2	2.0	0.0	0.0	2	2	0
fam4360	2	2	2	2.0	0.0	0.0	2	2	0
fam4361	2	2	2	2.0	0.0	0.0	2	2	0
fam4362	2	2	2	2.0	0.0	0.0	2	2	0
fam4363	2	2	2	2.0	0.0	0.0	2	2	0
fam4364	2	2	2	2.0	0.0	0.0	2	2	0
fam4365	2	2	2	2.0	0.0	0.0	2	2	0
fam4366	2	2	2	2.0	0.0	0.0	2	2	0
fam4367	2	2	2	2.0	0.0	0.0	2	2	0
fam4368	2	2	2	2.0	0.0	0.0	2	2	0
fam4369	2	2	2	2.0	0.0	0.0	2	2	0
fam4370	2	2	2	2.0	0.0	0.0	2	2	0
fam4371	2	2	2	2.0	0.0	0.0	2	2	0
fam4372	2	2	2	2.0	0.0	0.0	2	2	0
fam4373	2	2	2	2.0	0.0	0.0	2	2	0
fam4374	2	2	2	2.0	0.0	0.0	2	2	0
fam4375	2	2	2	2.0	0.0	0.0	2	2	0
fam4376	2	2	2	2.0	0.0	0.0	2	2	0
fam4377	2	2	2	2.0	0.0	0.0	2	2	0
fam4378	2	2	2	2.0	0.0	0.0	2	2	0
fam4379	2	2	2	2.0	0.0	0.0	2	2	0
fam4380	2	2	2	2.0	0.0	0.0	2	2	0
fam4381	2	2	2	2.0	0.0	0.0	2	2	0
fam4382	2	2	2	2.0	0.0	0.0	2	2	0
fam4383	2	2	2	2.0	0.0	0.0	2	2	0
fam4384	2	2	2	2.0	0.0	0.0	2	2	0
fam4385	2	2	2	2.0	0.0	0.0	2	2	0
fam4386	2	2	2	2.0	0.0	0.0	2	2	0
fam4387	2	2	2	2.0	0.0	0.0	2	2	0
fam4388	2	2	2	2.0	0.0	0.0	2	2	0
fam4389	2	2	2	2.0	0.0	0.0	2	2	0
fam4390	2	2	2	2.0	0.0	0.0	2	2	0
fam4391	2	2	2	2.0	0.0	0.0	2	2	0
fam4392	2	2	2	2.0	0.0	0.0	2	2	0
fam4393	2	2	2	2.0	0.0	0.0	2	2	0
fam4394	2	2	2	2.0	0.0	0.0	2	2	0
fam4395	2	2	2	2.0	0.0	0.0	2	2	0
fam4396	3	2	2	2.3333333333333335	0.5773502691896258	0.24743582965269678	3	2	1
fam4397	2	2	3	2.3333333333333335	0.5773502691896258	0.24743582965269678	3	2	1
fam4398	2	3	2	2.3333333333333335	0.5773502691896258	0.24743582965269678	3	2	1
fam4399	2	3	2	2.3333333333333335	0.5773502691896258	0.24743582965269678	3	2	1
fam4400	2	2	3	2.3333333333333335	0.5773502691896258	0.24743582965269678	3	2	1
fam4401	2	3	2	2.3333333333333335	0.5773502691896258	0.24743582965269678	3	2	1
fam4402	3	2	2	2.3333333333333335	0.5773502691896258	0.24743582965269678	3	2	1
fam4403	2	3	2	2.3333333333333335	0.5773502691896258	0.24743582965269678	3	2	1
fam4404	2	3	2	2.3333333333333335	0.5773502691896258	0.24743582965269678	3	2	1
fam4405	2	3	2	2.3333333333333335	0.5773502691896258	0.24743582965269678	3	2	1
fam4406	2	3	2	2.3333333333333335	0.5773502691896258	0.24743582965269678	3	2	1
fam4407	2	3	2	2.3333333333333335	0.5773502691896258	0.24743582965269678	3	2	1
fam4408	2	2	3	2.3333333333333335	0.5773502691896258	0.24743582965269678	3	2	1
fam4409	2	3	2	2.3333333333333335	0.5773502691896258	0.24743582965269678	3	2	1
fam4410	2	3	2	2.3333333333333335	0.5773502691896258	0.24743582965269678	3	2	1
fam4411	2	3	2	2.3333333333333335	0.5773502691896258	0.24743582965269678	3	2	1
fam4412	2	3	2	2.3333333333333335	0.5773502691896258	0.24743582965269678	3	2	1
fam4413	2	3	2	2.3333333333333335	0.5773502691896258	0.24743582965269678	3	2	1
fam4414	2	2	3	2.3333333333333335	0.5773502691896258	0.24743582965269678	3	2	1
fam4415	2	2	3	2.3333333333333335	0.5773502691896258	0.24743582965269678	3	2	1
fam4416	2	3	2	2.3333333333333335	0.5773502691896258	0.24743582965269678	3	2	1
fam4417	2	3	2	2.3333333333333335	0.5773502691896258	0.24743582965269678	3	2	1
fam4418	2	3	2	2.3333333333333335	0.5773502691896258	0.24743582965269678	3	2	1
fam4419	2	2	3	2.3333333333333335	0.5773502691896258	0.24743582965269678	3	2	1
fam4420	3	2	2	2.3333333333333335	0.5773502691896258	0.24743582965269678	3	2	1
fam4421	2	3	2	2.3333333333333335	0.5773502691896258	0.24743582965269678	3	2	1
fam4422	2	2	3	2.3333333333333335	0.5773502691896258	0.24743582965269678	3	2	1
fam4423	2	3	2	2.3333333333333335	0.5773502691896258	0.24743582965269678	3	2	1
fam4424	2	3	2	2.3333333333333335	0.5773502691896258	0.24743582965269678	3	2	1
fam4425	2	3	2	2.3333333333333335	0.5773502691896258	0.24743582965269678	3	2	1
fam4426	2	3	2	2.3333333333333335	0.5773502691896258	0.24743582965269678	3	2	1
fam4427	2	3	2	2.3333333333333335	0.5773502691896258	0.24743582965269678	3	2	1
fam4428	2	2	3	2.3333333333333335	0.5773502691896258	0.24743582965269678	3	2	1
fam4429	2	3	2	2.3333333333333335	0.5773502691896258	0.24743582965269678	3	2	1
fam4430	2	3	2	2.3333333333333335	0.5773502691896258	0.24743582965269678	3	2	1
fam4431	3	2	2	2.3333333333333335	0.5773502691896258	0.24743582965269678	3	2	1
fam4432	2	2	3	2.3333333333333335	0.5773502691896258	0.24743582965269678	3	2	1
fam4433	2	3	2	2.3333333333333335	0.5773502691896258	0.24743582965269678	3	2	1
fam4434	2	3	2	2.3333333333333335	0.5773502691896258	0.24743582965269678	3	2	1
fam4435	2	3	2	2.3333333333333335	0.5773502691896258	0.24743582965269678	3	2	1
fam4436	3	2	2	2.3333333333333335	0.5773502691896258	0.24743582965269678	3	2	1
fam4437	2	2	3	2.3333333333333335	0.5773502691896258	0.24743582965269678	3	2	1
fam4438	2	3	2	2.3333333333333335	0.5773502691896258	0.24743582965269678	3	2	1
fam4439	2	2	3	2.3333333333333335	0.5773502691896258	0.24743582965269678	3	2	1
fam4440	2	3	2	2.3333333333333335	0.5773502691896258	0.24743582965269678	3	2	1
fam4441	2	2	3	2.3333333333333335	0.5773502691896258	0.24743582965269678	3	2	1
fam4442	2	2	3	2.3333333333333335	0.5773502691896258	0.24743582965269678	3	2	1
fam4443	2	3	2	2.3333333333333335	0.5773502691896258	0.24743582965269678	3	2	1
fam4444	2	3	2	2.3333333333333335	0.5773502691896258	0.24743582965269678	3	2	1
fam4445	2	3	2	2.3333333333333335	0.5773502691896258	0.24743582965269678	3	2	1
fam4446	3	2	2	2.3333333333333335	0.5773502691896258	0.24743582965269678	3	2	1
fam4447	3	2	2	2.3333333333333335	0.5773502691896258	0.24743582965269678	3	2	1
fam4448	2	3	2	2.3333333333333335	0.5773502691896258	0.24743582965269678	3	2	1
fam4449	2	2	3	2.3333333333333335	0.5773502691896258	0.24743582965269678	3	2	1
fam4450	2	2	3	2.3333333333333335	0.5773502691896258	0.24743582965269678	3	2	1
fam4451	2	3	2	2.3333333333333335	0.5773502691896258	0.24743582965269678	3	2	1
fam4452	2	2	3	2.3333333333333335	0.5773502691896258	0.24743582965269678	3	2	1
fam4453	2	3	2	2.3333333333333335	0.5773502691896258	0.24743582965269678	3	2	1
fam4454	2	3	2	2.3333333333333335	0.5773502691896258	0.24743582965269678	3	2	1
fam4455	2	3	2	2.3333333333333335	0.5773502691896258	0.24743582965269678	3	2	1
fam4456	2	3	2	2.3333333333333335	0.5773502691896258	0.24743582965269678	3	2	1
fam4457	2	2	3	2.3333333333333335	0.5773502691896258	0.24743582965269678	3	2	1
fam4458	2	3	2	2.3333333333333335	0.5773502691896258	0.24743582965269678	3	2	1
fam4459	2	3	2	2.3333333333333335	0.5773502691896258	0.24743582965269678	3	2	1
fam4460	2	2	3	2.3333333333333335	0.5773502691896258	0.24743582965269678	3	2	1
fam4461	3	2	2	2.3333333333333335	0.5773502691896258	0.24743582965269678	3	2	1
fam4462	2	3	2	2.3333333333333335	0.5773502691896258	0.24743582965269678	3	2	1
fam4463	2	2	3	2.3333333333333335	0.5773502691896258	0.24743582965269678	3	2	1
fam4464	2	2	3	2.3333333333333335	0.5773502691896258	0.24743582965269678	3	2	1
fam4465	2	3	2	2.3333333333333335	0.5773502691896258	0.24743582965269678	3	2	1
fam4466	3	2	2	2.3333333333333335	0.5773502691896258	0.24743582965269678	3	2	1
fam4467	2	2	3	2.3333333333333335	0.5773502691896258	0.24743582965269678	3	2	1
fam4468	2	3	2	2.3333333333333335	0.5773502691896258	0.24743582965269678	3	2	1
fam4469	3	2	2	2.3333333333333335	0.5773502691896258	0.24743582965269678	3	2	1
fam4470	2	3	2	2.3333333333333335	0.5773502691896258	0.24743582965269678	3	2	1
fam4471	2	3	2	2.3333333333333335	0.5773502691896258	0.24743582965269678	3	2	1
fam4472	2	2	3	2.3333333333333335	0.5773502691896258	0.24743582965269678	3	2	1
fam4473	2	3	2	2.3333333333333335	0.5773502691896258	0.24743582965269678	3	2	1
fam4474	2	3	2	2.3333333333333335	0.5773502691896258	0.24743582965269678	3	2	1
fam4475	2	3	2	2.3333333333333335	0.5773502691896258	0.24743582965269678	3	2	1
fam4476	2	2	3	2.3333333333333335	0.5773502691896258	0.24743582965269678	3	2	1
fam4477	2	2	3	2.3333333333333335	0.5773502691896258	0.24743582965269678	3	2	1
fam4478	2	3	2	2.3333333333333335	0.5773502691896258	0.24743582965269678	3	2	1
fam4479	2	3	2	2.3333333333333335	0.5773502691896258	0.24743582965269678	3	2	1
fam4480	2	2	3	2.3333333333333335	0.5773502691896258	0.24743582965269678	3	2	1
fam4481	2	3	2	2.3333333333333335	0.5773502691896258	0.24743582965269678	3	2	1
fam4482	2	3	2	2.3333333333333335	0.5773502691896258	0.24743582965269678	3	2	1
fam4483	2	3	2	2.3333333333333335	0.5773502691896258	0.24743582965269678	3	2	1
fam4484	3	2	2	2.3333333333333335	0.5773502691896258	0.24743582965269678	3	2	1
fam4485	2	2	3	2.3333333333333335	0.5773502691896258	0.24743582965269678	3	2	1
fam4486	3	2	2	2.3333333333333335	0.5773502691896258	0.24743582965269678	3	2	1
fam4487	2	3	2	2.3333333333333335	0.5773502691896258	0.24743582965269678	3	2	1
fam4488	3	2	2	2.3333333333333335	0.5773502691896258	0.24743582965269678	3	2	1
fam4489	2	3	2	2.3333333333333335	0.5773502691896258	0.24743582965269678	3	2	1
fam4490	2	2	3	2.3333333333333335	0.5773502691896258	0.24743582965269678	3	2	1
fam4491	2	3	2	2.3333333333333335	0.5773502691896258	0.24743582965269678	3	2	1
fam4492	2	2	3	2.3333333333333335	0.5773502691896258	0.24743582965269678	3	2	1
fam4493	2	3	2	2.3333333333333335	0.5773502691896258	0.24743582965269678	3	2	1
fam4494	2	3	2	2.3333333333333335	0.5773502691896258	0.24743582965269678	3	2	1
fam4495	2	3	2	2.3333333333333335	0.5773502691896258	0.24743582965269678	3	2	1
fam4496	2	3	2	2.3333333333333335	0.5773502691896258	0.24743582965269678	3	2	1
fam4497	2	3	2	2.3333333333333335	0.5773502691896258	0.24743582965269678	3	2	1
fam4498	2	2	3	2.3333333333333335	0.5773502691896258	0.24743582965269678	3	2	1
fam4499	2	2	3	2.3333333333333335	0.5773502691896258	0.24743582965269678	3	2	1
fam4500	2	3	2	2.3333333333333335	0.5773502691896258	0.24743582965269678	3	2	1
fam4501	2	3	2	2.3333333333333335	0.5773502691896258	0.24743582965269678	3	2	1
fam4502	2	3	2	2.3333333333333335	0.5773502691896258	0.24743582965269678	3	2	1
fam4503	2	3	2	2.3333333333333335	0.5773502691896258	0.24743582965269678	3	2	1
fam4504	2	3	2	2.3333333333333335	0.5773502691896258	0.24743582965269678	3	2	1
fam4505	3	2	2	2.3333333333333335	0.5773502691896258	0.24743582965269678	3	2	1
fam4506	2	3	2	2.3333333333333335	0.5773502691896258	0.24743582965269678	3	2	1
fam4507	2	3	2	2.3333333333333335	0.5773502691896258	0.24743582965269678	3	2	1
fam4508	2	3	2	2.3333333333333335	0.5773502691896258	0.24743582965269678	3	2	1
fam4509	2	3	2	2.3333333333333335	0.5773502691896258	0.24743582965269678	3	2	1
fam4510	2	3	2	2.3333333333333335	0.5773502691896258	0.24743582965269678	3	2	1
fam4511	2	3	2	2.3333333333333335	0.5773502691896258	0.24743582965269678	3	2	1
fam4512	2	3	2	2.3333333333333335	0.5773502691896258	0.24743582965269678	3	2	1
fam4513	2	3	2	2.3333333333333335	0.5773502691896258	0.24743582965269678	3	2	1
fam4514	2	3	2	2.3333333333333335	0.5773502691896258	0.24743582965269678	3	2	1
fam4515	2	2	3	2.3333333333333335	0.5773502691896258	0.24743582965269678	3	2	1
fam4516	2	3	2	2.3333333333333335	0.5773502691896258	0.24743582965269678	3	2	1
fam4517	2	3	2	2.3333333333333335	0.5773502691896258	0.24743582965269678	3	2	1
fam4518	2	2	3	2.3333333333333335	0.5773502691896258	0.24743582965269678	3	2	1
fam4519	2	3	2	2.3333333333333335	0.5773502691896258	0.24743582965269678	3	2	1
fam4520	2	3	2	2.3333333333333335	0.5773502691896258	0.24743582965269678	3	2	1
fam4521	2	3	2	2.3333333333333335	0.5773502691896258	0.24743582965269678	3	2	1
fam4522	2	2	3	2.3333333333333335	0.5773502691896258	0.24743582965269678	3	2	1
fam4523	2	3	2	2.3333333333333335	0.5773502691896258	0.24743582965269678	3	2	1
fam4524	2	3	2	2.3333333333333335	0.5773502691896258	0.24743582965269678	3	2	1
fam4525	2	2	3	2.3333333333333335	0.5773502691896258	0.24743582965269678	3	2	1
fam4526	2	3	2	2.3333333333333335	0.5773502691896258	0.24743582965269678	3	2	1
fam4527	2	2	3	2.3333333333333335	0.5773502691896258	0.24743582965269678	3	2	1
fam4528	2	3	2	2.3333333333333335	0.5773502691896258	0.24743582965269678	3	2	1
fam4529	2	3	2	2.3333333333333335	0.5773502691896258	0.24743582965269678	3	2	1
fam4530	2	3	2	2.3333333333333335	0.5773502691896258	0.24743582965269678	3	2	1
fam4531	2	3	2	2.3333333333333335	0.5773502691896258	0.24743582965269678	3	2	1
fam4532	2	3	2	2.3333333333333335	0.5773502691896258	0.24743582965269678	3	2	1
fam4533	2	3	2	2.3333333333333335	0.5773502691896258	0.24743582965269678	3	2	1
fam4534	2	2	3	2.3333333333333335	0.5773502691896258	0.24743582965269678	3	2	1
fam4535	2	2	3	2.3333333333333335	0.5773502691896258	0.24743582965269678	3	2	1
fam4536	2	3	2	2.3333333333333335	0.5773502691896258	0.24743582965269678	3	2	1
fam4537	2	3	2	2.3333333333333335	0.5773502691896258	0.24743582965269678	3	2	1
fam4538	2	3	2	2.3333333333333335	0.5773502691896258	0.24743582965269678	3	2	1
fam4539	2	3	2	2.3333333333333335	0.5773502691896258	0.24743582965269678	3	2	1
fam4540	2	3	2	2.3333333333333335	0.5773502691896258	0.24743582965269678	3	2	1
fam4541	2	3	2	2.3333333333333335	0.5773502691896258	0.24743582965269678	3	2	1
fam4542	2	3	2	2.3333333333333335	0.5773502691896258	0.24743582965269678	3	2	1
fam4543	2	2	3	2.3333333333333335	0.5773502691896258	0.24743582965269678	3	2	1
fam4544	2	3	2	2.3333333333333335	0.5773502691896258	0.24743582965269678	3	2	1
fam4545	2	3	2	2.3333333333333335	0.5773502691896258	0.24743582965269678	3	2	1
fam4546	2	3	2	2.3333333333333335	0.5773502691896258	0.24743582965269678	3	2	1
fam4547	2	2	3	2.3333333333333335	0.5773502691896258	0.24743582965269678	3	2	1
fam4548	2	3	2	2.3333333333333335	0.5773502691896258	0.24743582965269678	3	2	1
fam4549	2	3	2	2.3333333333333335	0.5773502691896258	0.24743582965269678	3	2	1
fam4550	2	3	2	2.3333333333333335	0.5773502691896258	0.24743582965269678	3	2	1
fam4551	2	2	3	2.3333333333333335	0.5773502691896258	0.24743582965269678	3	2	1
fam4552	2	2	3	2.3333333333333335	0.5773502691896258	0.24743582965269678	3	2	1
fam4553	2	3	2	2.3333333333333335	0.5773502691896258	0.24743582965269678	3	2	1
fam4554	2	3	2	2.3333333333333335	0.5773502691896258	0.24743582965269678	3	2	1
fam4555	2	3	2	2.3333333333333335	0.5773502691896258	0.24743582965269678	3	2	1
fam4556	2	2	3	2.3333333333333335	0.5773502691896258	0.24743582965269678	3	2	1
fam4557	2	2	3	2.3333333333333335	0.5773502691896258	0.24743582965269678	3	2	1
fam4558	2	3	2	2.3333333333333335	0.5773502691896258	0.24743582965269678	3	2	1
fam4559	2	2	3	2.3333333333333335	0.5773502691896258	0.24743582965269678	3	2	1
fam4560	2	3	2	2.3333333333333335	0.5773502691896258	0.24743582965269678	3	2	1
fam4561	2	3	2	2.3333333333333335	0.5773502691896258	0.24743582965269678	3	2	1
fam4562	2	3	2	2.3333333333333335	0.5773502691896258	0.24743582965269678	3	2	1
fam4563	2	3	2	2.3333333333333335	0.5773502691896258	0.24743582965269678	3	2	1
fam4564	2	3	2	2.3333333333333335	0.5773502691896258	0.24743582965269678	3	2	1
fam4565	2	3	2	2.3333333333333335	0.5773502691896258	0.24743582965269678	3	2	1
fam4566	2	2	3	2.3333333333333335	0.5773502691896258	0.24743582965269678	3	2	1
fam4567	3	2	2	2.3333333333333335	0.5773502691896258	0.24743582965269678	3	2	1
fam4568	2	2	3	2.3333333333333335	0.5773502691896258	0.24743582965269678	3	2	1
fam4569	2	2	3	2.3333333333333335	0.5773502691896258	0.24743582965269678	3	2	1
fam4570	2	2	3	2.3333333333333335	0.5773502691896258	0.24743582965269678	3	2	1
fam4571	2	3	2	2.3333333333333335	0.5773502691896258	0.24743582965269678	3	2	1
fam4572	2	3	2	2.3333333333333335	0.5773502691896258	0.24743582965269678	3	2	1
fam4573	2	2	3	2.3333333333333335	0.5773502691896258	0.24743582965269678	3	2	1
fam4574	2	2	3	2.3333333333333335	0.5773502691896258	0.24743582965269678	3	2	1
fam4575	2	2	3	2.3333333333333335	0.5773502691896258	0.24743582965269678	3	2	1
fam4576	2	3	2	2.3333333333333335	0.5773502691896258	0.24743582965269678	3	2	1
fam4577	2	2	3	2.3333333333333335	0.5773502691896258	0.24743582965269678	3	2	1
fam4578	3	2	2	2.3333333333333335	0.5773502691896258	0.24743582965269678	3	2	1
fam4579	3	2	2	2.3333333333333335	0.5773502691896258	0.24743582965269678	3	2	1
fam4580	2	3	2	2.3333333333333335	0.5773502691896258	0.24743582965269678	3	2	1
fam4581	2	3	2	2.3333333333333335	0.5773502691896258	0.24743582965269678	3	2	1
fam4582	2	3	2	2.3333333333333335	0.5773502691896258	0.24743582965269678	3	2	1
fam4583	2	3	2	2.3333333333333335	0.5773502691896258	0.24743582965269678	3	2	1
fam4584	2	3	2	2.3333333333333335	0.5773502691896258	0.24743582965269678	3	2	1
fam4585	2	2	3	2.3333333333333335	0.5773502691896258	0.24743582965269678	3	2	1
fam4586	2	3	2	2.3333333333333335	0.5773502691896258	0.24743582965269678	3	2	1
fam4587	2	3	2	2.3333333333333335	0.5773502691896258	0.24743582965269678	3	2	1
fam4588	2	3	2	2.3333333333333335	0.5773502691896258	0.24743582965269678	3	2	1
fam4589	3	2	2	2.3333333333333335	0.5773502691896258	0.24743582965269678	3	2	1
fam4590	2	3	2	2.3333333333333335	0.5773502691896258	0.24743582965269678	3	2	1
fam4591	2	2	3	2.3333333333333335	0.5773502691896258	0.24743582965269678	3	2	1
fam4592	2	2	3	2.3333333333333335	0.5773502691896258	0.24743582965269678	3	2	1
fam4593	2	3	2	2.3333333333333335	0.5773502691896258	0.24743582965269678	3	2	1
fam4594	2	3	2	2.3333333333333335	0.5773502691896258	0.24743582965269678	3	2	1
fam4595	2	3	2	2.3333333333333335	0.5773502691896258	0.24743582965269678	3	2	1
fam4596	2	3	2	2.3333333333333335	0.5773502691896258	0.24743582965269678	3	2	1
fam4597	2	2	3	2.3333333333333335	0.5773502691896258	0.24743582965269678	3	2	1
fam4598	2	3	2	2.3333333333333335	0.5773502691896258	0.24743582965269678	3	2	1
fam4599	2	2	3	2.3333333333333335	0.5773502691896258	0.24743582965269678	3	2	1
fam4600	2	3	2	2.3333333333333335	0.5773502691896258	0.24743582965269678	3	2	1
fam4601	2	3	2	2.3333333333333335	0.5773502691896258	0.24743582965269678	3	2	1
fam4602	2	2	3	2.3333333333333335	0.5773502691896258	0.24743582965269678	3	2	1
fam4603	2	3	2	2.3333333333333335	0.5773502691896258	0.24743582965269678	3	2	1
fam4604	2	3	2	2.3333333333333335	0.5773502691896258	0.24743582965269678	3	2	1
fam4605	2	3	2	2.3333333333333335	0.5773502691896258	0.24743582965269678	3	2	1
fam4606	2	2	3	2.3333333333333335	0.5773502691896258	0.24743582965269678	3	2	1
fam4607	2	2	3	2.3333333333333335	0.5773502691896258	0.24743582965269678	3	2	1
fam4608	2	2	3	2.3333333333333335	0.5773502691896258	0.24743582965269678	3	2	1
fam4609	2	3	2	2.3333333333333335	0.5773502691896258	0.24743582965269678	3	2	1
fam4610	2	3	2	2.3333333333333335	0.5773502691896258	0.24743582965269678	3	2	1
fam4611	2	3	2	2.3333333333333335	0.5773502691896258	0.24743582965269678	3	2	1
fam4612	2	3	2	2.3333333333333335	0.5773502691896258	0.24743582965269678	3	2	1
fam4613	2	2	3	2.3333333333333335	0.5773502691896258	0.24743582965269678	3	2	1
fam4614	2	3	2	2.3333333333333335	0.5773502691896258	0.24743582965269678	3	2	1
fam4615	2	2	3	2.3333333333333335	0.5773502691896258	0.24743582965269678	3	2	1
fam4616	2	2	3	2.3333333333333335	0.5773502691896258	0.24743582965269678	3	2	1
fam4617	2	3	2	2.3333333333333335	0.5773502691896258	0.24743582965269678	3	2	1
fam4618	2	3	2	2.3333333333333335	0.5773502691896258	0.24743582965269678	3	2	1
fam4619	2	3	2	2.3333333333333335	0.5773502691896258	0.24743582965269678	3	2	1
fam4620	3	2	2	2.3333333333333335	0.5773502691896258	0.24743582965269678	3	2	1
fam4621	2	3	2	2.3333333333333335	0.5773502691896258	0.24743582965269678	3	2	1
fam4622	2	3	2	2.3333333333333335	0.5773502691896258	0.24743582965269678	3	2	1
fam4623	2	2	3	2.3333333333333335	0.5773502691896258	0.24743582965269678	3	2	1
fam4624	2	3	2	2.3333333333333335	0.5773502691896258	0.24743582965269678	3	2	1
fam4625	2	3	2	2.3333333333333335	0.5773502691896258	0.24743582965269678	3	2	1
fam4626	2	2	3	2.3333333333333335	0.5773502691896258	0.24743582965269678	3	2	1
fam4627	2	2	3	2.3333333333333335	0.5773502691896258	0.24743582965269678	3	2	1
fam4628	2	3	2	2.3333333333333335	0.5773502691896258	0.24743582965269678	3	2	1
fam4629	2	2	3	2.3333333333333335	0.5773502691896258	0.24743582965269678	3	2	1
fam4630	2	3	2	2.3333333333333335	0.5773502691896258	0.24743582965269678	3	2	1
fam4631	2	2	3	2.3333333333333335	0.5773502691896258	0.24743582965269678	3	2	1
fam4632	2	3	2	2.3333333333333335	0.5773502691896258	0.24743582965269678	3	2	1
fam4633	2	2	3	2.3333333333333335	0.5773502691896258	0.24743582965269678	3	2	1
fam4634	2	3	2	2.3333333333333335	0.5773502691896258	0.24743582965269678	3	2	1
fam4635	2	2	3	2.3333333333333335	0.5773502691896258	0.24743582965269678	3	2	1
fam4636	2	3	2	2.3333333333333335	0.5773502691896258	0.24743582965269678	3	2	1
fam4637	2	3	2	2.3333333333333335	0.5773502691896258	0.24743582965269678	3	2	1
fam4638	2	3	2	2.3333333333333335	0.5773502691896258	0.24743582965269678	3	2	1
fam4639	2	3	2	2.3333333333333335	0.5773502691896258	0.24743582965269678	3	2	1
fam4640	2	3	2	2.3333333333333335	0.5773502691896258	0.24743582965269678	3	2	1
fam4641	3	2	2	2.3333333333333335	0.5773502691896258	0.24743582965269678	3	2	1
fam4642	2	3	2	2.3333333333333335	0.5773502691896258	0.24743582965269678	3	2	1
fam4643	2	3	2	2.3333333333333335	0.5773502691896258	0.24743582965269678	3	2	1
fam4644	2	2	3	2.3333333333333335	0.5773502691896258	0.24743582965269678	3	2	1
fam4645	2	3	2	2.3333333333333335	0.5773502691896258	0.24743582965269678	3	2	1
fam4646	2	3	2	2.3333333333333335	0.5773502691896258	0.24743582965269678	3	2	1
fam4647	2	3	2	2.3333333333333335	0.5773502691896258	0.24743582965269678	3	2	1
fam4648	2	3	2	2.3333333333333335	0.5773502691896258	0.24743582965269678	3	2	1
fam4649	2	3	2	2.3333333333333335	0.5773502691896258	0.24743582965269678	3	2	1
fam4650	2	2	3	2.3333333333333335	0.5773502691896258	0.24743582965269678	3	2	1
fam4651	2	3	2	2.3333333333333335	0.5773502691896258	0.24743582965269678	3	2	1
fam4652	2	3	2	2.3333333333333335	0.5773502691896258	0.24743582965269678	3	2	1
fam4653	2	3	2	2.3333333333333335	0.5773502691896258	0.24743582965269678	3	2	1
fam4654	2	3	2	2.3333333333333335	0.5773502691896258	0.24743582965269678	3	2	1
fam4655	2	3	2	2.3333333333333335	0.5773502691896258	0.24743582965269678	3	2	1
fam4656	2	3	2	2.3333333333333335	0.5773502691896258	0.24743582965269678	3	2	1
fam4657	2	3	2	2.3333333333333335	0.5773502691896258	0.24743582965269678	3	2	1
fam4658	2	2	3	2.3333333333333335	0.5773502691896258	0.24743582965269678	3	2	1
fam4659	2	2	3	2.3333333333333335	0.5773502691896258	0.24743582965269678	3	2	1
fam4660	2	3	2	2.3333333333333335	0.5773502691896258	0.24743582965269678	3	2	1
fam4661	2	3	2	2.3333333333333335	0.5773502691896258	0.24743582965269678	3	2	1
fam4662	2	3	2	2.3333333333333335	0.5773502691896258	0.24743582965269678	3	2	1
fam4663	2	3	2	2.3333333333333335	0.5773502691896258	0.24743582965269678	3	2	1
fam4664	2	3	2	2.3333333333333335	0.5773502691896258	0.24743582965269678	3	2	1
fam4665	2	2	3	2.3333333333333335	0.5773502691896258	0.24743582965269678	3	2	1
fam4666	3	2	2	2.3333333333333335	0.5773502691896258	0.24743582965269678	3	2	1
fam4667	2	2	3	2.3333333333333335	0.5773502691896258	0.24743582965269678	3	2	1
fam4668	2	2	3	2.3333333333333335	0.5773502691896258	0.24743582965269678	3	2	1
fam4669	2	3	2	2.3333333333333335	0.5773502691896258	0.24743582965269678	3	2	1
fam4670	2	2	3	2.3333333333333335	0.5773502691896258	0.24743582965269678	3	2	1
fam4671	2	3	2	2.3333333333333335	0.5773502691896258	0.24743582965269678	3	2	1
fam4672	2	2	3	2.3333333333333335	0.5773502691896258	0.24743582965269678	3	2	1
fam4673	2	3	2	2.3333333333333335	0.5773502691896258	0.24743582965269678	3	2	1
fam4674	2	2	3	2.3333333333333335	0.5773502691896258	0.24743582965269678	3	2	1
fam4675	2	3	2	2.3333333333333335	0.5773502691896258	0.24743582965269678	3	2	1
fam4676	2	2	3	2.3333333333333335	0.5773502691896258	0.24743582965269678	3	2	1
fam4677	2	3	2	2.3333333333333335	0.5773502691896258	0.24743582965269678	3	2	1
fam4678	2	2	3	2.3333333333333335	0.5773502691896258	0.24743582965269678	3	2	1
fam4679	2	3	2	2.3333333333333335	0.5773502691896258	0.24743582965269678	3	2	1
fam4680	2	3	2	2.3333333333333335	0.5773502691896258	0.24743582965269678	3	2	1
fam4681	2	2	3	2.3333333333333335	0.5773502691896258	0.24743582965269678	3	2	1
fam4682	2	2	3	2.3333333333333335	0.5773502691896258	0.24743582965269678	3	2	1
fam4683	2	2	3	2.3333333333333335	0.5773502691896258	0.24743582965269678	3	2	1
fam4684	2	3	2	2.3333333333333335	0.5773502691896258	0.24743582965269678	3	2	1
fam4685	2	3	2	2.3333333333333335	0.5773502691896258	0.24743582965269678	3	2	1
fam4686	2	3	2	2.3333333333333335	0.5773502691896258	0.24743582965269678	3	2	1
fam4687	2	2	3	2.3333333333333335	0.5773502691896258	0.24743582965269678	3	2	1
fam4688	2	2	3	2.3333333333333335	0.5773502691896258	0.24743582965269678	3	2	1
fam4689	2	3	2	2.3333333333333335	0.5773502691896258	0.24743582965269678	3	2	1
fam4690	2	2	3	2.3333333333333335	0.5773502691896258	0.24743582965269678	3	2	1
fam4691	2	2	3	2.3333333333333335	0.5773502691896258	0.24743582965269678	3	2	1
fam4692	2	3	2	2.3333333333333335	0.5773502691896258	0.24743582965269678	3	2	1
fam4693	2	3	2	2.3333333333333335	0.5773502691896258	0.24743582965269678	3	2	1
fam4694	2	2	3	2.3333333333333335	0.5773502691896258	0.24743582965269678	3	2	1
fam4695	2	2	3	2.3333333333333335	0.5773502691896258	0.24743582965269678	3	2	1
fam4696	2	2	3	2.3333333333333335	0.5773502691896258	0.24743582965269678	3	2	1
fam4697	2	3	2	2.3333333333333335	0.5773502691896258	0.24743582965269678	3	2	1
fam4698	2	2	3	2.3333333333333335	0.5773502691896258	0.24743582965269678	3	2	1
fam4699	2	3	2	2.3333333333333335	0.5773502691896258	0.24743582965269678	3	2	1
fam4700	2	3	2	2.3333333333333335	0.5773502691896258	0.24743582965269678	3	2	1
fam4701	2	2	3	2.3333333333333335	0.5773502691896258	0.24743582965269678	3	2	1
fam4702	3	2	2	2.3333333333333335	0.5773502691896258	0.24743582965269678	3	2	1
fam4703	2	3	2	2.3333333333333335	0.5773502691896258	0.24743582965269678	3	2	1
fam4704	2	3	2	2.3333333333333335	0.5773502691896258	0.24743582965269678	3	2	1
fam4705	2	3	2	2.3333333333333335	0.5773502691896258	0.24743582965269678	3	2	1
fam4706	3	2	2	2.3333333333333335	0.5773502691896258	0.24743582965269678	3	2	1
fam4707	2	2	3	2.3333333333333335	0.5773502691896258	0.24743582965269678	3	2	1
fam4708	2	3	2	2.3333333333333335	0.5773502691896258	0.24743582965269678	3	2	1
fam4709	2	3	2	2.3333333333333335	0.5773502691896258	0.24743582965269678	3	2	1
fam4710	2	3	2	2.3333333333333335	0.5773502691896258	0.24743582965269678	3	2	1
fam4711	3	2	2	2.3333333333333335	0.5773502691896258	0.24743582965269678	3	2	1
fam4712	2	2	3	2.3333333333333335	0.5773502691896258	0.24743582965269678	3	2	1
fam4713	3	2	2	2.3333333333333335	0.5773502691896258	0.24743582965269678	3	2	1
fam4714	2	2	3	2.3333333333333335	0.5773502691896258	0.24743582965269678	3	2	1
fam4715	2	2	3	2.3333333333333335	0.5773502691896258	0.24743582965269678	3	2	1
fam4716	2	2	3	2.3333333333333335	0.5773502691896258	0.24743582965269678	3	2	1
fam4717	2	3	2	2.3333333333333335	0.5773502691896258	0.24743582965269678	3	2	1
fam4718	2	2	3	2.3333333333333335	0.5773502691896258	0.24743582965269678	3	2	1
fam4719	2	3	2	2.3333333333333335	0.5773502691896258	0.24743582965269678	3	2	1
fam4720	2	3	2	2.3333333333333335	0.5773502691896258	0.24743582965269678	3	2	1
fam4721	2	3	2	2.3333333333333335	0.5773502691896258	0.24743582965269678	3	2	1
fam4722	2	3	2	2.3333333333333335	0.5773502691896258	0.24743582965269678	3	2	1
fam4723	2	3	2	2.3333333333333335	0.5773502691896258	0.24743582965269678	3	2	1
fam4724	2	2	3	2.3333333333333335	0.5773502691896258	0.24743582965269678	3	2	1
fam4725	2	3	2	2.3333333333333335	0.5773502691896258	0.24743582965269678	3	2	1
fam4726	2	2	3	2.3333333333333335	0.5773502691896258	0.24743582965269678	3	2	1
fam4727	2	2	3	2.3333333333333335	0.5773502691896258	0.24743582965269678	3	2	1
fam4728	2	2	3	2.3333333333333335	0.5773502691896258	0.24743582965269678	3	2	1
fam4729	2	3	2	2.3333333333333335	0.5773502691896258	0.24743582965269678	3	2	1
fam4730	2	3	2	2.3333333333333335	0.5773502691896258	0.24743582965269678	3	2	1
fam4731	2	2	3	2.3333333333333335	0.5773502691896258	0.24743582965269678	3	2	1
fam4732	2	2	3	2.3333333333333335	0.5773502691896258	0.24743582965269678	3	2	1
fam4733	2	2	3	2.3333333333333335	0.5773502691896258	0.24743582965269678	3	2	1
fam4734	2	3	2	2.3333333333333335	0.5773502691896258	0.24743582965269678	3	2	1
fam4735	2	3	2	2.3333333333333335	0.5773502691896258	0.24743582965269678	3	2	1
fam4736	2	3	2	2.3333333333333335	0.5773502691896258	0.24743582965269678	3	2	1
fam4737	2	2	3	2.3333333333333335	0.5773502691896258	0.24743582965269678	3	2	1
fam4738	2	2	3	2.3333333333333335	0.5773502691896258	0.24743582965269678	3	2	1
fam4739	2	3	2	2.3333333333333335	0.5773502691896258	0.24743582965269678	3	2	1
fam4740	2	3	2	2.3333333333333335	0.5773502691896258	0.24743582965269678	3	2	1
fam4741	2	2	3	2.3333333333333335	0.5773502691896258	0.24743582965269678	3	2	1
fam4742	2	2	3	2.3333333333333335	0.5773502691896258	0.24743582965269678	3	2	1
fam4743	2	2	3	2.3333333333333335	0.5773502691896258	0.24743582965269678	3	2	1
fam4744	3	2	2	2.3333333333333335	0.5773502691896258	0.24743582965269678	3	2	1
fam4745	2	2	3	2.3333333333333335	0.5773502691896258	0.24743582965269678	3	2	1
fam4746	2	2	3	2.3333333333333335	0.5773502691896258	0.24743582965269678	3	2	1
fam4747	2	3	2	2.3333333333333335	0.5773502691896258	0.24743582965269678	3	2	1
fam4748	2	3	2	2.3333333333333335	0.5773502691896258	0.24743582965269678	3	2	1
fam4749	3	2	2	2.3333333333333335	0.5773502691896258	0.24743582965269678	3	2	1
fam4750	2	3	2	2.3333333333333335	0.5773502691896258	0.24743582965269678	3	2	1
fam4751	2	3	2	2.3333333333333335	0.5773502691896258	0.24743582965269678	3	2	1
fam4752	2	2	3	2.3333333333333335	0.5773502691896258	0.24743582965269678	3	2	1
fam4753	2	2	3	2.3333333333333335	0.5773502691896258	0.24743582965269678	3	2	1
fam4754	2	3	2	2.3333333333333335	0.5773502691896258	0.24743582965269678	3	2	1
fam4755	2	2	3	2.3333333333333335	0.5773502691896258	0.24743582965269678	3	2	1
fam4756	2	3	2	2.3333333333333335	0.5773502691896258	0.24743582965269678	3	2	1
fam4757	2	3	2	2.3333333333333335	0.5773502691896258	0.24743582965269678	3	2	1
fam4758	3	2	2	2.3333333333333335	0.5773502691896258	0.24743582965269678	3	2	1
fam4759	2	3	2	2.3333333333333335	0.5773502691896258	0.24743582965269678	3	2	1
fam4760	2	3	2	2.3333333333333335	0.5773502691896258	0.24743582965269678	3	2	1
fam4761	2	3	2	2.3333333333333335	0.5773502691896258	0.24743582965269678	3	2	1
fam4762	2	3	2	2.3333333333333335	0.5773502691896258	0.24743582965269678	3	2	1
fam4763	2	3	2	2.3333333333333335	0.5773502691896258	0.24743582965269678	3	2	1
fam4764	2	3	2	2.3333333333333335	0.5773502691896258	0.24743582965269678	3	2	1
fam4765	2	2	3	2.3333333333333335	0.5773502691896258	0.24743582965269678	3	2	1
fam4766	2	3	2	2.3333333333333335	0.5773502691896258	0.24743582965269678	3	2	1
fam4767	2	2	3	2.3333333333333335	0.5773502691896258	0.24743582965269678	3	2	1
fam4768	2	2	3	2.3333333333333335	0.5773502691896258	0.24743582965269678	3	2	1
fam4769	2	2	3	2.3333333333333335	0.5773502691896258	0.24743582965269678	3	2	1
fam4770	2	3	2	2.3333333333333335	0.5773502691896258	0.24743582965269678	3	2	1
fam4771	2	3	2	2.3333333333333335	0.5773502691896258	0.24743582965269678	3	2	1
fam4772	2	3	2	2.3333333333333335	0.5773502691896258	0.24743582965269678	3	2	1
fam4773	2	3	2	2.3333333333333335	0.5773502691896258	0.24743582965269678	3	2	1
fam4774	2	3	2	2.3333333333333335	0.5773502691896258	0.24743582965269678	3	2	1
fam4775	2	3	2	2.3333333333333335	0.5773502691896258	0.24743582965269678	3	2	1
fam4776	2	3	2	2.3333333333333335	0.5773502691896258	0.24743582965269678	3	2	1
fam4777	2	3	2	2.3333333333333335	0.5773502691896258	0.24743582965269678	3	2	1
fam4778	2	3	2	2.3333333333333335	0.5773502691896258	0.24743582965269678	3	2	1
fam4779	2	3	2	2.3333333333333335	0.5773502691896258	0.24743582965269678	3	2	1
fam4780	2	3	2	2.3333333333333335	0.5773502691896258	0.24743582965269678	3	2	1
fam4781	2	2	3	2.3333333333333335	0.5773502691896258	0.24743582965269678	3	2	1
fam4782	3	2	2	2.3333333333333335	0.5773502691896258	0.24743582965269678	3	2	1
fam4783	2	3	2	2.3333333333333335	0.5773502691896258	0.24743582965269678	3	2	1
fam4784	2	3	2	2.3333333333333335	0.5773502691896258	0.24743582965269678	3	2	1
fam4785	2	3	2	2.3333333333333335	0.5773502691896258	0.24743582965269678	3	2	1
fam4786	2	3	2	2.3333333333333335	0.5773502691896258	0.24743582965269678	3	2	1
fam4787	2	3	2	2.3333333333333335	0.5773502691896258	0.24743582965269678	3	2	1
fam4788	2	3	2	2.3333333333333335	0.5773502691896258	0.24743582965269678	3	2	1
fam4789	2	3	2	2.3333333333333335	0.5773502691896258	0.24743582965269678	3	2	1
fam4790	2	3	2	2.3333333333333335	0.5773502691896258	0.24743582965269678	3	2	1
fam4791	2	3	2	2.3333333333333335	0.5773502691896258	0.24743582965269678	3	2	1
fam4792	2	2	3	2.3333333333333335	0.5773502691896258	0.24743582965269678	3	2	1
fam4793	2	3	2	2.3333333333333335	0.5773502691896258	0.24743582965269678	3	2	1
fam4794	2	2	3	2.3333333333333335	0.5773502691896258	0.24743582965269678	3	2	1
fam4795	2	2	3	2.3333333333333335	0.5773502691896258	0.24743582965269678	3	2	1
fam4796	2	3	2	2.3333333333333335	0.5773502691896258	0.24743582965269678	3	2	1
fam4797	2	3	2	2.3333333333333335	0.5773502691896258	0.24743582965269678	3	2	1
fam4798	2	2	3	2.3333333333333335	0.5773502691896258	0.24743582965269678	3	2	1
fam4799	2	2	3	2.3333333333333335	0.5773502691896258	0.24743582965269678	3	2	1
fam4800	2	3	2	2.3333333333333335	0.5773502691896258	0.24743582965269678	3	2	1
fam4801	2	3	2	2.3333333333333335	0.5773502691896258	0.24743582965269678	3	2	1
fam4802	2	3	2	2.3333333333333335	0.5773502691896258	0.24743582965269678	3	2	1
fam4803	2	2	3	2.3333333333333335	0.5773502691896258	0.24743582965269678	3	2	1
fam4804	2	3	2	2.3333333333333335	0.5773502691896258	0.24743582965269678	3	2	1
fam4805	2	3	2	2.3333333333333335	0.5773502691896258	0.24743582965269678	3	2	1
fam4806	2	2	3	2.3333333333333335	0.5773502691896258	0.24743582965269678	3	2	1
fam4807	2	2	3	2.3333333333333335	0.5773502691896258	0.24743582965269678	3	2	1
fam4808	2	3	2	2.3333333333333335	0.5773502691896258	0.24743582965269678	3	2	1
fam4809	2	2	3	2.3333333333333335	0.5773502691896258	0.24743582965269678	3	2	1
fam4810	3	2	2	2.3333333333333335	0.5773502691896258	0.24743582965269678	3	2	1
fam4811	2	3	2	2.3333333333333335	0.5773502691896258	0.24743582965269678	3	2	1
fam4812	2	3	2	2.3333333333333335	0.5773502691896258	0.24743582965269678	3	2	1
fam4813	2	2	3	2.3333333333333335	0.5773502691896258	0.24743582965269678	3	2	1
fam4814	2	2	3	2.3333333333333335	0.5773502691896258	0.24743582965269678	3	2	1
fam4815	2	3	2	2.3333333333333335	0.5773502691896258	0.24743582965269678	3	2	1
fam4816	2	2	3	2.3333333333333335	0.5773502691896258	0.24743582965269678	3	2	1
fam4817	2	3	2	2.3333333333333335	0.5773502691896258	0.24743582965269678	3	2	1
fam4818	2	2	3	2.3333333333333335	0.5773502691896258	0.24743582965269678	3	2	1
fam4819	2	3	2	2.3333333333333335	0.5773502691896258	0.24743582965269678	3	2	1
fam4820	2	2	3	2.3333333333333335	0.5773502691896258	0.24743582965269678	3	2	1
fam4821	2	3	2	2.3333333333333335	0.5773502691896258	0.24743582965269678	3	2	1
fam4822	2	2	3	2.3333333333333335	0.5773502691896258	0.24743582965269678	3	2	1
fam4823	2	2	3	2.3333333333333335	0.5773502691896258	0.24743582965269678	3	2	1
fam4824	2	3	2	2.3333333333333335	0.5773502691896258	0.24743582965269678	3	2	1
fam4825	2	3	2	2.3333333333333335	0.5773502691896258	0.24743582965269678	3	2	1
fam4826	2	3	2	2.3333333333333335	0.5773502691896258	0.24743582965269678	3	2	1
fam4827	2	2	3	2.3333333333333335	0.5773502691896258	0.24743582965269678	3	2	1
fam4828	2	2	3	2.3333333333333335	0.5773502691896258	0.24743582965269678	3	2	1
fam4829	2	3	2	2.3333333333333335	0.5773502691896258	0.24743582965269678	3	2	1
fam4830	2	3	2	2.3333333333333335	0.5773502691896258	0.24743582965269678	3	2	1
fam4831	2	3	2	2.3333333333333335	0.5773502691896258	0.24743582965269678	3	2	1
fam4832	2	2	3	2.3333333333333335	0.5773502691896258	0.24743582965269678	3	2	1
fam4833	2	3	2	2.3333333333333335	0.5773502691896258	0.24743582965269678	3	2	1
fam4834	2	3	2	2.3333333333333335	0.5773502691896258	0.24743582965269678	3	2	1
fam4835	2	3	2	2.3333333333333335	0.5773502691896258	0.24743582965269678	3	2	1
fam4836	2	2	3	2.3333333333333335	0.5773502691896258	0.24743582965269678	3	2	1
fam4837	2	3	2	2.3333333333333335	0.5773502691896258	0.24743582965269678	3	2	1
fam4838	2	3	2	2.3333333333333335	0.5773502691896258	0.24743582965269678	3	2	1
fam4839	2	3	2	2.3333333333333335	0.5773502691896258	0.24743582965269678	3	2	1
fam4840	3	2	2	2.3333333333333335	0.5773502691896258	0.24743582965269678	3	2	1
fam4841	3	2	2	2.3333333333333335	0.5773502691896258	0.24743582965269678	3	2	1
fam4842	2	2	3	2.3333333333333335	0.5773502691896258	0.24743582965269678	3	2	1
fam4843	2	3	2	2.3333333333333335	0.5773502691896258	0.24743582965269678	3	2	1
fam4844	3	2	2	2.3333333333333335	0.5773502691896258	0.24743582965269678	3	2	1
fam4845	2	3	2	2.3333333333333335	0.5773502691896258	0.24743582965269678	3	2	1
fam4846	2	2	3	2.3333333333333335	0.5773502691896258	0.24743582965269678	3	2	1
fam4847	2	3	2	2.3333333333333335	0.5773502691896258	0.24743582965269678	3	2	1
fam4848	2	3	2	2.3333333333333335	0.5773502691896258	0.24743582965269678	3	2	1
fam4849	2	2	3	2.3333333333333335	0.5773502691896258	0.24743582965269678	3	2	1
fam4850	3	2	2	2.3333333333333335	0.5773502691896258	0.24743582965269678	3	2	1
fam4851	2	3	2	2.3333333333333335	0.5773502691896258	0.24743582965269678	3	2	1
fam4852	2	3	2	2.3333333333333335	0.5773502691896258	0.24743582965269678	3	2	1
fam4853	2	3	2	2.3333333333333335	0.5773502691896258	0.24743582965269678	3	2	1
fam4854	2	3	2	2.3333333333333335	0.5773502691896258	0.24743582965269678	3	2	1
fam4855	2	2	3	2.3333333333333335	0.5773502691896258	0.24743582965269678	3	2	1
fam4856	2	2	3	2.3333333333333335	0.5773502691896258	0.24743582965269678	3	2	1
fam4857	2	2	3	2.3333333333333335	0.5773502691896258	0.24743582965269678	3	2	1
fam4858	2	3	2	2.3333333333333335	0.5773502691896258	0.24743582965269678	3	2	1
fam4859	2	3	2	2.3333333333333335	0.5773502691896258	0.24743582965269678	3	2	1
fam4860	2	3	2	2.3333333333333335	0.5773502691896258	0.24743582965269678	3	2	1
fam4861	2	3	2	2.3333333333333335	0.5773502691896258	0.24743582965269678	3	2	1
fam4862	2	3	2	2.3333333333333335	0.5773502691896258	0.24743582965269678	3	2	1
fam4863	2	3	2	2.3333333333333335	0.5773502691896258	0.24743582965269678	3	2	1
fam4864	2	3	2	2.3333333333333335	0.5773502691896258	0.24743582965269678	3	2	1
fam4865	2	3	2	2.3333333333333335	0.5773502691896258	0.24743582965269678	3	2	1
fam4866	2	2	3	2.3333333333333335	0.5773502691896258	0.24743582965269678	3	2	1
fam4867	2	3	2	2.3333333333333335	0.5773502691896258	0.24743582965269678	3	2	1
fam4868	2	3	2	2.3333333333333335	0.5773502691896258	0.24743582965269678	3	2	1
fam4869	2	3	2	2.3333333333333335	0.5773502691896258	0.24743582965269678	3	2	1
fam4870	3	2	2	2.3333333333333335	0.5773502691896258	0.24743582965269678	3	2	1
fam4871	2	3	2	2.3333333333333335	0.5773502691896258	0.24743582965269678	3	2	1
fam4872	3	2	2	2.3333333333333335	0.5773502691896258	0.24743582965269678	3	2	1
fam4873	2	3	2	2.3333333333333335	0.5773502691896258	0.24743582965269678	3	2	1
fam4874	2	3	2	2.3333333333333335	0.5773502691896258	0.24743582965269678	3	2	1
fam4875	3	2	2	2.3333333333333335	0.5773502691896258	0.24743582965269678	3	2	1
fam4876	2	2	3	2.3333333333333335	0.5773502691896258	0.24743582965269678	3	2	1
fam4877	2	3	2	2.3333333333333335	0.5773502691896258	0.24743582965269678	3	2	1
fam4878	2	2	3	2.3333333333333335	0.5773502691896258	0.24743582965269678	3	2	1
fam4879	2	3	2	2.3333333333333335	0.5773502691896258	0.24743582965269678	3	2	1
fam4880	2	3	2	2.3333333333333335	0.5773502691896258	0.24743582965269678	3	2	1
fam4881	2	3	2	2.3333333333333335	0.5773502691896258	0.24743582965269678	3	2	1
fam4882	2	3	2	2.3333333333333335	0.5773502691896258	0.24743582965269678	3	2	1
fam4883	2	2	3	2.3333333333333335	0.5773502691896258	0.24743582965269678	3	2	1
fam4884	2	2	3	2.3333333333333335	0.5773502691896258	0.24743582965269678	3	2	1
fam4885	3	2	2	2.3333333333333335	0.5773502691896258	0.24743582965269678	3	2	1
fam4886	3	2	2	2.3333333333333335	0.5773502691896258	0.24743582965269678	3	2	1
fam4887	3	2	2	2.3333333333333335	0.5773502691896258	0.24743582965269678	3	2	1
fam4888	2	3	2	2.3333333333333335	0.5773502691896258	0.24743582965269678	3	2	1
fam4889	2	3	2	2.3333333333333335	0.5773502691896258	0.24743582965269678	3	2	1
fam4890	2	3	2	2.3333333333333335	0.5773502691896258	0.24743582965269678	3	2	1
fam4891	2	3	2	2.3333333333333335	0.5773502691896258	0.24743582965269678	3	2	1
fam4892	2	3	2	2.3333333333333335	0.5773502691896258	0.24743582965269678	3	2	1
fam4893	2	3	2	2.3333333333333335	0.5773502691896258	0.24743582965269678	3	2	1
fam4894	2	3	2	2.3333333333333335	0.5773502691896258	0.24743582965269678	3	2	1
fam4895	2	3	2	2.3333333333333335	0.5773502691896258	0.24743582965269678	3	2	1
fam4896	2	3	2	2.3333333333333335	0.5773502691896258	0.24743582965269678	3	2	1
fam4897	2	2	3	2.3333333333333335	0.5773502691896258	0.24743582965269678	3	2	1
fam4898	2	3	2	2.3333333333333335	0.5773502691896258	0.24743582965269678	3	2	1
fam4899	2	3	2	2.3333333333333335	0.5773502691896258	0.24743582965269678	3	2	1
fam4900	2	3	2	2.3333333333333335	0.5773502691896258	0.24743582965269678	3	2	1
fam4901	2	2	3	2.3333333333333335	0.5773502691896258	0.24743582965269678	3	2	1
fam4902	2	3	2	2.3333333333333335	0.5773502691896258	0.24743582965269678	3	2	1
fam4903	2	2	3	2.3333333333333335	0.5773502691896258	0.24743582965269678	3	2	1
fam4904	2	2	3	2.3333333333333335	0.5773502691896258	0.24743582965269678	3	2	1
fam4905	2	3	2	2.3333333333333335	0.5773502691896258	0.24743582965269678	3	2	1
fam4906	2	2	3	2.3333333333333335	0.5773502691896258	0.24743582965269678	3	2	1
fam4907	2	3	2	2.3333333333333335	0.5773502691896258	0.24743582965269678	3	2	1
fam4908	2	3	2	2.3333333333333335	0.5773502691896258	0.24743582965269678	3	2	1
fam4909	2	3	2	2.3333333333333335	0.5773502691896258	0.24743582965269678	3	2	1
fam4910	2	2	3	2.3333333333333335	0.5773502691896258	0.24743582965269678	3	2	1
fam4911	3	2	2	2.3333333333333335	0.5773502691896258	0.24743582965269678	3	2	1
fam4912	2	3	2	2.3333333333333335	0.5773502691896258	0.24743582965269678	3	2	1
fam4913	2	2	3	2.3333333333333335	0.5773502691896258	0.24743582965269678	3	2	1
fam4914	2	3	2	2.3333333333333335	0.5773502691896258	0.24743582965269678	3	2	1
fam4915	2	3	2	2.3333333333333335	0.5773502691896258	0.24743582965269678	3	2	1
fam4916	2	3	2	2.3333333333333335	0.5773502691896258	0.24743582965269678	3	2	1
fam4917	2	3	2	2.3333333333333335	0.5773502691896258	0.24743582965269678	3	2	1
fam4918	2	3	2	2.3333333333333335	0.5773502691896258	0.24743582965269678	3	2	1
fam4919	2	3	2	2.3333333333333335	0.5773502691896258	0.24743582965269678	3	2	1
fam4920	3	2	2	2.3333333333333335	0.5773502691896258	0.24743582965269678	3	2	1
fam4921	2	2	3	2.3333333333333335	0.5773502691896258	0.24743582965269678	3	2	1
fam4922	2	2	3	2.3333333333333335	0.5773502691896258	0.24743582965269678	3	2	1
fam4923	2	3	2	2.3333333333333335	0.5773502691896258	0.24743582965269678	3	2	1
fam4924	2	2	3	2.3333333333333335	0.5773502691896258	0.24743582965269678	3	2	1
fam4925	2	3	2	2.3333333333333335	0.5773502691896258	0.24743582965269678	3	2	1
fam4926	2	3	2	2.3333333333333335	0.5773502691896258	0.24743582965269678	3	2	1
fam4927	2	3	2	2.3333333333333335	0.5773502691896258	0.24743582965269678	3	2	1
fam4928	2	3	2	2.3333333333333335	0.5773502691896258	0.24743582965269678	3	2	1
fam4929	2	3	2	2.3333333333333335	0.5773502691896258	0.24743582965269678	3	2	1
fam4930	2	3	2	2.3333333333333335	0.5773502691896258	0.24743582965269678	3	2	1
fam4931	2	3	2	2.3333333333333335	0.5773502691896258	0.24743582965269678	3	2	1
fam4932	2	3	2	2.3333333333333335	0.5773502691896258	0.24743582965269678	3	2	1
fam4933	2	3	2	2.3333333333333335	0.5773502691896258	0.24743582965269678	3	2	1
fam4934	2	2	3	2.3333333333333335	0.5773502691896258	0.24743582965269678	3	2	1
fam4935	2	2	3	2.3333333333333335	0.5773502691896258	0.24743582965269678	3	2	1
fam4936	3	2	2	2.3333333333333335	0.5773502691896258	0.24743582965269678	3	2	1
fam4937	2	2	3	2.3333333333333335	0.5773502691896258	0.24743582965269678	3	2	1
fam4938	2	3	2	2.3333333333333335	0.5773502691896258	0.24743582965269678	3	2	1
fam4939	2	3	2	2.3333333333333335	0.5773502691896258	0.24743582965269678	3	2	1
fam4940	2	3	2	2.3333333333333335	0.5773502691896258	0.24743582965269678	3	2	1
fam4941	2	3	2	2.3333333333333335	0.5773502691896258	0.24743582965269678	3	2	1
fam4942	2	3	2	2.3333333333333335	0.5773502691896258	0.24743582965269678	3	2	1
fam4943	2	3	2	2.3333333333333335	0.5773502691896258	0.24743582965269678	3	2	1
fam4944	2	3	2	2.3333333333333335	0.5773502691896258	0.24743582965269678	3	2	1
fam4945	2	2	3	2.3333333333333335	0.5773502691896258	0.24743582965269678	3	2	1
fam4946	2	3	2	2.3333333333333335	0.5773502691896258	0.24743582965269678	3	2	1
fam4947	2	2	3	2.3333333333333335	0.5773502691896258	0.24743582965269678	3	2	1
fam4948	2	3	2	2.3333333333333335	0.5773502691896258	0.24743582965269678	3	2	1
fam4949	2	2	3	2.3333333333333335	0.5773502691896258	0.24743582965269678	3	2	1
fam4950	2	2	3	2.3333333333333335	0.5773502691896258	0.24743582965269678	3	2	1
fam4951	2	3	2	2.3333333333333335	0.5773502691896258	0.24743582965269678	3	2	1
fam4952	2	3	2	2.3333333333333335	0.5773502691896258	0.24743582965269678	3	2	1
fam4953	2	2	3	2.3333333333333335	0.5773502691896258	0.24743582965269678	3	2	1
fam4954	2	3	2	2.3333333333333335	0.5773502691896258	0.24743582965269678	3	2	1
fam4955	2	2	3	2.3333333333333335	0.5773502691896258	0.24743582965269678	3	2	1
fam4956	2	3	2	2.3333333333333335	0.5773502691896258	0.24743582965269678	3	2	1
fam4957	2	3	2	2.3333333333333335	0.5773502691896258	0.24743582965269678	3	2	1
fam4958	2	2	3	2.3333333333333335	0.5773502691896258	0.24743582965269678	3	2	1
fam4959	2	3	2	2.3333333333333335	0.5773502691896258	0.24743582965269678	3	2	1
fam4960	2	3	2	2.3333333333333335	0.5773502691896258	0.24743582965269678	3	2	1
fam4961	2	3	2	2.3333333333333335	0.5773502691896258	0.24743582965269678	3	2	1
fam4962	2	3	2	2.3333333333333335	0.5773502691896258	0.24743582965269678	3	2	1
fam4963	2	2	3	2.3333333333333335	0.5773502691896258	0.24743582965269678	3	2	1
fam4964	2	3	2	2.3333333333333335	0.5773502691896258	0.24743582965269678	3	2	1
fam4965	2	2	3	2.3333333333333335	0.5773502691896258	0.24743582965269678	3	2	1
fam4966	2	3	2	2.3333333333333335	0.5773502691896258	0.24743582965269678	3	2	1
fam4967	3	2	2	2.3333333333333335	0.5773502691896258	0.24743582965269678	3	2	1
fam4968	2	2	3	2.3333333333333335	0.5773502691896258	0.24743582965269678	3	2	1
fam4969	2	2	3	2.3333333333333335	0.5773502691896258	0.24743582965269678	3	2	1
fam4970	2	2	2	2.0	0.0	0.0	2	2	0
fam4971	2	2	2	2.0	0.0	0.0	2	2	0
fam4972	2	2	2	2.0	0.0	0.0	2	2	0
fam4973	2	2	2	2.0	0.0	0.0	2	2	0
fam4974	2	2	2	2.0	0.0	0.0	2	2	0
fam4975	2	2	2	2.0	0.0	0.0	2	2	0
fam4976	2	2	2	2.0	0.0	0.0	2	2	0
fam4977	2	4	2	2.6666666666666665	1.1547005383792515	0.4330127018922193	4	2	2
fam4978	2	3	2	2.3333333333333335	0.5773502691896258	0.24743582965269678	3	2	1
fam4979	2	4	2	2.6666666666666665	1.1547005383792515	0.4330127018922193	4	2	2
fam4980	2	4	2	2.6666666666666665	1.1547005383792515	0.4330127018922193	4	2	2
fam4981	2	2	4	2.6666666666666665	1.1547005383792515	0.4330127018922193	4	2	2
fam4982	2	4	2	2.6666666666666665	1.1547005383792515	0.4330127018922193	4	2	2
fam4983	2	4	2	2.6666666666666665	1.1547005383792515	0.4330127018922193	4	2	2
fam4984	2	4	2	2.6666666666666665	1.1547005383792515	0.4330127018922193	4	2	2
fam4985	2	2	2	2.0	0.0	0.0	2	2	0
fam4986	2	2	4	2.6666666666666665	1.1547005383792515	0.4330127018922193	4	2	2
fam4987	2	4	2	2.6666666666666665	1.1547005383792515	0.4330127018922193	4	2	2
fam4988	2	4	2	2.6666666666666665	1.1547005383792515	0.4330127018922193	4	2	2
fam4989	2	4	2	2.6666666666666665	1.1547005383792515	0.4330127018922193	4	2	2
fam4990	2	2	2	2.0	0.0	0.0	2	2	0
fam4991	2	4	2	2.6666666666666665	1.1547005383792515	0.4330127018922193	4	2	2
fam4992	2	2	4	2.6666666666666665	1.1547005383792515	0.4330127018922193	4	2	2
fam4993	2	2	4	2.6666666666666665	1.1547005383792515	0.4330127018922193	4	2	2
fam4994	2	4	2	2.6666666666666665	1.1547005383792515	0.4330127018922193	4	2	2
fam4995	2	3	2	2.3333333333333335	0.5773502691896258	0.24743582965269678	3	2	1
fam4996	2	4	2	2.6666666666666665	1.1547005383792515	0.4330127018922193	4	2	2
fam4997	2	4	2	2.6666666666666665	1.1547005383792515	0.4330127018922193	4	2	2
fam4998	2	4	2	2.6666666666666665	1.1547005383792515	0.4330127018922193	4	2	2
fam4999	2	4	2	2.6666666666666665	1.1547005383792515	0.4330127018922193	4	2	2
fam5000	2	4	2	2.6666666666666665	1.1547005383792515	0.4330127018922193	4	2	2
fam5001	2	2	2	2.0	0.0	0.0	2	2	0
fam5002	2	4	2	2.6666666666666665	1.1547005383792515	0.4330127018922193	4	2	2
fam5003	2	4	2	2.6666666666666665	1.1547005383792515	0.4330127018922193	4	2	2
fam5004	2	4	2	2.6666666666666665	1.1547005383792515	0.4330127018922193	4	2	2
fam5005	2	4	2	2.6666666666666665	1.1547005383792515	0.4330127018922193	4	2	2
fam5006	2	4	2	2.6666666666666665	1.1547005383792515	0.4330127018922193	4	2	2
fam5007	2	4	2	2.6666666666666665	1.1547005383792515	0.4330127018922193	4	2	2
fam5008	4	2	2	2.6666666666666665	1.1547005383792515	0.4330127018922193	4	2	2
fam5009	2	4	2	2.6666666666666665	1.1547005383792515	0.4330127018922193	4	2	2
fam5010	2	4	2	2.6666666666666665	1.1547005383792515	0.4330127018922193	4	2	2
fam5011	2	4	2	2.6666666666666665	1.1547005383792515	0.4330127018922193	4	2	2
fam5012	2	4	2	2.6666666666666665	1.1547005383792515	0.4330127018922193	4	2	2
fam5013	2	4	2	2.6666666666666665	1.1547005383792515	0.4330127018922193	4	2	2
fam5014	2	4	2	2.6666666666666665	1.1547005383792515	0.4330127018922193	4	2	2
fam5015	2	2	4	2.6666666666666665	1.1547005383792515	0.4330127018922193	4	2	2
fam5016	2	4	2	2.6666666666666665	1.1547005383792515	0.4330127018922193	4	2	2
fam5017	2	4	2	2.6666666666666665	1.1547005383792515	0.4330127018922193	4	2	2
fam5018	2	4	2	2.6666666666666665	1.1547005383792515	0.4330127018922193	4	2	2
fam5019	2	4	2	2.6666666666666665	1.1547005383792515	0.4330127018922193	4	2	2
fam5020	2	4	2	2.6666666666666665	1.1547005383792515	0.4330127018922193	4	2	2
fam5021	2	4	2	2.6666666666666665	1.1547005383792515	0.4330127018922193	4	2	2
fam5022	2	2	4	2.6666666666666665	1.1547005383792515	0.4330127018922193	4	2	2
fam5023	2	4	2	2.6666666666666665	1.1547005383792515	0.4330127018922193	4	2	2
fam5024	2	2	2	2.0	0.0	0.0	2	2	0
fam5025	4	2	2	2.6666666666666665	1.1547005383792515	0.4330127018922193	4	2	2
fam5026	2	4	2	2.6666666666666665	1.1547005383792515	0.4330127018922193	4	2	2
fam5027	2	4	2	2.6666666666666665	1.1547005383792515	0.4330127018922193	4	2	2
fam5028	2	2	2	2.0	0.0	0.0	2	2	0
fam5029	2	4	2	2.6666666666666665	1.1547005383792515	0.4330127018922193	4	2	2
fam5030	2	3	2	2.3333333333333335	0.5773502691896258	0.24743582965269678	3	2	1
fam5031	2	2	2	2.0	0.0	0.0	2	2	0
fam5032	2	4	2	2.6666666666666665	1.1547005383792515	0.4330127018922193	4	2	2
fam5033	2	4	2	2.6666666666666665	1.1547005383792515	0.4330127018922193	4	2	2
fam5034	2	4	2	2.6666666666666665	1.1547005383792515	0.4330127018922193	4	2	2
fam5035	2	4	2	2.6666666666666665	1.1547005383792515	0.4330127018922193	4	2	2
fam5036	2	4	2	2.6666666666666665	1.1547005383792515	0.4330127018922193	4	2	2
fam5037	2	4	2	2.6666666666666665	1.1547005383792515	0.4330127018922193	4	2	2
fam5038	2	4	2	2.6666666666666665	1.1547005383792515	0.4330127018922193	4	2	2
fam5039	2	4	2	2.6666666666666665	1.1547005383792515	0.4330127018922193	4	2	2
fam5040	2	4	2	2.6666666666666665	1.1547005383792515	0.4330127018922193	4	2	2
fam5041	2	4	2	2.6666666666666665	1.1547005383792515	0.4330127018922193	4	2	2
fam5042	2	4	2	2.6666666666666665	1.1547005383792515	0.4330127018922193	4	2	2
fam5043	2	4	2	2.6666666666666665	1.1547005383792515	0.4330127018922193	4	2	2
fam5044	2	4	2	2.6666666666666665	1.1547005383792515	0.4330127018922193	4	2	2
fam5045	2	4	2	2.6666666666666665	1.1547005383792515	0.4330127018922193	4	2	2
fam5046	2	4	2	2.6666666666666665	1.1547005383792515	0.4330127018922193	4	2	2
fam5047	2	4	2	2.6666666666666665	1.1547005383792515	0.4330127018922193	4	2	2
fam5048	4	2	2	2.6666666666666665	1.1547005383792515	0.4330127018922193	4	2	2
fam5049	2	2	4	2.6666666666666665	1.1547005383792515	0.4330127018922193	4	2	2
fam5050	2	4	2	2.6666666666666665	1.1547005383792515	0.4330127018922193	4	2	2
fam5051	2	4	2	2.6666666666666665	1.1547005383792515	0.4330127018922193	4	2	2
fam5052	2	4	2	2.6666666666666665	1.1547005383792515	0.4330127018922193	4	2	2
fam5053	2	2	4	2.6666666666666665	1.1547005383792515	0.4330127018922193	4	2	2
fam5054	2	2	4	2.6666666666666665	1.1547005383792515	0.4330127018922193	4	2	2
fam5055	2	4	2	2.6666666666666665	1.1547005383792515	0.4330127018922193	4	2	2
fam5056	2	4	2	2.6666666666666665	1.1547005383792515	0.4330127018922193	4	2	2
fam5057	2	2	2	2.0	0.0	0.0	2	2	0
fam5058	2	4	2	2.6666666666666665	1.1547005383792515	0.4330127018922193	4	2	2
fam5059	2	4	2	2.6666666666666665	1.1547005383792515	0.4330127018922193	4	2	2
fam5060	4	2	2	2.6666666666666665	1.1547005383792515	0.4330127018922193	4	2	2
fam5061	2	2	2	2.0	0.0	0.0	2	2	0
fam5062	2	4	2	2.6666666666666665	1.1547005383792515	0.4330127018922193	4	2	2
fam5063	2	4	2	2.6666666666666665	1.1547005383792515	0.4330127018922193	4	2	2
fam5064	2	2	4	2.6666666666666665	1.1547005383792515	0.4330127018922193	4	2	2
fam5065	2	2	4	2.6666666666666665	1.1547005383792515	0.4330127018922193	4	2	2
fam5066	2	4	2	2.6666666666666665	1.1547005383792515	0.4330127018922193	4	2	2
fam5067	4	2	2	2.6666666666666665	1.1547005383792515	0.4330127018922193	4	2	2
fam5068	2	4	2	2.6666666666666665	1.1547005383792515	0.4330127018922193	4	2	2
fam5069	2	4	2	2.6666666666666665	1.1547005383792515	0.4330127018922193	4	2	2
fam5070	2	4	2	2.6666666666666665	1.1547005383792515	0.4330127018922193	4	2	2
fam5071	2	4	2	2.6666666666666665	1.1547005383792515	0.4330127018922193	4	2	2
fam5072	2	2	2	2.0	0.0	0.0	2	2	0
fam5073	2	4	2	2.6666666666666665	1.1547005383792515	0.4330127018922193	4	2	2
fam5074	2	4	2	2.6666666666666665	1.1547005383792515	0.4330127018922193	4	2	2
fam5075	2	2	4	2.6666666666666665	1.1547005383792515	0.4330127018922193	4	2	2
fam5076	2	4	2	2.6666666666666665	1.1547005383792515	0.4330127018922193	4	2	2
fam5077	2	4	2	2.6666666666666665	1.1547005383792515	0.4330127018922193	4	2	2
fam5078	2	4	2	2.6666666666666665	1.1547005383792515	0.4330127018922193	4	2	2
fam5079	4	2	2	2.6666666666666665	1.1547005383792515	0.4330127018922193	4	2	2
fam5080	2	3	2	2.3333333333333335	0.5773502691896258	0.24743582965269678	3	2	1
fam5081	2	4	2	2.6666666666666665	1.1547005383792515	0.4330127018922193	4	2	2
fam5082	2	4	2	2.6666666666666665	1.1547005383792515	0.4330127018922193	4	2	2
fam5083	2	4	2	2.6666666666666665	1.1547005383792515	0.4330127018922193	4	2	2
fam5084	2	4	2	2.6666666666666665	1.1547005383792515	0.4330127018922193	4	2	2
fam5085	2	2	4	2.6666666666666665	1.1547005383792515	0.4330127018922193	4	2	2
fam5086	4	2	2	2.6666666666666665	1.1547005383792515	0.4330127018922193	4	2	2
fam5087	2	2	4	2.6666666666666665	1.1547005383792515	0.4330127018922193	4	2	2
fam5088	2	4	2	2.6666666666666665	1.1547005383792515	0.4330127018922193	4	2	2
fam5089	2	4	2	2.6666666666666665	1.1547005383792515	0.4330127018922193	4	2	2
fam5090	2	4	2	2.6666666666666665	1.1547005383792515	0.4330127018922193	4	2	2
fam5091	2	4	2	2.6666666666666665	1.1547005383792515	0.4330127018922193	4	2	2
fam5092	2	4	2	2.6666666666666665	1.1547005383792515	0.4330127018922193	4	2	2
fam5093	2	4	2	2.6666666666666665	1.1547005383792515	0.4330127018922193	4	2	2
fam5094	2	4	2	2.6666666666666665	1.1547005383792515	0.4330127018922193	4	2	2
fam5095	2	2	2	2.0	0.0	0.0	2	2	0
fam5096	2	4	2	2.6666666666666665	1.1547005383792515	0.4330127018922193	4	2	2
fam5097	2	4	2	2.6666666666666665	1.1547005383792515	0.4330127018922193	4	2	2
fam5098	2	2	2	2.0	0.0	0.0	2	2	0
fam5099	2	4	2	2.6666666666666665	1.1547005383792515	0.4330127018922193	4	2	2
fam5100	2	2	2	2.0	0.0	0.0	2	2	0
fam5101	2	4	2	2.6666666666666665	1.1547005383792515	0.4330127018922193	4	2	2
fam5102	2	2	4	2.6666666666666665	1.1547005383792515	0.4330127018922193	4	2	2
fam5103	2	4	2	2.6666666666666665	1.1547005383792515	0.4330127018922193	4	2	2
fam5104	2	4	2	2.6666666666666665	1.1547005383792515	0.4330127018922193	4	2	2
fam5105	2	4	2	2.6666666666666665	1.1547005383792515	0.4330127018922193	4	2	2
fam5106	2	4	2	2.6666666666666665	1.1547005383792515	0.4330127018922193	4	2	2
fam5107	2	4	2	2.6666666666666665	1.1547005383792515	0.4330127018922193	4	2	2
fam5108	2	2	4	2.6666666666666665	1.1547005383792515	0.4330127018922193	4	2	2
fam5109	2	4	2	2.6666666666666665	1.1547005383792515	0.4330127018922193	4	2	2
fam5110	2	4	2	2.6666666666666665	1.1547005383792515	0.4330127018922193	4	2	2
fam5111	2	4	2	2.6666666666666665	1.1547005383792515	0.4330127018922193	4	2	2
fam5112	2	4	2	2.6666666666666665	1.1547005383792515	0.4330127018922193	4	2	2
fam5113	2	4	2	2.6666666666666665	1.1547005383792515	0.4330127018922193	4	2	2
fam5114	4	2	2	2.6666666666666665	1.1547005383792515	0.4330127018922193	4	2	2
fam5115	2	4	2	2.6666666666666665	1.1547005383792515	0.4330127018922193	4	2	2
fam5116	2	4	2	2.6666666666666665	1.1547005383792515	0.4330127018922193	4	2	2
fam5117	2	4	2	2.6666666666666665	1.1547005383792515	0.4330127018922193	4	2	2
fam5118	2	4	2	2.6666666666666665	1.1547005383792515	0.4330127018922193	4	2	2
fam5119	2	4	2	2.6666666666666665	1.1547005383792515	0.4330127018922193	4	2	2
fam5120	2	2	3	2.3333333333333335	0.5773502691896258	0.24743582965269678	3	2	1
fam5121	2	2	4	2.6666666666666665	1.1547005383792515	0.4330127018922193	4	2	2
fam5122	2	2	4	2.6666666666666665	1.1547005383792515	0.4330127018922193	4	2	2
fam5123	2	4	2	2.6666666666666665	1.1547005383792515	0.4330127018922193	4	2	2
fam5124	2	4	2	2.6666666666666665	1.1547005383792515	0.4330127018922193	4	2	2
fam5125	2	2	2	2.0	0.0	0.0	2	2	0
fam5126	4	2	2	2.6666666666666665	1.1547005383792515	0.4330127018922193	4	2	2
fam5127	2	4	2	2.6666666666666665	1.1547005383792515	0.4330127018922193	4	2	2
fam5128	2	2	2	2.0	0.0	0.0	2	2	0
fam5129	2	3	2	2.3333333333333335	0.5773502691896258	0.24743582965269678	3	2	1
fam5130	2	4	2	2.6666666666666665	1.1547005383792515	0.4330127018922193	4	2	2
fam5131	2	2	4	2.6666666666666665	1.1547005383792515	0.4330127018922193	4	2	2
fam5132	4	2	2	2.6666666666666665	1.1547005383792515	0.4330127018922193	4	2	2
fam5133	2	4	2	2.6666666666666665	1.1547005383792515	0.4330127018922193	4	2	2
fam5134	2	4	2	2.6666666666666665	1.1547005383792515	0.4330127018922193	4	2	2
fam5135	2	4	2	2.6666666666666665	1.1547005383792515	0.4330127018922193	4	2	2
fam5136	2	4	2	2.6666666666666665	1.1547005383792515	0.4330127018922193	4	2	2
fam5137	4	2	2	2.6666666666666665	1.1547005383792515	0.4330127018922193	4	2	2
fam5138	2	4	2	2.6666666666666665	1.1547005383792515	0.4330127018922193	4	2	2
fam5139	2	4	2	2.6666666666666665	1.1547005383792515	0.4330127018922193	4	2	2
fam5140	2	4	2	2.6666666666666665	1.1547005383792515	0.4330127018922193	4	2	2
fam5141	2	4	2	2.6666666666666665	1.1547005383792515	0.4330127018922193	4	2	2
fam5142	2	4	2	2.6666666666666665	1.1547005383792515	0.4330127018922193	4	2	2
fam5143	2	4	2	2.6666666666666665	1.1547005383792515	0.4330127018922193	4	2	2
fam5144	2	2	3	2.3333333333333335	0.5773502691896258	0.24743582965269678	3	2	1
fam5145	2	2	4	2.6666666666666665	1.1547005383792515	0.4330127018922193	4	2	2
fam5146	4	2	2	2.6666666666666665	1.1547005383792515	0.4330127018922193	4	2	2
fam5147	2	4	2	2.6666666666666665	1.1547005383792515	0.4330127018922193	4	2	2
fam5148	2	2	4	2.6666666666666665	1.1547005383792515	0.4330127018922193	4	2	2
fam5149	2	4	2	2.6666666666666665	1.1547005383792515	0.4330127018922193	4	2	2
fam5150	2	4	2	2.6666666666666665	1.1547005383792515	0.4330127018922193	4	2	2
fam5151	2	2	4	2.6666666666666665	1.1547005383792515	0.4330127018922193	4	2	2
fam5152	2	4	2	2.6666666666666665	1.1547005383792515	0.4330127018922193	4	2	2
fam5153	2	4	2	2.6666666666666665	1.1547005383792515	0.4330127018922193	4	2	2
fam5154	2	2	2	2.0	0.0	0.0	2	2	0
fam5155	2	4	2	2.6666666666666665	1.1547005383792515	0.4330127018922193	4	2	2
fam5156	2	4	2	2.6666666666666665	1.1547005383792515	0.4330127018922193	4	2	2
fam5157	2	4	2	2.6666666666666665	1.1547005383792515	0.4330127018922193	4	2	2
fam5158	2	4	2	2.6666666666666665	1.1547005383792515	0.4330127018922193	4	2	2
fam5159	4	2	2	2.6666666666666665	1.1547005383792515	0.4330127018922193	4	2	2
fam5160	2	4	2	2.6666666666666665	1.1547005383792515	0.4330127018922193	4	2	2
fam5161	2	4	2	2.6666666666666665	1.1547005383792515	0.4330127018922193	4	2	2
fam5162	2	2	2	2.0	0.0	0.0	2	2	0
fam5163	2	4	2	2.6666666666666665	1.1547005383792515	0.4330127018922193	4	2	2
fam5164	2	3	2	2.3333333333333335	0.5773502691896258	0.24743582965269678	3	2	1
fam5165	2	3	2	2.3333333333333335	0.5773502691896258	0.24743582965269678	3	2	1
fam5166	2	4	2	2.6666666666666665	1.1547005383792515	0.4330127018922193	4	2	2
fam5167	2	4	2	2.6666666666666665	1.1547005383792515	0.4330127018922193	4	2	2
fam5168	2	4	2	2.6666666666666665	1.1547005383792515	0.4330127018922193	4	2	2
fam5169	2	4	2	2.6666666666666665	1.1547005383792515	0.4330127018922193	4	2	2
fam5170	2	4	2	2.6666666666666665	1.1547005383792515	0.4330127018922193	4	2	2
fam5171	2	4	2	2.6666666666666665	1.1547005383792515	0.4330127018922193	4	2	2
fam5172	2	4	2	2.6666666666666665	1.1547005383792515	0.4330127018922193	4	2	2
fam5173	2	2	4	2.6666666666666665	1.1547005383792515	0.4330127018922193	4	2	2
fam5174	2	4	2	2.6666666666666665	1.1547005383792515	0.4330127018922193	4	2	2
fam5175	2	4	2	2.6666666666666665	1.1547005383792515	0.4330127018922193	4	2	2
fam5176	2	4	2	2.6666666666666665	1.1547005383792515	0.4330127018922193	4	2	2
fam5177	2	2	4	2.6666666666666665	1.1547005383792515	0.4330127018922193	4	2	2
fam5178	2	2	4	2.6666666666666665	1.1547005383792515	0.4330127018922193	4	2	2
fam5179	2	4	2	2.6666666666666665	1.1547005383792515	0.4330127018922193	4	2	2
fam5180	2	4	2	2.6666666666666665	1.1547005383792515	0.4330127018922193	4	2	2
fam5181	2	2	4	2.6666666666666665	1.1547005383792515	0.4330127018922193	4	2	2
fam5182	2	4	2	2.6666666666666665	1.1547005383792515	0.4330127018922193	4	2	2
fam5183	2	4	2	2.6666666666666665	1.1547005383792515	0.4330127018922193	4	2	2
fam5184	2	4	2	2.6666666666666665	1.1547005383792515	0.4330127018922193	4	2	2
fam5185	2	4	2	2.6666666666666665	1.1547005383792515	0.4330127018922193	4	2	2
fam5186	2	4	2	2.6666666666666665	1.1547005383792515	0.4330127018922193	4	2	2
fam5187	2	4	2	2.6666666666666665	1.1547005383792515	0.4330127018922193	4	2	2
fam5188	2	4	2	2.6666666666666665	1.1547005383792515	0.4330127018922193	4	2	2
fam5189	2	4	2	2.6666666666666665	1.1547005383792515	0.4330127018922193	4	2	2
fam5190	2	4	2	2.6666666666666665	1.1547005383792515	0.4330127018922193	4	2	2
fam5191	2	4	2	2.6666666666666665	1.1547005383792515	0.4330127018922193	4	2	2
fam5192	2	2	4	2.6666666666666665	1.1547005383792515	0.4330127018922193	4	2	2
fam5193	2	2	4	2.6666666666666665	1.1547005383792515	0.4330127018922193	4	2	2
fam5194	2	4	2	2.6666666666666665	1.1547005383792515	0.4330127018922193	4	2	2
fam5195	2	4	2	2.6666666666666665	1.1547005383792515	0.4330127018922193	4	2	2
fam5196	2	4	2	2.6666666666666665	1.1547005383792515	0.4330127018922193	4	2	2
fam5197	2	2	4	2.6666666666666665	1.1547005383792515	0.4330127018922193	4	2	2
fam5198	2	4	2	2.6666666666666665	1.1547005383792515	0.4330127018922193	4	2	2
fam5199	2	2	4	2.6666666666666665	1.1547005383792515	0.4330127018922193	4	2	2
fam5200	2	4	2	2.6666666666666665	1.1547005383792515	0.4330127018922193	4	2	2
fam5201	2	4	2	2.6666666666666665	1.1547005383792515	0.4330127018922193	4	2	2
fam5202	2	4	2	2.6666666666666665	1.1547005383792515	0.4330127018922193	4	2	2
fam5203	4	2	2	2.6666666666666665	1.1547005383792515	0.4330127018922193	4	2	2
fam5204	2	4	2	2.6666666666666665	1.1547005383792515	0.4330127018922193	4	2	2
fam5205	2	4	2	2.6666666666666665	1.1547005383792515	0.4330127018922193	4	2	2
fam5206	2	4	2	2.6666666666666665	1.1547005383792515	0.4330127018922193	4	2	2
fam5207	2	3	2	2.3333333333333335	0.5773502691896258	0.24743582965269678	3	2	1
fam5208	2	2	4	2.6666666666666665	1.1547005383792515	0.4330127018922193	4	2	2
fam5209	2	4	2	2.6666666666666665	1.1547005383792515	0.4330127018922193	4	2	2
fam5210	2	4	2	2.6666666666666665	1.1547005383792515	0.4330127018922193	4	2	2
fam5211	2	3	2	2.3333333333333335	0.5773502691896258	0.24743582965269678	3	2	1
fam5212	2	4	2	2.6666666666666665	1.1547005383792515	0.4330127018922193	4	2	2
fam5213	2	4	2	2.6666666666666665	1.1547005383792515	0.4330127018922193	4	2	2
fam5214	2	2	4	2.6666666666666665	1.1547005383792515	0.4330127018922193	4	2	2
fam5215	2	4	2	2.6666666666666665	1.1547005383792515	0.4330127018922193	4	2	2
fam5216	2	4	2	2.6666666666666665	1.1547005383792515	0.4330127018922193	4	2	2
fam5217	2	4	2	2.6666666666666665	1.1547005383792515	0.4330127018922193	4	2	2
fam5218	2	4	2	2.6666666666666665	1.1547005383792515	0.4330127018922193	4	2	2
fam5219	2	4	2	2.6666666666666665	1.1547005383792515	0.4330127018922193	4	2	2
fam5220	2	4	2	2.6666666666666665	1.1547005383792515	0.4330127018922193	4	2	2
fam5221	2	2	4	2.6666666666666665	1.1547005383792515	0.4330127018922193	4	2	2
fam5222	2	4	2	2.6666666666666665	1.1547005383792515	0.4330127018922193	4	2	2
fam5223	2	4	2	2.6666666666666665	1.1547005383792515	0.4330127018922193	4	2	2
fam5224	2	3	2	2.3333333333333335	0.5773502691896258	0.24743582965269678	3	2	1
fam5225	2	4	2	2.6666666666666665	1.1547005383792515	0.4330127018922193	4	2	2
fam5226	2	2	4	2.6666666666666665	1.1547005383792515	0.4330127018922193	4	2	2
fam5227	2	2	4	2.6666666666666665	1.1547005383792515	0.4330127018922193	4	2	2
fam5228	2	4	2	2.6666666666666665	1.1547005383792515	0.4330127018922193	4	2	2
fam5229	2	4	2	2.6666666666666665	1.1547005383792515	0.4330127018922193	4	2	2
fam5230	2	4	2	2.6666666666666665	1.1547005383792515	0.4330127018922193	4	2	2
fam5231	2	2	4	2.6666666666666665	1.1547005383792515	0.4330127018922193	4	2	2
fam5232	2	4	2	2.6666666666666665	1.1547005383792515	0.4330127018922193	4	2	2
fam5233	2	2	2	2.0	0.0	0.0	2	2	0
fam5234	2	4	2	2.6666666666666665	1.1547005383792515	0.4330127018922193	4	2	2
fam5235	2	2	3	2.3333333333333335	0.5773502691896258	0.24743582965269678	3	2	1
fam5236	2	4	2	2.6666666666666665	1.1547005383792515	0.4330127018922193	4	2	2
fam5237	2	4	2	2.6666666666666665	1.1547005383792515	0.4330127018922193	4	2	2
fam5238	2	2	2	2.0	0.0	0.0	2	2	0
fam5239	2	4	2	2.6666666666666665	1.1547005383792515	0.4330127018922193	4	2	2
fam5240	2	2	4	2.6666666666666665	1.1547005383792515	0.4330127018922193	4	2	2
fam5241	4	2	2	2.6666666666666665	1.1547005383792515	0.4330127018922193	4	2	2
fam5242	2	4	2	2.6666666666666665	1.1547005383792515	0.4330127018922193	4	2	2
fam5243	2	4	2	2.6666666666666665	1.1547005383792515	0.4330127018922193	4	2	2
fam5244	2	4	2	2.6666666666666665	1.1547005383792515	0.4330127018922193	4	2	2
fam5245	2	4	2	2.6666666666666665	1.1547005383792515	0.4330127018922193	4	2	2
fam5246	2	4	2	2.6666666666666665	1.1547005383792515	0.4330127018922193	4	2	2
fam5247	2	2	4	2.6666666666666665	1.1547005383792515	0.4330127018922193	4	2	2
fam5248	2	2	4	2.6666666666666665	1.1547005383792515	0.4330127018922193	4	2	2
fam5249	2	2	2	2.0	0.0	0.0	2	2	0
fam5250	2	4	2	2.6666666666666665	1.1547005383792515	0.4330127018922193	4	2	2
fam5251	2	4	2	2.6666666666666665	1.1547005383792515	0.4330127018922193	4	2	2
fam5252	2	2	4	2.6666666666666665	1.1547005383792515	0.4330127018922193	4	2	2
fam5253	2	4	2	2.6666666666666665	1.1547005383792515	0.4330127018922193	4	2	2
fam5254	2	4	2	2.6666666666666665	1.1547005383792515	0.4330127018922193	4	2	2
fam5255	2	2	4	2.6666666666666665	1.1547005383792515	0.4330127018922193	4	2	2
fam5256	2	4	2	2.6666666666666665	1.1547005383792515	0.4330127018922193	4	2	2
fam5257	2	4	2	2.6666666666666665	1.1547005383792515	0.4330127018922193	4	2	2
fam5258	2	4	2	2.6666666666666665	1.1547005383792515	0.4330127018922193	4	2	2
fam5259	2	4	2	2.6666666666666665	1.1547005383792515	0.4330127018922193	4	2	2
fam5260	2	4	2	2.6666666666666665	1.1547005383792515	0.4330127018922193	4	2	2
fam5261	2	2	4	2.6666666666666665	1.1547005383792515	0.4330127018922193	4	2	2
fam5262	2	2	4	2.6666666666666665	1.1547005383792515	0.4330127018922193	4	2	2
fam5263	2	4	2	2.6666666666666665	1.1547005383792515	0.4330127018922193	4	2	2
fam5264	2	2	2	2.0	0.0	0.0	2	2	0
fam5265	2	4	2	2.6666666666666665	1.1547005383792515	0.4330127018922193	4	2	2
fam5266	2	4	2	2.6666666666666665	1.1547005383792515	0.4330127018922193	4	2	2
fam5267	2	4	2	2.6666666666666665	1.1547005383792515	0.4330127018922193	4	2	2
fam5268	2	2	3	2.3333333333333335	0.5773502691896258	0.24743582965269678	3	2	1
fam5269	2	4	2	2.6666666666666665	1.1547005383792515	0.4330127018922193	4	2	2
fam5270	2	4	2	2.6666666666666665	1.1547005383792515	0.4330127018922193	4	2	2
fam5271	2	4	2	2.6666666666666665	1.1547005383792515	0.4330127018922193	4	2	2
fam5272	2	4	2	2.6666666666666665	1.1547005383792515	0.4330127018922193	4	2	2
fam5273	2	3	2	2.3333333333333335	0.5773502691896258	0.24743582965269678	3	2	1
fam5274	2	4	2	2.6666666666666665	1.1547005383792515	0.4330127018922193	4	2	2
fam5275	4	2	2	2.6666666666666665	1.1547005383792515	0.4330127018922193	4	2	2
fam5276	2	4	2	2.6666666666666665	1.1547005383792515	0.4330127018922193	4	2	2
fam5277	4	2	2	2.6666666666666665	1.1547005383792515	0.4330127018922193	4	2	2
fam5278	2	4	2	2.6666666666666665	1.1547005383792515	0.4330127018922193	4	2	2
fam5279	2	4	2	2.6666666666666665	1.1547005383792515	0.4330127018922193	4	2	2
fam5280	2	4	2	2.6666666666666665	1.1547005383792515	0.4330127018922193	4	2	2
fam5281	2	4	2	2.6666666666666665	1.1547005383792515	0.4330127018922193	4	2	2
fam5282	2	4	2	2.6666666666666665	1.1547005383792515	0.4330127018922193	4	2	2
fam5283	2	4	2	2.6666666666666665	1.1547005383792515	0.4330127018922193	4	2	2
fam5284	2	4	2	2.6666666666666665	1.1547005383792515	0.4330127018922193	4	2	2
fam5285	2	4	2	2.6666666666666665	1.1547005383792515	0.4330127018922193	4	2	2
fam5286	2	4	2	2.6666666666666665	1.1547005383792515	0.4330127018922193	4	2	2
fam5287	3	2	2	2.3333333333333335	0.5773502691896258	0.24743582965269678	3	2	1
fam5288	2	4	2	2.6666666666666665	1.1547005383792515	0.4330127018922193	4	2	2
fam5289	2	2	4	2.6666666666666665	1.1547005383792515	0.4330127018922193	4	2	2
fam5290	2	4	2	2.6666666666666665	1.1547005383792515	0.4330127018922193	4	2	2
fam5291	2	4	2	2.6666666666666665	1.1547005383792515	0.4330127018922193	4	2	2
fam5292	2	2	3	2.3333333333333335	0.5773502691896258	0.24743582965269678	3	2	1
fam5293	2	3	2	2.3333333333333335	0.5773502691896258	0.24743582965269678	3	2	1
fam5294	2	2	3	2.3333333333333335	0.5773502691896258	0.24743582965269678	3	2	1
fam5295	2	3	2	2.3333333333333335	0.5773502691896258	0.24743582965269678	3	2	1
fam5296	2	2	3	2.3333333333333335	0.5773502691896258	0.24743582965269678	3	2	1
fam5297	2	3	2	2.3333333333333335	0.5773502691896258	0.24743582965269678	3	2	1
fam5298	2	3	2	2.3333333333333335	0.5773502691896258	0.24743582965269678	3	2	1
fam5299	2	3	2	2.3333333333333335	0.5773502691896258	0.24743582965269678	3	2	1
fam5300	2	3	2	2.3333333333333335	0.5773502691896258	0.24743582965269678	3	2	1
fam5301	2	2	3	2.3333333333333335	0.5773502691896258	0.24743582965269678	3	2	1
fam5302	2	2	3	2.3333333333333335	0.5773502691896258	0.24743582965269678	3	2	1
fam5303	2	3	2	2.3333333333333335	0.5773502691896258	0.24743582965269678	3	2	1
fam5304	2	3	2	2.3333333333333335	0.5773502691896258	0.24743582965269678	3	2	1
fam5305	2	3	2	2.3333333333333335	0.5773502691896258	0.24743582965269678	3	2	1
fam5306	2	2	3	2.3333333333333335	0.5773502691896258	0.24743582965269678	3	2	1
fam5307	2	2	3	2.3333333333333335	0.5773502691896258	0.24743582965269678	3	2	1
fam5308	2	3	2	2.3333333333333335	0.5773502691896258	0.24743582965269678	3	2	1
fam5309	2	2	2	2.0	0.0	0.0	2	2	0
fam5310	2	2	2	2.0	0.0	0.0	2	2	0
fam5311	2	2	2	2.0	0.0	0.0	2	2	0
fam5312	2	2	2	2.0	0.0	0.0	2	2	0
fam5313	2	2	2	2.0	0.0	0.0	2	2	0
fam5314	2	3	2	2.3333333333333335	0.5773502691896258	0.24743582965269678	3	2	1
fam5315	2	3	2	2.3333333333333335	0.5773502691896258	0.24743582965269678	3	2	1
fam5316	2	3	2	2.3333333333333335	0.5773502691896258	0.24743582965269678	3	2	1
fam5317	2	3	2	2.3333333333333335	0.5773502691896258	0.24743582965269678	3	2	1
fam5318	2	3	2	2.3333333333333335	0.5773502691896258	0.24743582965269678	3	2	1
fam5319	2	2	2	2.0	0.0	0.0	2	2	0
fam5320	2	2	2	2.0	0.0	0.0	2	2	0
fam5321	2	2	2	2.0	0.0	0.0	2	2	0
fam5322	2	3	2	2.3333333333333335	0.5773502691896258	0.24743582965269678	3	2	1
fam5323	2	2	3	2.3333333333333335	0.5773502691896258	0.24743582965269678	3	2	1
fam5324	2	2	3	2.3333333333333335	0.5773502691896258	0.24743582965269678	3	2	1
fam5325	2	3	2	2.3333333333333335	0.5773502691896258	0.24743582965269678	3	2	1
fam5326	2	2	3	2.3333333333333335	0.5773502691896258	0.24743582965269678	3	2	1
fam5327	2	2	2	2.0	0.0	0.0	2	2	0
fam5328	2	2	2	2.0	0.0	0.0	2	2	0
fam5329	2	2	2	2.0	0.0	0.0	2	2	0
fam5330	2	2	2	2.0	0.0	0.0	2	2	0
fam5331	2	2	2	2.0	0.0	0.0	2	2	0
fam5332	2	2	2	2.0	0.0	0.0	2	2	0
fam5333	2	2	2	2.0	0.0	0.0	2	2	0
fam5334	2	2	2	2.0	0.0	0.0	2	2	0
fam5335	2	2	3	2.3333333333333335	0.5773502691896258	0.24743582965269678	3	2	1
fam5336	2	3	2	2.3333333333333335	0.5773502691896258	0.24743582965269678	3	2	1
fam5337	2	4	2	2.6666666666666665	1.1547005383792515	0.4330127018922193	4	2	2
fam5338	2	4	2	2.6666666666666665	1.1547005383792515	0.4330127018922193	4	2	2
fam5339	2	2	3	2.3333333333333335	0.5773502691896258	0.24743582965269678	3	2	1
fam5340	2	4	2	2.6666666666666665	1.1547005383792515	0.4330127018922193	4	2	2
fam5341	2	3	2	2.3333333333333335	0.5773502691896258	0.24743582965269678	3	2	1
fam5342	2	4	2	2.6666666666666665	1.1547005383792515	0.4330127018922193	4	2	2
fam5343	2	4	2	2.6666666666666665	1.1547005383792515	0.4330127018922193	4	2	2
fam5344	4	2	2	2.6666666666666665	1.1547005383792515	0.4330127018922193	4	2	2
fam5345	2	4	2	2.6666666666666665	1.1547005383792515	0.4330127018922193	4	2	2
fam5346	2	4	2	2.6666666666666665	1.1547005383792515	0.4330127018922193	4	2	2
fam5347	2	4	2	2.6666666666666665	1.1547005383792515	0.4330127018922193	4	2	2
fam5348	2	3	2	2.3333333333333335	0.5773502691896258	0.24743582965269678	3	2	1
fam5349	2	2	3	2.3333333333333335	0.5773502691896258	0.24743582965269678	3	2	1
fam5350	2	3	2	2.3333333333333335	0.5773502691896258	0.24743582965269678	3	2	1
fam5351	2	2	3	2.3333333333333335	0.5773502691896258	0.24743582965269678	3	2	1
fam5352	2	4	2	2.6666666666666665	1.1547005383792515	0.4330127018922193	4	2	2
fam5353	2	4	2	2.6666666666666665	1.1547005383792515	0.4330127018922193	4	2	2
fam5354	2	3	2	2.3333333333333335	0.5773502691896258	0.24743582965269678	3	2	1
fam5355	2	4	2	2.6666666666666665	1.1547005383792515	0.4330127018922193	4	2	2
fam5356	2	3	2	2.3333333333333335	0.5773502691896258	0.24743582965269678	3	2	1
fam5357	2	3	2	2.3333333333333335	0.5773502691896258	0.24743582965269678	3	2	1
fam5358	2	4	2	2.6666666666666665	1.1547005383792515	0.4330127018922193	4	2	2
fam5359	2	3	2	2.3333333333333335	0.5773502691896258	0.24743582965269678	3	2	1
fam5360	2	4	2	2.6666666666666665	1.1547005383792515	0.4330127018922193	4	2	2
fam5361	2	4	2	2.6666666666666665	1.1547005383792515	0.4330127018922193	4	2	2
fam5362	2	4	2	2.6666666666666665	1.1547005383792515	0.4330127018922193	4	2	2
fam5363	2	3	2	2.3333333333333335	0.5773502691896258	0.24743582965269678	3	2	1
fam5364	2	4	2	2.6666666666666665	1.1547005383792515	0.4330127018922193	4	2	2
fam5365	2	2	3	2.3333333333333335	0.5773502691896258	0.24743582965269678	3	2	1
fam5366	2	4	2	2.6666666666666665	1.1547005383792515	0.4330127018922193	4	2	2
fam5367	2	4	2	2.6666666666666665	1.1547005383792515	0.4330127018922193	4	2	2
fam5368	2	3	2	2.3333333333333335	0.5773502691896258	0.24743582965269678	3	2	1
fam5369	3	2	2	2.3333333333333335	0.5773502691896258	0.24743582965269678	3	2	1
fam5370	2	2	4	2.6666666666666665	1.1547005383792515	0.4330127018922193	4	2	2
fam5371	2	3	2	2.3333333333333335	0.5773502691896258	0.24743582965269678	3	2	1
fam5372	3	2	2	2.3333333333333335	0.5773502691896258	0.24743582965269678	3	2	1
fam5373	2	2	3	2.3333333333333335	0.5773502691896258	0.24743582965269678	3	2	1
fam5374	2	3	2	2.3333333333333335	0.5773502691896258	0.24743582965269678	3	2	1
fam5375	2	2	3	2.3333333333333335	0.5773502691896258	0.24743582965269678	3	2	1
fam5376	2	3	2	2.3333333333333335	0.5773502691896258	0.24743582965269678	3	2	1
fam5377	2	4	2	2.6666666666666665	1.1547005383792515	0.4330127018922193	4	2	2
fam5378	2	2	3	2.3333333333333335	0.5773502691896258	0.24743582965269678	3	2	1
fam5379	2	2	3	2.3333333333333335	0.5773502691896258	0.24743582965269678	3	2	1
fam5380	2	2	4	2.6666666666666665	1.1547005383792515	0.4330127018922193	4	2	2
fam5381	2	3	2	2.3333333333333335	0.5773502691896258	0.24743582965269678	3	2	1
fam5382	2	3	2	2.3333333333333335	0.5773502691896258	0.24743582965269678	3	2	1
fam5383	2	3	2	2.3333333333333335	0.5773502691896258	0.24743582965269678	3	2	1
fam5384	2	4	2	2.6666666666666665	1.1547005383792515	0.4330127018922193	4	2	2
fam5385	2	4	2	2.6666666666666665	1.1547005383792515	0.4330127018922193	4	2	2
fam5386	2	2	3	2.3333333333333335	0.5773502691896258	0.24743582965269678	3	2	1
fam5387	2	4	2	2.6666666666666665	1.1547005383792515	0.4330127018922193	4	2	2
fam5388	3	2	2	2.3333333333333335	0.5773502691896258	0.24743582965269678	3	2	1
fam5389	2	4	2	2.6666666666666665	1.1547005383792515	0.4330127018922193	4	2	2
fam5390	2	4	2	2.6666666666666665	1.1547005383792515	0.4330127018922193	4	2	2
fam5391	2	3	2	2.3333333333333335	0.5773502691896258	0.24743582965269678	3	2	1
fam5392	2	2	3	2.3333333333333335	0.5773502691896258	0.24743582965269678	3	2	1
fam5393	2	2	4	2.6666666666666665	1.1547005383792515	0.4330127018922193	4	2	2
fam5394	2	2	3	2.3333333333333335	0.5773502691896258	0.24743582965269678	3	2	1
fam5395	2	3	2	2.3333333333333335	0.5773502691896258	0.24743582965269678	3	2	1
fam5396	2	3	2	2.3333333333333335	0.5773502691896258	0.24743582965269678	3	2	1
fam5397	2	4	2	2.6666666666666665	1.1547005383792515	0.4330127018922193	4	2	2
fam5398	2	2	3	2.3333333333333335	0.5773502691896258	0.24743582965269678	3	2	1
fam5399	2	4	2	2.6666666666666665	1.1547005383792515	0.4330127018922193	4	2	2
fam5400	2	3	2	2.3333333333333335	0.5773502691896258	0.24743582965269678	3	2	1
fam5401	2	2	4	2.6666666666666665	1.1547005383792515	0.4330127018922193	4	2	2
fam5402	2	3	2	2.3333333333333335	0.5773502691896258	0.24743582965269678	3	2	1
fam5403	2	3	2	2.3333333333333335	0.5773502691896258	0.24743582965269678	3	2	1
fam5404	2	3	2	2.3333333333333335	0.5773502691896258	0.24743582965269678	3	2	1
fam5405	2	4	2	2.6666666666666665	1.1547005383792515	0.4330127018922193	4	2	2
fam5406	2	4	2	2.6666666666666665	1.1547005383792515	0.4330127018922193	4	2	2
fam5407	2	3	2	2.3333333333333335	0.5773502691896258	0.24743582965269678	3	2	1
fam5408	2	3	2	2.3333333333333335	0.5773502691896258	0.24743582965269678	3	2	1
fam5409	2	2	2	2.0	0.0	0.0	2	2	0
fam5410	2	3	2	2.3333333333333335	0.5773502691896258	0.24743582965269678	3	2	1
fam5411	2	4	2	2.6666666666666665	1.1547005383792515	0.4330127018922193	4	2	2
fam5412	2	4	2	2.6666666666666665	1.1547005383792515	0.4330127018922193	4	2	2
fam5413	2	2	3	2.3333333333333335	0.5773502691896258	0.24743582965269678	3	2	1
fam5414	2	3	2	2.3333333333333335	0.5773502691896258	0.24743582965269678	3	2	1
fam5415	3	2	2	2.3333333333333335	0.5773502691896258	0.24743582965269678	3	2	1
fam5416	2	4	2	2.6666666666666665	1.1547005383792515	0.4330127018922193	4	2	2
fam5417	2	4	2	2.6666666666666665	1.1547005383792515	0.4330127018922193	4	2	2
fam5418	2	4	2	2.6666666666666665	1.1547005383792515	0.4330127018922193	4	2	2
fam5419	2	2	3	2.3333333333333335	0.5773502691896258	0.24743582965269678	3	2	1
fam5420	2	3	2	2.3333333333333335	0.5773502691896258	0.24743582965269678	3	2	1
fam5421	2	4	2	2.6666666666666665	1.1547005383792515	0.4330127018922193	4	2	2
fam5422	2	4	2	2.6666666666666665	1.1547005383792515	0.4330127018922193	4	2	2
fam5423	2	2	3	2.3333333333333335	0.5773502691896258	0.24743582965269678	3	2	1
fam5424	2	2	3	2.3333333333333335	0.5773502691896258	0.24743582965269678	3	2	1
fam5425	2	4	2	2.6666666666666665	1.1547005383792515	0.4330127018922193	4	2	2
fam5426	2	3	2	2.3333333333333335	0.5773502691896258	0.24743582965269678	3	2	1
fam5427	2	4	2	2.6666666666666665	1.1547005383792515	0.4330127018922193	4	2	2
fam5428	2	3	2	2.3333333333333335	0.5773502691896258	0.24743582965269678	3	2	1
fam5429	2	4	2	2.6666666666666665	1.1547005383792515	0.4330127018922193	4	2	2
fam5430	2	2	3	2.3333333333333335	0.5773502691896258	0.24743582965269678	3	2	1
fam5431	2	3	2	2.3333333333333335	0.5773502691896258	0.24743582965269678	3	2	1
fam5432	2	3	2	2.3333333333333335	0.5773502691896258	0.24743582965269678	3	2	1
fam5433	2	3	2	2.3333333333333335	0.5773502691896258	0.24743582965269678	3	2	1
fam5434	2	2	3	2.3333333333333335	0.5773502691896258	0.24743582965269678	3	2	1
fam5435	2	3	2	2.3333333333333335	0.5773502691896258	0.24743582965269678	3	2	1
fam5436	2	3	2	2.3333333333333335	0.5773502691896258	0.24743582965269678	3	2	1
fam5437	2	3	2	2.3333333333333335	0.5773502691896258	0.24743582965269678	3	2	1
fam5438	2	2	2	2.0	0.0	0.0	2	2	0
fam5439	2	3	2	2.3333333333333335	0.5773502691896258	0.24743582965269678	3	2	1
fam5440	2	3	2	2.3333333333333335	0.5773502691896258	0.24743582965269678	3	2	1
fam5441	2	2	3	2.3333333333333335	0.5773502691896258	0.24743582965269678	3	2	1
fam5442	2	3	2	2.3333333333333335	0.5773502691896258	0.24743582965269678	3	2	1
fam5443	2	3	2	2.3333333333333335	0.5773502691896258	0.24743582965269678	3	2	1
fam5444	2	2	3	2.3333333333333335	0.5773502691896258	0.24743582965269678	3	2	1
fam5445	2	3	2	2.3333333333333335	0.5773502691896258	0.24743582965269678	3	2	1
fam5446	2	4	2	2.6666666666666665	1.1547005383792515	0.4330127018922193	4	2	2
fam5447	2	2	2	2.0	0.0	0.0	2	2	0
fam5448	2	2	2	2.0	0.0	0.0	2	2	0
fam5449	2	2	2	2.0	0.0	0.0	2	2	0
fam5450	2	3	2	2.3333333333333335	0.5773502691896258	0.24743582965269678	3	2	1
fam5451	2	3	2	2.3333333333333335	0.5773502691896258	0.24743582965269678	3	2	1
fam5452	2	3	2	2.3333333333333335	0.5773502691896258	0.24743582965269678	3	2	1
fam5453	2	3	2	2.3333333333333335	0.5773502691896258	0.24743582965269678	3	2	1
fam5454	2	3	2	2.3333333333333335	0.5773502691896258	0.24743582965269678	3	2	1
fam5455	2	2	3	2.3333333333333335	0.5773502691896258	0.24743582965269678	3	2	1
fam5456	2	3	2	2.3333333333333335	0.5773502691896258	0.24743582965269678	3	2	1
fam5457	2	2	3	2.3333333333333335	0.5773502691896258	0.24743582965269678	3	2	1
fam5458	2	4	2	2.6666666666666665	1.1547005383792515	0.4330127018922193	4	2	2
fam5459	2	2	2	2.0	0.0	0.0	2	2	0
fam5460	2	2	2	2.0	0.0	0.0	2	2	0
fam5461	2	3	2	2.3333333333333335	0.5773502691896258	0.24743582965269678	3	2	1
fam5462	2	2	2	2.0	0.0	0.0	2	2	0
fam5463	2	2	2	2.0	0.0	0.0	2	2	0
fam5464	2	2	2	2.0	0.0	0.0	2	2	0
fam5465	2	2	2	2.0	0.0	0.0	2	2	0
fam5466	2	3	2	2.3333333333333335	0.5773502691896258	0.24743582965269678	3	2	1
fam5467	2	2	2	2.0	0.0	0.0	2	2	0
fam5468	2	3	2	2.3333333333333335	0.5773502691896258	0.24743582965269678	3	2	1
fam5469	2	2	2	2.0	0.0	0.0	2	2	0
fam5470	2	2	2	2.0	0.0	0.0	2	2	0
fam5471	2	2	3	2.3333333333333335	0.5773502691896258	0.24743582965269678	3	2	1
fam5472	2	2	3	2.3333333333333335	0.5773502691896258	0.24743582965269678	3	2	1
fam5473	2	2	2	2.0	0.0	0.0	2	2	0
fam5474	2	2	2	2.0	0.0	0.0	2	2	0
fam5475	2	2	2	2.0	0.0	0.0	2	2	0
fam5476	2	3	2	2.3333333333333335	0.5773502691896258	0.24743582965269678	3	2	1
fam5477	2	2	2	2.0	0.0	0.0	2	2	0
fam5478	2	3	2	2.3333333333333335	0.5773502691896258	0.24743582965269678	3	2	1
fam5479	3	2	2	2.3333333333333335	0.5773502691896258	0.24743582965269678	3	2	1
fam5480	2	2	4	2.6666666666666665	1.1547005383792515	0.4330127018922193	4	2	2
fam5481	2	4	2	2.6666666666666665	1.1547005383792515	0.4330127018922193	4	2	2
fam5482	2	2	2	2.0	0.0	0.0	2	2	0
fam5483	2	2	2	2.0	0.0	0.0	2	2	0
fam5484	3	2	2	2.3333333333333335	0.5773502691896258	0.24743582965269678	3	2	1
fam5485	3	2	2	2.3333333333333335	0.5773502691896258	0.24743582965269678	3	2	1
fam5486	2	2	2	2.0	0.0	0.0	2	2	0
fam5487	2	3	2	2.3333333333333335	0.5773502691896258	0.24743582965269678	3	2	1
fam5488	2	2	3	2.3333333333333335	0.5773502691896258	0.24743582965269678	3	2	1
fam5489	2	3	2	2.3333333333333335	0.5773502691896258	0.24743582965269678	3	2	1
fam5490	2	2	3	2.3333333333333335	0.5773502691896258	0.24743582965269678	3	2	1
fam5491	2	3	2	2.3333333333333335	0.5773502691896258	0.24743582965269678	3	2	1
fam5492	2	3	2	2.3333333333333335	0.5773502691896258	0.24743582965269678	3	2	1
fam5493	2	2	4	2.6666666666666665	1.1547005383792515	0.4330127018922193	4	2	2
fam5494	2	2	2	2.0	0.0	0.0	2	2	0
fam5495	2	2	3	2.3333333333333335	0.5773502691896258	0.24743582965269678	3	2	1
fam5496	2	4	2	2.6666666666666665	1.1547005383792515	0.4330127018922193	4	2	2
fam5497	2	2	3	2.3333333333333335	0.5773502691896258	0.24743582965269678	3	2	1
fam5498	2	2	2	2.0	0.0	0.0	2	2	0
fam5499	2	2	2	2.0	0.0	0.0	2	2	0
fam5500	2	2	2	2.0	0.0	0.0	2	2	0
fam5501	2	2	2	2.0	0.0	0.0	2	2	0
fam5502	2	2	2	2.0	0.0	0.0	2	2	0
fam5503	2	2	2	2.0	0.0	0.0	2	2	0
fam5504	2	2	2	2.0	0.0	0.0	2	2	0
fam5505	2	2	2	2.0	0.0	0.0	2	2	0
fam5506	2	2	2	2.0	0.0	0.0	2	2	0
fam5507	2	2	2	2.0	0.0	0.0	2	2	0
fam5508	2	2	2	2.0	0.0	0.0	2	2	0
fam5509	2	2	2	2.0	0.0	0.0	2	2	0
fam5510	2	2	2	2.0	0.0	0.0	2	2	0
fam5511	2	2	2	2.0	0.0	0.0	2	2	0
fam5512	2	2	2	2.0	0.0	0.0	2	2	0
fam5513	2	2	2	2.0	0.0	0.0	2	2	0
fam5514	2	2	2	2.0	0.0	0.0	2	2	0
fam5515	2	2	2	2.0	0.0	0.0	2	2	0
fam5516	2	2	2	2.0	0.0	0.0	2	2	0
fam5517	2	2	2	2.0	0.0	0.0	2	2	0
fam5518	2	2	2	2.0	0.0	0.0	2	2	0
fam5519	2	2	2	2.0	0.0	0.0	2	2	0
fam5520	2	2	2	2.0	0.0	0.0	2	2	0
fam5521	2	2	2	2.0	0.0	0.0	2	2	0
fam5522	2	2	2	2.0	0.0	0.0	2	2	0
fam5523	2	2	2	2.0	0.0	0.0	2	2	0
fam5524	2	2	2	2.0	0.0	0.0	2	2	0
fam5525	2	2	2	2.0	0.0	0.0	2	2	0
fam5526	2	2	2	2.0	0.0	0.0	2	2	0
fam5527	2	2	2	2.0	0.0	0.0	2	2	0
fam5528	2	2	2	2.0	0.0	0.0	2	2	0
fam5529	2	2	2	2.0	0.0	0.0	2	2	0
fam5530	2	2	2	2.0	0.0	0.0	2	2	0
fam5531	2	2	2	2.0	0.0	0.0	2	2	0
fam5532	2	2	2	2.0	0.0	0.0	2	2	0
fam5533	2	2	2	2.0	0.0	0.0	2	2	0
fam5534	2	2	2	2.0	0.0	0.0	2	2	0
fam5535	2	2	2	2.0	0.0	0.0	2	2	0
fam5536	2	2	2	2.0	0.0	0.0	2	2	0
fam5537	2	2	2	2.0	0.0	0.0	2	2	0
fam5538	2	2	2	2.0	0.0	0.0	2	2	0
fam5539	2	2	2	2.0	0.0	0.0	2	2	0
fam5540	2	2	2	2.0	0.0	0.0	2	2	0
fam5541	2	2	2	2.0	0.0	0.0	2	2	0
fam5542	2	2	2	2.0	0.0	0.0	2	2	0
fam5543	2	2	2	2.0	0.0	0.0	2	2	0
fam5544	2	2	2	2.0	0.0	0.0	2	2	0
fam5545	2	2	2	2.0	0.0	0.0	2	2	0
fam5546	2	2	2	2.0	0.0	0.0	2	2	0
fam5547	2	2	2	2.0	0.0	0.0	2	2	0
fam5548	2	2	2	2.0	0.0	0.0	2	2	0
fam5549	2	2	2	2.0	0.0	0.0	2	2	0
fam5550	2	2	2	2.0	0.0	0.0	2	2	0
fam5551	2	2	2	2.0	0.0	0.0	2	2	0
fam5552	2	2	2	2.0	0.0	0.0	2	2	0
fam5553	2	2	2	2.0	0.0	0.0	2	2	0
fam5554	2	2	2	2.0	0.0	0.0	2	2	0
fam5555	2	2	2	2.0	0.0	0.0	2	2	0
fam5556	2	2	2	2.0	0.0	0.0	2	2	0
fam5557	2	2	2	2.0	0.0	0.0	2	2	0
fam5558	2	2	2	2.0	0.0	0.0	2	2	0
fam5559	2	2	2	2.0	0.0	0.0	2	2	0
fam5560	2	2	2	2.0	0.0	0.0	2	2	0
fam5561	2	2	2	2.0	0.0	0.0	2	2	0
fam5562	2	2	2	2.0	0.0	0.0	2	2	0
fam5563	2	2	2	2.0	0.0	0.0	2	2	0
fam5564	2	2	2	2.0	0.0	0.0	2	2	0
fam5565	2	2	2	2.0	0.0	0.0	2	2	0
fam5566	2	2	2	2.0	0.0	0.0	2	2	0
fam5567	2	2	2	2.0	0.0	0.0	2	2	0
fam5568	2	2	2	2.0	0.0	0.0	2	2	0
fam5569	2	2	2	2.0	0.0	0.0	2	2	0
fam5570	2	2	2	2.0	0.0	0.0	2	2	0
fam5571	2	2	2	2.0	0.0	0.0	2	2	0
fam5572	2	2	2	2.0	0.0	0.0	2	2	0
fam5573	2	2	2	2.0	0.0	0.0	2	2	0
fam5574	2	2	2	2.0	0.0	0.0	2	2	0
fam5575	2	2	2	2.0	0.0	0.0	2	2	0
fam5576	2	2	2	2.0	0.0	0.0	2	2	0
fam5577	2	2	2	2.0	0.0	0.0	2	2	0
fam5578	2	2	2	2.0	0.0	0.0	2	2	0
fam5579	2	2	2	2.0	0.0	0.0	2	2	0
fam5580	2	2	2	2.0	0.0	0.0	2	2	0
fam5581	2	2	2	2.0	0.0	0.0	2	2	0
fam5582	2	2	2	2.0	0.0	0.0	2	2	0
fam5583	2	2	2	2.0	0.0	0.0	2	2	0
fam5584	2	2	2	2.0	0.0	0.0	2	2	0
fam5585	2	2	2	2.0	0.0	0.0	2	2	0
fam5586	2	2	2	2.0	0.0	0.0	2	2	0
fam5587	2	2	2	2.0	0.0	0.0	2	2	0
fam5588	2	2	2	2.0	0.0	0.0	2	2	0
fam5589	2	2	2	2.0	0.0	0.0	2	2	0
fam5590	2	2	2	2.0	0.0	0.0	2	2	0
fam5591	2	2	2	2.0	0.0	0.0	2	2	0
fam5592	2	2	2	2.0	0.0	0.0	2	2	0
fam5593	2	2	2	2.0	0.0	0.0	2	2	0
fam5594	2	2	2	2.0	0.0	0.0	2	2	0
fam5595	2	2	2	2.0	0.0	0.0	2	2	0
fam5596	2	2	2	2.0	0.0	0.0	2	2	0
fam5597	2	2	2	2.0	0.0	0.0	2	2	0
fam5598	2	2	2	2.0	0.0	0.0	2	2	0
fam5599	2	2	2	2.0	0.0	0.0	2	2	0
fam5600	2	2	2	2.0	0.0	0.0	2	2	0
fam5601	2	2	2	2.0	0.0	0.0	2	2	0
fam5602	2	2	2	2.0	0.0	0.0	2	2	0
fam5603	2	2	2	2.0	0.0	0.0	2	2	0
fam5604	2	2	2	2.0	0.0	0.0	2	2	0
fam5605	2	2	2	2.0	0.0	0.0	2	2	0
fam5606	2	2	2	2.0	0.0	0.0	2	2	0
fam5607	2	2	2	2.0	0.0	0.0	2	2	0
fam5608	2	2	2	2.0	0.0	0.0	2	2	0
fam5609	2	2	2	2.0	0.0	0.0	2	2	0
fam5610	2	2	2	2.0	0.0	0.0	2	2	0
fam5611	2	2	2	2.0	0.0	0.0	2	2	0
fam5612	2	2	2	2.0	0.0	0.0	2	2	0
fam5613	2	2	2	2.0	0.0	0.0	2	2	0
fam5614	2	2	2	2.0	0.0	0.0	2	2	0
fam5615	2	2	2	2.0	0.0	0.0	2	2	0
fam5616	2	2	2	2.0	0.0	0.0	2	2	0
fam5617	2	2	2	2.0	0.0	0.0	2	2	0
fam5618	2	2	2	2.0	0.0	0.0	2	2	0
fam5619	2	2	2	2.0	0.0	0.0	2	2	0
fam5620	2	2	2	2.0	0.0	0.0	2	2	0
fam5621	2	2	2	2.0	0.0	0.0	2	2	0
fam5622	2	2	2	2.0	0.0	0.0	2	2	0
fam5623	2	2	2	2.0	0.0	0.0	2	2	0
fam5624	2	2	2	2.0	0.0	0.0	2	2	0
fam5625	2	2	2	2.0	0.0	0.0	2	2	0
fam5626	2	2	2	2.0	0.0	0.0	2	2	0
fam5627	2	2	2	2.0	0.0	0.0	2	2	0
fam5628	2	2	2	2.0	0.0	0.0	2	2	0
fam5629	2	2	2	2.0	0.0	0.0	2	2	0
fam5630	2	2	2	2.0	0.0	0.0	2	2	0
fam5631	2	2	2	2.0	0.0	0.0	2	2	0
fam5632	2	2	2	2.0	0.0	0.0	2	2	0
fam5633	2	2	2	2.0	0.0	0.0	2	2	0
fam5634	2	2	2	2.0	0.0	0.0	2	2	0
fam5635	2	2	2	2.0	0.0	0.0	2	2	0
fam5636	2	2	2	2.0	0.0	0.0	2	2	0
fam5637	2	2	2	2.0	0.0	0.0	2	2	0
fam5638	2	2	2	2.0	0.0	0.0	2	2	0
fam5639	2	2	2	2.0	0.0	0.0	2	2	0
fam5640	2	2	2	2.0	0.0	0.0	2	2	0
fam5641	2	2	2	2.0	0.0	0.0	2	2	0
fam5642	2	2	2	2.0	0.0	0.0	2	2	0
fam5643	2	2	2	2.0	0.0	0.0	2	2	0
fam5644	2	2	2	2.0	0.0	0.0	2	2	0
fam5645	2	2	2	2.0	0.0	0.0	2	2	0
fam5646	2	2	2	2.0	0.0	0.0	2	2	0
fam5647	2	2	2	2.0	0.0	0.0	2	2	0
fam5648	2	2	2	2.0	0.0	0.0	2	2	0
fam5649	2	2	2	2.0	0.0	0.0	2	2	0
fam5650	2	2	2	2.0	0.0	0.0	2	2	0
fam5651	2	2	2	2.0	0.0	0.0	2	2	0
fam5652	2	2	2	2.0	0.0	0.0	2	2	0
fam5653	2	2	2	2.0	0.0	0.0	2	2	0
fam5654	2	2	2	2.0	0.0	0.0	2	2	0
fam5655	2	2	2	2.0	0.0	0.0	2	2	0
fam5656	2	2	2	2.0	0.0	0.0	2	2	0
fam5657	2	2	2	2.0	0.0	0.0	2	2	0
fam5658	2	2	2	2.0	0.0	0.0	2	2	0
fam5659	2	2	2	2.0	0.0	0.0	2	2	0
fam5660	2	2	2	2.0	0.0	0.0	2	2	0
fam5661	2	2	2	2.0	0.0	0.0	2	2	0
fam5662	2	2	2	2.0	0.0	0.0	2	2	0
fam5663	2	2	2	2.0	0.0	0.0	2	2	0
fam5664	2	2	2	2.0	0.0	0.0	2	2	0
fam5665	2	2	2	2.0	0.0	0.0	2	2	0
fam5666	2	2	2	2.0	0.0	0.0	2	2	0
fam5667	2	2	2	2.0	0.0	0.0	2	2	0
fam5668	2	2	2	2.0	0.0	0.0	2	2	0
fam5669	2	2	2	2.0	0.0	0.0	2	2	0
fam5670	2	2	2	2.0	0.0	0.0	2	2	0
fam5671	2	2	2	2.0	0.0	0.0	2	2	0
fam5672	2	2	2	2.0	0.0	0.0	2	2	0
fam5673	2	2	2	2.0	0.0	0.0	2	2	0
fam5674	2	2	2	2.0	0.0	0.0	2	2	0
fam5675	2	2	2	2.0	0.0	0.0	2	2	0
fam5676	2	2	2	2.0	0.0	0.0	2	2	0
fam5677	2	2	2	2.0	0.0	0.0	2	2	0
fam5678	2	2	2	2.0	0.0	0.0	2	2	0
fam5679	2	2	2	2.0	0.0	0.0	2	2	0
fam5680	2	2	2	2.0	0.0	0.0	2	2	0
fam5681	2	2	2	2.0	0.0	0.0	2	2	0
fam5682	2	2	2	2.0	0.0	0.0	2	2	0
fam5683	2	2	2	2.0	0.0	0.0	2	2	0
fam5684	2	2	2	2.0	0.0	0.0	2	2	0
fam5685	2	2	2	2.0	0.0	0.0	2	2	0
fam5686	2	2	2	2.0	0.0	0.0	2	2	0
fam5687	2	2	2	2.0	0.0	0.0	2	2	0
fam5688	2	2	2	2.0	0.0	0.0	2	2	0
fam5689	2	2	2	2.0	0.0	0.0	2	2	0
fam5690	2	2	2	2.0	0.0	0.0	2	2	0
fam5691	2	2	2	2.0	0.0	0.0	2	2	0
fam5692	2	2	2	2.0	0.0	0.0	2	2	0
fam5693	2	2	2	2.0	0.0	0.0	2	2	0
fam5694	2	2	2	2.0	0.0	0.0	2	2	0
fam5695	2	2	2	2.0	0.0	0.0	2	2	0
fam5696	2	2	2	2.0	0.0	0.0	2	2	0
fam5697	2	2	2	2.0	0.0	0.0	2	2	0
fam5698	2	2	2	2.0	0.0	0.0	2	2	0
fam5699	2	2	2	2.0	0.0	0.0	2	2	0
fam5700	2	2	2	2.0	0.0	0.0	2	2	0
fam5701	2	2	2	2.0	0.0	0.0	2	2	0
fam5702	2	2	2	2.0	0.0	0.0	2	2	0
fam5703	2	2	2	2.0	0.0	0.0	2	2	0
fam5704	2	2	2	2.0	0.0	0.0	2	2	0
fam5705	2	2	2	2.0	0.0	0.0	2	2	0
fam5706	2	2	2	2.0	0.0	0.0	2	2	0
fam5707	2	2	2	2.0	0.0	0.0	2	2	0
fam5708	2	2	2	2.0	0.0	0.0	2	2	0
fam5709	2	2	2	2.0	0.0	0.0	2	2	0
fam5710	2	2	2	2.0	0.0	0.0	2	2	0
fam5711	2	2	2	2.0	0.0	0.0	2	2	0
fam5712	2	2	2	2.0	0.0	0.0	2	2	0
fam5713	2	2	2	2.0	0.0	0.0	2	2	0
fam5714	2	2	2	2.0	0.0	0.0	2	2	0
fam5715	2	2	2	2.0	0.0	0.0	2	2	0
fam5716	2	2	2	2.0	0.0	0.0	2	2	0
fam5717	2	2	2	2.0	0.0	0.0	2	2	0
fam5718	2	2	2	2.0	0.0	0.0	2	2	0
fam5719	2	2	2	2.0	0.0	0.0	2	2	0
fam5720	2	2	2	2.0	0.0	0.0	2	2	0
fam5721	2	2	2	2.0	0.0	0.0	2	2	0
fam5722	2	2	2	2.0	0.0	0.0	2	2	0
fam5723	2	2	2	2.0	0.0	0.0	2	2	0
fam5724	2	2	2	2.0	0.0	0.0	2	2	0
fam5725	2	2	2	2.0	0.0	0.0	2	2	0
fam5726	2	2	2	2.0	0.0	0.0	2	2	0
fam5727	2	2	2	2.0	0.0	0.0	2	2	0
fam5728	2	2	2	2.0	0.0	0.0	2	2	0
fam5729	2	2	2	2.0	0.0	0.0	2	2	0
fam5730	2	2	2	2.0	0.0	0.0	2	2	0
fam5731	2	2	2	2.0	0.0	0.0	2	2	0
fam5732	2	2	2	2.0	0.0	0.0	2	2	0
fam5733	2	2	2	2.0	0.0	0.0	2	2	0
fam5734	2	2	2	2.0	0.0	0.0	2	2	0
fam5735	2	2	2	2.0	0.0	0.0	2	2	0
fam5736	2	2	2	2.0	0.0	0.0	2	2	0
fam5737	2	2	2	2.0	0.0	0.0	2	2	0
fam5738	2	2	2	2.0	0.0	0.0	2	2	0
fam5739	2	2	2	2.0	0.0	0.0	2	2	0
fam5740	2	2	2	2.0	0.0	0.0	2	2	0
fam5741	2	2	2	2.0	0.0	0.0	2	2	0
fam5742	2	2	2	2.0	0.0	0.0	2	2	0
fam5743	2	2	2	2.0	0.0	0.0	2	2	0
fam5744	2	2	2	2.0	0.0	0.0	2	2	0
fam5745	2	2	2	2.0	0.0	0.0	2	2	0
fam5746	2	2	2	2.0	0.0	0.0	2	2	0
fam5747	2	2	2	2.0	0.0	0.0	2	2	0
fam5748	2	2	2	2.0	0.0	0.0	2	2	0
fam5749	2	2	2	2.0	0.0	0.0	2	2	0
fam5750	2	2	2	2.0	0.0	0.0	2	2	0
fam5751	2	2	2	2.0	0.0	0.0	2	2	0
fam5752	2	2	2	2.0	0.0	0.0	2	2	0
fam5753	2	2	2	2.0	0.0	0.0	2	2	0
fam5754	2	2	2	2.0	0.0	0.0	2	2	0
fam5755	2	2	2	2.0	0.0	0.0	2	2	0
fam5756	2	2	2	2.0	0.0	0.0	2	2	0
fam5757	2	2	2	2.0	0.0	0.0	2	2	0
fam5758	2	2	2	2.0	0.0	0.0	2	2	0
fam5759	2	2	2	2.0	0.0	0.0	2	2	0
fam5760	2	2	2	2.0	0.0	0.0	2	2	0
fam5761	2	2	2	2.0	0.0	0.0	2	2	0
fam5762	2	2	2	2.0	0.0	0.0	2	2	0
fam5763	2	2	2	2.0	0.0	0.0	2	2	0
fam5764	2	2	2	2.0	0.0	0.0	2	2	0
fam5765	2	2	2	2.0	0.0	0.0	2	2	0
fam5766	2	2	2	2.0	0.0	0.0	2	2	0
fam5767	2	2	2	2.0	0.0	0.0	2	2	0
fam5768	2	2	2	2.0	0.0	0.0	2	2	0
fam5769	2	2	2	2.0	0.0	0.0	2	2	0
fam5770	2	2	2	2.0	0.0	0.0	2	2	0
fam5771	2	2	2	2.0	0.0	0.0	2	2	0
fam5772	2	2	2	2.0	0.0	0.0	2	2	0
fam5773	2	2	2	2.0	0.0	0.0	2	2	0
fam5774	2	2	2	2.0	0.0	0.0	2	2	0
fam5775	2	2	2	2.0	0.0	0.0	2	2	0
fam5776	2	2	2	2.0	0.0	0.0	2	2	0
fam5777	2	2	2	2.0	0.0	0.0	2	2	0
fam5778	2	2	2	2.0	0.0	0.0	2	2	0
fam5779	2	2	2	2.0	0.0	0.0	2	2	0
fam5780	2	2	2	2.0	0.0	0.0	2	2	0
fam5781	2	2	2	2.0	0.0	0.0	2	2	0
fam5782	2	2	2	2.0	0.0	0.0	2	2	0
fam5783	2	2	2	2.0	0.0	0.0	2	2	0
fam5784	2	2	2	2.0	0.0	0.0	2	2	0
fam5785	2	2	2	2.0	0.0	0.0	2	2	0
fam5786	2	2	2	2.0	0.0	0.0	2	2	0
fam5787	2	2	2	2.0	0.0	0.0	2	2	0
fam5788	2	2	2	2.0	0.0	0.0	2	2	0
fam5789	2	2	2	2.0	0.0	0.0	2	2	0
fam5790	2	2	2	2.0	0.0	0.0	2	2	0
fam5791	2	2	2	2.0	0.0	0.0	2	2	0
fam5792	2	2	2	2.0	0.0	0.0	2	2	0
fam5793	2	2	2	2.0	0.0	0.0	2	2	0
fam5794	2	2	2	2.0	0.0	0.0	2	2	0
fam5795	2	2	2	2.0	0.0	0.0	2	2	0
fam5796	2	2	2	2.0	0.0	0.0	2	2	0
fam5797	2	2	2	2.0	0.0	0.0	2	2	0
fam5798	2	2	2	2.0	0.0	0.0	2	2	0
fam5799	2	2	2	2.0	0.0	0.0	2	2	0
fam5800	2	2	2	2.0	0.0	0.0	2	2	0
fam5801	2	2	2	2.0	0.0	0.0	2	2	0
fam5802	2	2	2	2.0	0.0	0.0	2	2	0
fam5803	2	2	2	2.0	0.0	0.0	2	2	0
fam5804	2	2	2	2.0	0.0	0.0	2	2	0
fam5805	2	2	2	2.0	0.0	0.0	2	2	0
fam5806	2	2	2	2.0	0.0	0.0	2	2	0
fam5807	2	2	2	2.0	0.0	0.0	2	2	0
fam5808	2	2	2	2.0	0.0	0.0	2	2	0
fam5809	2	2	2	2.0	0.0	0.0	2	2	0
fam5810	2	2	2	2.0	0.0	0.0	2	2	0
fam5811	2	2	2	2.0	0.0	0.0	2	2	0
fam5812	2	2	2	2.0	0.0	0.0	2	2	0
fam5813	2	2	2	2.0	0.0	0.0	2	2	0
fam5814	2	2	2	2.0	0.0	0.0	2	2	0
fam5815	2	2	2	2.0	0.0	0.0	2	2	0
fam5816	2	2	2	2.0	0.0	0.0	2	2	0
fam5817	2	2	2	2.0	0.0	0.0	2	2	0
fam5818	2	2	2	2.0	0.0	0.0	2	2	0
fam5819	2	2	2	2.0	0.0	0.0	2	2	0
fam5820	2	2	2	2.0	0.0	0.0	2	2	0
fam5821	2	2	2	2.0	0.0	0.0	2	2	0
fam5822	2	2	2	2.0	0.0	0.0	2	2	0
fam5823	2	2	2	2.0	0.0	0.0	2	2	0
fam5824	2	2	2	2.0	0.0	0.0	2	2	0
fam5825	2	2	2	2.0	0.0	0.0	2	2	0
fam5826	2	2	2	2.0	0.0	0.0	2	2	0
fam5827	2	2	2	2.0	0.0	0.0	2	2	0
fam5828	2	2	2	2.0	0.0	0.0	2	2	0
fam5829	2	2	2	2.0	0.0	0.0	2	2	0
fam5830	2	2	2	2.0	0.0	0.0	2	2	0
fam5831	2	2	2	2.0	0.0	0.0	2	2	0
fam5832	2	2	2	2.0	0.0	0.0	2	2	0
fam5833	2	2	2	2.0	0.0	0.0	2	2	0
fam5834	2	2	2	2.0	0.0	0.0	2	2	0
fam5835	2	2	2	2.0	0.0	0.0	2	2	0
fam5836	2	2	2	2.0	0.0	0.0	2	2	0
fam5837	2	2	2	2.0	0.0	0.0	2	2	0
fam5838	2	2	2	2.0	0.0	0.0	2	2	0
fam5839	2	2	2	2.0	0.0	0.0	2	2	0
fam5840	2	2	2	2.0	0.0	0.0	2	2	0
fam5841	2	2	2	2.0	0.0	0.0	2	2	0
fam5842	2	2	2	2.0	0.0	0.0	2	2	0
fam5843	2	2	2	2.0	0.0	0.0	2	2	0
fam5844	2	2	2	2.0	0.0	0.0	2	2	0
fam5845	2	2	2	2.0	0.0	0.0	2	2	0
fam5846	2	2	2	2.0	0.0	0.0	2	2	0
fam5847	2	2	2	2.0	0.0	0.0	2	2	0
fam5848	2	2	2	2.0	0.0	0.0	2	2	0
fam5849	2	2	2	2.0	0.0	0.0	2	2	0
fam5850	2	2	2	2.0	0.0	0.0	2	2	0
fam5851	2	2	2	2.0	0.0	0.0	2	2	0
fam5852	2	2	2	2.0	0.0	0.0	2	2	0
fam5853	2	2	2	2.0	0.0	0.0	2	2	0
fam5854	2	2	2	2.0	0.0	0.0	2	2	0
fam5855	2	2	2	2.0	0.0	0.0	2	2	0
fam5856	2	2	2	2.0	0.0	0.0	2	2	0
fam5857	2	2	2	2.0	0.0	0.0	2	2	0
fam5858	2	2	2	2.0	0.0	0.0	2	2	0
fam5859	2	2	2	2.0	0.0	0.0	2	2	0
fam5860	2	2	2	2.0	0.0	0.0	2	2	0
fam5861	2	2	2	2.0	0.0	0.0	2	2	0
fam5862	2	2	2	2.0	0.0	0.0	2	2	0
fam5863	2	2	2	2.0	0.0	0.0	2	2	0
fam5864	2	2	2	2.0	0.0	0.0	2	2	0
fam5865	2	2	2	2.0	0.0	0.0	2	2	0
fam5866	2	2	2	2.0	0.0	0.0	2	2	0
fam5867	2	2	2	2.0	0.0	0.0	2	2	0
fam5868	2	2	2	2.0	0.0	0.0	2	2	0
fam5869	2	2	2	2.0	0.0	0.0	2	2	0
fam5870	2	2	2	2.0	0.0	0.0	2	2	0
fam5871	2	2	2	2.0	0.0	0.0	2	2	0
fam5872	2	2	2	2.0	0.0	0.0	2	2	0
fam5873	2	2	2	2.0	0.0	0.0	2	2	0
fam5874	2	2	2	2.0	0.0	0.0	2	2	0
fam5875	2	2	2	2.0	0.0	0.0	2	2	0
fam5876	2	2	2	2.0	0.0	0.0	2	2	0
fam5877	2	2	2	2.0	0.0	0.0	2	2	0
fam5878	2	2	2	2.0	0.0	0.0	2	2	0
fam5879	2	2	2	2.0	0.0	0.0	2	2	0
fam5880	2	2	2	2.0	0.0	0.0	2	2	0
fam5881	2	2	2	2.0	0.0	0.0	2	2	0
fam5882	2	2	2	2.0	0.0	0.0	2	2	0
fam5883	2	2	2	2.0	0.0	0.0	2	2	0
fam5884	2	2	2	2.0	0.0	0.0	2	2	0
fam5885	2	2	2	2.0	0.0	0.0	2	2	0
fam5886	2	2	2	2.0	0.0	0.0	2	2	0
fam5887	2	2	2	2.0	0.0	0.0	2	2	0
fam5888	2	2	2	2.0	0.0	0.0	2	2	0
fam5889	2	2	2	2.0	0.0	0.0	2	2	0
fam5890	2	2	2	2.0	0.0	0.0	2	2	0
fam5891	2	2	2	2.0	0.0	0.0	2	2	0
fam5892	2	2	2	2.0	0.0	0.0	2	2	0
fam5893	2	2	2	2.0	0.0	0.0	2	2	0
fam5894	2	2	2	2.0	0.0	0.0	2	2	0
fam5895	2	2	2	2.0	0.0	0.0	2	2	0
fam5896	2	2	2	2.0	0.0	0.0	2	2	0
fam5897	2	2	2	2.0	0.0	0.0	2	2	0
fam5898	2	2	2	2.0	0.0	0.0	2	2	0
fam5899	2	2	2	2.0	0.0	0.0	2	2	0
fam5900	2	2	2	2.0	0.0	0.0	2	2	0
fam5901	2	2	2	2.0	0.0	0.0	2	2	0
fam5902	2	2	2	2.0	0.0	0.0	2	2	0
fam5903	2	2	2	2.0	0.0	0.0	2	2	0
fam5904	2	2	2	2.0	0.0	0.0	2	2	0
fam5905	2	2	2	2.0	0.0	0.0	2	2	0
fam5906	2	2	2	2.0	0.0	0.0	2	2	0
fam5907	2	2	2	2.0	0.0	0.0	2	2	0
fam5908	2	2	2	2.0	0.0	0.0	2	2	0
fam5909	2	2	2	2.0	0.0	0.0	2	2	0
fam5910	2	2	2	2.0	0.0	0.0	2	2	0
fam5911	2	2	2	2.0	0.0	0.0	2	2	0
fam5912	2	2	2	2.0	0.0	0.0	2	2	0
fam5913	2	2	2	2.0	0.0	0.0	2	2	0
fam5914	2	2	2	2.0	0.0	0.0	2	2	0
fam5915	2	2	2	2.0	0.0	0.0	2	2	0
fam5916	2	2	2	2.0	0.0	0.0	2	2	0
fam5917	2	2	2	2.0	0.0	0.0	2	2	0
fam5918	2	2	2	2.0	0.0	0.0	2	2	0
fam5919	2	2	2	2.0	0.0	0.0	2	2	0
fam5920	2	2	2	2.0	0.0	0.0	2	2	0
fam5921	2	2	2	2.0	0.0	0.0	2	2	0
fam5922	2	2	2	2.0	0.0	0.0	2	2	0
fam5923	2	2	2	2.0	0.0	0.0	2	2	0
fam5924	2	2	2	2.0	0.0	0.0	2	2	0
fam5925	2	2	2	2.0	0.0	0.0	2	2	0
fam5926	2	2	2	2.0	0.0	0.0	2	2	0
fam5927	2	2	2	2.0	0.0	0.0	2	2	0
fam5928	2	2	2	2.0	0.0	0.0	2	2	0
fam5929	2	2	2	2.0	0.0	0.0	2	2	0
fam5930	2	2	2	2.0	0.0	0.0	2	2	0
fam5931	2	2	2	2.0	0.0	0.0	2	2	0
fam5932	2	2	2	2.0	0.0	0.0	2	2	0
fam5933	2	2	2	2.0	0.0	0.0	2	2	0
fam5934	2	2	2	2.0	0.0	0.0	2	2	0
fam5935	2	2	2	2.0	0.0	0.0	2	2	0
fam5936	2	2	2	2.0	0.0	0.0	2	2	0
fam5937	2	2	2	2.0	0.0	0.0	2	2	0
fam5938	2	2	2	2.0	0.0	0.0	2	2	0
fam5939	2	2	2	2.0	0.0	0.0	2	2	0
fam5940	2	2	2	2.0	0.0	0.0	2	2	0
fam5941	2	2	2	2.0	0.0	0.0	2	2	0
fam5942	2	2	2	2.0	0.0	0.0	2	2	0
fam5943	2	2	2	2.0	0.0	0.0	2	2	0
fam5944	2	2	2	2.0	0.0	0.0	2	2	0
fam5945	2	2	2	2.0	0.0	0.0	2	2	0
fam5946	2	2	2	2.0	0.0	0.0	2	2	0
fam5947	2	2	2	2.0	0.0	0.0	2	2	0
fam5948	2	2	2	2.0	0.0	0.0	2	2	0
fam5949	2	2	2	2.0	0.0	0.0	2	2	0
fam5950	2	2	2	2.0	0.0	0.0	2	2	0
fam5951	2	2	2	2.0	0.0	0.0	2	2	0
fam5952	2	2	2	2.0	0.0	0.0	2	2	0
fam5953	2	2	2	2.0	0.0	0.0	2	2	0
fam5954	2	2	2	2.0	0.0	0.0	2	2	0
fam5955	2	2	2	2.0	0.0	0.0	2	2	0
fam5956	2	2	2	2.0	0.0	0.0	2	2	0
fam5957	2	2	2	2.0	0.0	0.0	2	2	0
fam5958	2	2	2	2.0	0.0	0.0	2	2	0
fam5959	2	2	2	2.0	0.0	0.0	2	2	0
fam5960	2	2	2	2.0	0.0	0.0	2	2	0
fam5961	2	2	2	2.0	0.0	0.0	2	2	0
fam5962	2	2	2	2.0	0.0	0.0	2	2	0
fam5963	2	2	2	2.0	0.0	0.0	2	2	0
fam5964	2	2	2	2.0	0.0	0.0	2	2	0
fam5965	2	2	2	2.0	0.0	0.0	2	2	0
fam5966	2	2	2	2.0	0.0	0.0	2	2	0
fam5967	2	2	2	2.0	0.0	0.0	2	2	0
fam5968	2	2	2	2.0	0.0	0.0	2	2	0
fam5969	2	2	2	2.0	0.0	0.0	2	2	0
fam5970	2	2	2	2.0	0.0	0.0	2	2	0
fam5971	2	2	2	2.0	0.0	0.0	2	2	0
fam5972	2	2	2	2.0	0.0	0.0	2	2	0
fam5973	2	2	2	2.0	0.0	0.0	2	2	0
fam5974	2	2	2	2.0	0.0	0.0	2	2	0
fam5975	2	2	2	2.0	0.0	0.0	2	2	0
fam5976	2	2	2	2.0	0.0	0.0	2	2	0
fam5977	2	2	2	2.0	0.0	0.0	2	2	0
fam5978	2	2	2	2.0	0.0	0.0	2	2	0
fam5979	2	2	2	2.0	0.0	0.0	2	2	0
fam5980	2	2	2	2.0	0.0	0.0	2	2	0
fam5981	2	2	2	2.0	0.0	0.0	2	2	0
fam5982	2	2	2	2.0	0.0	0.0	2	2	0
fam5983	2	2	2	2.0	0.0	0.0	2	2	0
fam5984	2	2	2	2.0	0.0	0.0	2	2	0
fam5985	2	2	2	2.0	0.0	0.0	2	2	0
fam5986	2	2	2	2.0	0.0	0.0	2	2	0
fam5987	2	2	2	2.0	0.0	0.0	2	2	0
fam5988	2	2	2	2.0	0.0	0.0	2	2	0
fam5989	2	2	2	2.0	0.0	0.0	2	2	0
fam5990	2	2	2	2.0	0.0	0.0	2	2	0
fam5991	2	2	2	2.0	0.0	0.0	2	2	0
fam5992	2	2	2	2.0	0.0	0.0	2	2	0
fam5993	2	2	2	2.0	0.0	0.0	2	2	0
fam5994	2	2	2	2.0	0.0	0.0	2	2	0
fam5995	2	2	2	2.0	0.0	0.0	2	2	0
fam5996	2	2	2	2.0	0.0	0.0	2	2	0
fam5997	2	2	2	2.0	0.0	0.0	2	2	0
fam5998	2	2	2	2.0	0.0	0.0	2	2	0
fam5999	2	2	2	2.0	0.0	0.0	2	2	0
fam6000	2	2	2	2.0	0.0	0.0	2	2	0
fam6001	2	2	2	2.0	0.0	0.0	2	2	0
fam6002	2	2	2	2.0	0.0	0.0	2	2	0
fam6003	2	2	2	2.0	0.0	0.0	2	2	0
fam6004	2	2	2	2.0	0.0	0.0	2	2	0
fam6005	2	2	2	2.0	0.0	0.0	2	2	0
fam6006	2	2	2	2.0	0.0	0.0	2	2	0
fam6007	2	2	2	2.0	0.0	0.0	2	2	0
fam6008	2	2	2	2.0	0.0	0.0	2	2	0
fam6009	2	2	2	2.0	0.0	0.0	2	2	0
fam6010	2	2	2	2.0	0.0	0.0	2	2	0
fam6011	2	2	2	2.0	0.0	0.0	2	2	0
fam6012	2	2	2	2.0	0.0	0.0	2	2	0
fam6013	2	2	2	2.0	0.0	0.0	2	2	0
fam6014	2	2	2	2.0	0.0	0.0	2	2	0
fam6015	2	2	2	2.0	0.0	0.0	2	2	0
fam6016	2	2	2	2.0	0.0	0.0	2	2	0
fam6017	2	2	2	2.0	0.0	0.0	2	2	0
fam6018	2	2	2	2.0	0.0	0.0	2	2	0
fam6019	2	2	2	2.0	0.0	0.0	2	2	0
fam6020	2	2	2	2.0	0.0	0.0	2	2	0
fam6021	2	2	2	2.0	0.0	0.0	2	2	0
fam6022	2	2	2	2.0	0.0	0.0	2	2	0
fam6023	2	2	2	2.0	0.0	0.0	2	2	0
fam6024	2	2	2	2.0	0.0	0.0	2	2	0
fam6025	2	2	2	2.0	0.0	0.0	2	2	0
fam6026	2	2	2	2.0	0.0	0.0	2	2	0
fam6027	2	2	2	2.0	0.0	0.0	2	2	0
fam6028	2	2	2	2.0	0.0	0.0	2	2	0
fam6029	2	2	2	2.0	0.0	0.0	2	2	0
fam6030	2	2	2	2.0	0.0	0.0	2	2	0
fam6031	2	2	2	2.0	0.0	0.0	2	2	0
fam6032	2	2	2	2.0	0.0	0.0	2	2	0
fam6033	2	2	2	2.0	0.0	0.0	2	2	0
fam6034	2	2	2	2.0	0.0	0.0	2	2	0
fam6035	2	2	2	2.0	0.0	0.0	2	2	0
fam6036	2	2	2	2.0	0.0	0.0	2	2	0
fam6037	2	2	2	2.0	0.0	0.0	2	2	0
fam6038	2	2	2	2.0	0.0	0.0	2	2	0
fam6039	2	2	2	2.0	0.0	0.0	2	2	0
fam6040	2	2	2	2.0	0.0	0.0	2	2	0
fam6041	2	2	2	2.0	0.0	0.0	2	2	0
fam6042	2	2	2	2.0	0.0	0.0	2	2	0
fam6043	2	2	2	2.0	0.0	0.0	2	2	0
fam6044	2	2	2	2.0	0.0	0.0	2	2	0
fam6045	2	2	2	2.0	0.0	0.0	2	2	0
fam6046	2	2	2	2.0	0.0	0.0	2	2	0
fam6047	2	2	2	2.0	0.0	0.0	2	2	0
fam6048	2	2	2	2.0	0.0	0.0	2	2	0
fam6049	2	2	2	2.0	0.0	0.0	2	2	0
fam6050	2	2	2	2.0	0.0	0.0	2	2	0
fam6051	2	2	2	2.0	0.0	0.0	2	2	0
fam6052	2	2	2	2.0	0.0	0.0	2	2	0
fam6053	2	2	2	2.0	0.0	0.0	2	2	0
fam6054	2	2	2	2.0	0.0	0.0	2	2	0
fam6055	2	2	2	2.0	0.0	0.0	2	2	0
fam6056	2	2	2	2.0	0.0	0.0	2	2	0
fam6057	2	2	2	2.0	0.0	0.0	2	2	0
fam6058	2	2	2	2.0	0.0	0.0	2	2	0
fam6059	2	2	2	2.0	0.0	0.0	2	2	0
fam6060	2	2	2	2.0	0.0	0.0	2	2	0
fam6061	2	2	2	2.0	0.0	0.0	2	2	0
fam6062	2	2	2	2.0	0.0	0.0	2	2	0
fam6063	2	2	2	2.0	0.0	0.0	2	2	0
fam6064	2	2	2	2.0	0.0	0.0	2	2	0
fam6065	2	2	2	2.0	0.0	0.0	2	2	0
fam6066	2	2	2	2.0	0.0	0.0	2	2	0
fam6067	2	2	2	2.0	0.0	0.0	2	2	0
fam6068	2	2	2	2.0	0.0	0.0	2	2	0
fam6069	2	2	2	2.0	0.0	0.0	2	2	0
fam6070	2	2	2	2.0	0.0	0.0	2	2	0
fam6071	2	2	2	2.0	0.0	0.0	2	2	0
fam6072	2	2	2	2.0	0.0	0.0	2	2	0
fam6073	2	2	2	2.0	0.0	0.0	2	2	0
fam6074	2	2	2	2.0	0.0	0.0	2	2	0
fam6075	2	2	2	2.0	0.0	0.0	2	2	0
fam6076	2	2	2	2.0	0.0	0.0	2	2	0
fam6077	2	2	2	2.0	0.0	0.0	2	2	0
fam6078	2	2	2	2.0	0.0	0.0	2	2	0
fam6079	2	2	2	2.0	0.0	0.0	2	2	0
fam6080	2	2	2	2.0	0.0	0.0	2	2	0
fam6081	2	2	2	2.0	0.0	0.0	2	2	0
fam6082	2	2	2	2.0	0.0	0.0	2	2	0
fam6083	2	2	2	2.0	0.0	0.0	2	2	0
fam6084	2	2	2	2.0	0.0	0.0	2	2	0
fam6085	2	2	2	2.0	0.0	0.0	2	2	0
fam6086	2	2	2	2.0	0.0	0.0	2	2	0
fam6087	2	2	2	2.0	0.0	0.0	2	2	0
fam6088	2	2	2	2.0	0.0	0.0	2	2	0
fam6089	2	2	2	2.0	0.0	0.0	2	2	0
fam6090	2	2	2	2.0	0.0	0.0	2	2	0
fam6091	2	2	2	2.0	0.0	0.0	2	2	0
fam6092	2	2	2	2.0	0.0	0.0	2	2	0
fam6093	2	2	2	2.0	0.0	0.0	2	2	0
fam6094	2	2	2	2.0	0.0	0.0	2	2	0
fam6095	2	2	2	2.0	0.0	0.0	2	2	0
fam6096	2	2	2	2.0	0.0	0.0	2	2	0
fam6097	2	2	2	2.0	0.0	0.0	2	2	0
fam6098	2	2	2	2.0	0.0	0.0	2	2	0
fam6099	2	2	2	2.0	0.0	0.0	2	2	0
fam6100	2	2	2	2.0	0.0	0.0	2	2	0
fam6101	2	2	2	2.0	0.0	0.0	2	2	0
fam6102	2	2	2	2.0	0.0	0.0	2	2	0
fam6103	2	2	2	2.0	0.0	0.0	2	2	0
fam6104	2	2	2	2.0	0.0	0.0	2	2	0
fam6105	2	2	2	2.0	0.0	0.0	2	2	0
fam6106	2	2	2	2.0	0.0	0.0	2	2	0
fam6107	2	2	2	2.0	0.0	0.0	2	2	0
fam6108	2	2	2	2.0	0.0	0.0	2	2	0
fam6109	2	2	2	2.0	0.0	0.0	2	2	0
fam6110	2	2	2	2.0	0.0	0.0	2	2	0
fam6111	2	2	2	2.0	0.0	0.0	2	2	0
fam6112	2	2	2	2.0	0.0	0.0	2	2	0
fam6113	2	2	2	2.0	0.0	0.0	2	2	0
fam6114	2	2	2	2.0	0.0	0.0	2	2	0
fam6115	2	2	2	2.0	0.0	0.0	2	2	0
fam6116	2	2	2	2.0	0.0	0.0	2	2	0
fam6117	2	2	2	2.0	0.0	0.0	2	2	0
fam6118	2	2	2	2.0	0.0	0.0	2	2	0
fam6119	2	2	2	2.0	0.0	0.0	2	2	0
fam6120	2	2	2	2.0	0.0	0.0	2	2	0
fam6121	2	2	2	2.0	0.0	0.0	2	2	0
fam6122	2	2	2	2.0	0.0	0.0	2	2	0
fam6123	2	2	2	2.0	0.0	0.0	2	2	0
fam6124	2	2	2	2.0	0.0	0.0	2	2	0
fam6125	2	2	2	2.0	0.0	0.0	2	2	0
fam6126	2	2	2	2.0	0.0	0.0	2	2	0
fam6127	2	2	2	2.0	0.0	0.0	2	2	0
fam6128	2	2	2	2.0	0.0	0.0	2	2	0
fam6129	2	2	2	2.0	0.0	0.0	2	2	0
fam6130	2	2	2	2.0	0.0	0.0	2	2	0
fam6131	2	2	2	2.0	0.0	0.0	2	2	0
fam6132	2	2	2	2.0	0.0	0.0	2	2	0
fam6133	2	2	2	2.0	0.0	0.0	2	2	0
fam6134	2	2	2	2.0	0.0	0.0	2	2	0
fam6135	2	2	2	2.0	0.0	0.0	2	2	0
fam6136	2	2	2	2.0	0.0	0.0	2	2	0
fam6137	2	2	2	2.0	0.0	0.0	2	2	0
fam6138	2	2	2	2.0	0.0	0.0	2	2	0
fam6139	2	2	2	2.0	0.0	0.0	2	2	0
fam6140	2	2	2	2.0	0.0	0.0	2	2	0
fam6141	2	2	2	2.0	0.0	0.0	2	2	0
fam6142	2	2	2	2.0	0.0	0.0	2	2	0
fam6143	2	2	2	2.0	0.0	0.0	2	2	0
fam6144	2	2	2	2.0	0.0	0.0	2	2	0
fam6145	2	2	2	2.0	0.0	0.0	2	2	0
fam6146	2	2	2	2.0	0.0	0.0	2	2	0
fam6147	2	2	2	2.0	0.0	0.0	2	2	0
fam6148	2	2	2	2.0	0.0	0.0	2	2	0
fam6149	2	2	2	2.0	0.0	0.0	2	2	0
fam6150	2	2	2	2.0	0.0	0.0	2	2	0
fam6151	2	2	2	2.0	0.0	0.0	2	2	0
fam6152	2	2	2	2.0	0.0	0.0	2	2	0
fam6153	2	2	2	2.0	0.0	0.0	2	2	0
fam6154	2	2	2	2.0	0.0	0.0	2	2	0
fam6155	2	2	2	2.0	0.0	0.0	2	2	0
fam6156	2	2	2	2.0	0.0	0.0	2	2	0
fam6157	2	2	2	2.0	0.0	0.0	2	2	0
fam6158	2	2	2	2.0	0.0	0.0	2	2	0
fam6159	2	2	2	2.0	0.0	0.0	2	2	0
fam6160	2	2	2	2.0	0.0	0.0	2	2	0
fam6161	2	2	2	2.0	0.0	0.0	2	2	0
fam6162	2	2	2	2.0	0.0	0.0	2	2	0
fam6163	2	2	2	2.0	0.0	0.0	2	2	0
fam6164	2	2	2	2.0	0.0	0.0	2	2	0
fam6165	2	2	2	2.0	0.0	0.0	2	2	0
fam6166	2	2	2	2.0	0.0	0.0	2	2	0
fam6167	2	2	2	2.0	0.0	0.0	2	2	0
fam6168	2	2	2	2.0	0.0	0.0	2	2	0
fam6169	2	2	2	2.0	0.0	0.0	2	2	0
fam6170	2	2	2	2.0	0.0	0.0	2	2	0
fam6171	2	2	2	2.0	0.0	0.0	2	2	0
fam6172	2	2	2	2.0	0.0	0.0	2	2	0
fam6173	2	2	2	2.0	0.0	0.0	2	2	0
fam6174	2	2	2	2.0	0.0	0.0	2	2	0
fam6175	2	2	2	2.0	0.0	0.0	2	2	0
fam6176	2	2	2	2.0	0.0	0.0	2	2	0
fam6177	2	2	2	2.0	0.0	0.0	2	2	0
fam6178	2	2	2	2.0	0.0	0.0	2	2	0
fam6179	2	2	2	2.0	0.0	0.0	2	2	0
fam6180	2	2	2	2.0	0.0	0.0	2	2	0
fam6181	2	2	2	2.0	0.0	0.0	2	2	0
fam6182	2	2	2	2.0	0.0	0.0	2	2	0
fam6183	2	2	2	2.0	0.0	0.0	2	2	0
fam6184	2	2	2	2.0	0.0	0.0	2	2	0
fam6185	2	2	2	2.0	0.0	0.0	2	2	0
fam6186	2	2	2	2.0	0.0	0.0	2	2	0
fam6187	2	2	2	2.0	0.0	0.0	2	2	0
fam6188	2	2	2	2.0	0.0	0.0	2	2	0
fam6189	2	2	2	2.0	0.0	0.0	2	2	0
fam6190	2	2	2	2.0	0.0	0.0	2	2	0
fam6191	2	2	2	2.0	0.0	0.0	2	2	0
fam6192	2	2	2	2.0	0.0	0.0	2	2	0
fam6193	2	2	2	2.0	0.0	0.0	2	2	0
fam6194	2	2	2	2.0	0.0	0.0	2	2	0
fam6195	2	2	2	2.0	0.0	0.0	2	2	0
fam6196	2	2	2	2.0	0.0	0.0	2	2	0
fam6197	2	2	2	2.0	0.0	0.0	2	2	0
fam6198	2	2	2	2.0	0.0	0.0	2	2	0
fam6199	2	2	2	2.0	0.0	0.0	2	2	0
fam6200	2	2	2	2.0	0.0	0.0	2	2	0
fam6201	2	2	2	2.0	0.0	0.0	2	2	0
fam6202	2	2	2	2.0	0.0	0.0	2	2	0
fam6203	2	2	2	2.0	0.0	0.0	2	2	0
fam6204	2	2	2	2.0	0.0	0.0	2	2	0
fam6205	2	2	2	2.0	0.0	0.0	2	2	0
fam6206	2	2	2	2.0	0.0	0.0	2	2	0
fam6207	2	2	2	2.0	0.0	0.0	2	2	0
fam6208	2	2	2	2.0	0.0	0.0	2	2	0
fam6209	2	2	2	2.0	0.0	0.0	2	2	0
fam6210	2	2	2	2.0	0.0	0.0	2	2	0
fam6211	2	2	2	2.0	0.0	0.0	2	2	0
fam6212	2	2	2	2.0	0.0	0.0	2	2	0
fam6213	2	2	2	2.0	0.0	0.0	2	2	0
fam6214	2	2	2	2.0	0.0	0.0	2	2	0
fam6215	2	2	2	2.0	0.0	0.0	2	2	0
fam6216	2	2	2	2.0	0.0	0.0	2	2	0
fam6217	2	2	2	2.0	0.0	0.0	2	2	0
fam6218	2	2	2	2.0	0.0	0.0	2	2	0
fam6219	2	2	2	2.0	0.0	0.0	2	2	0
fam6220	2	2	2	2.0	0.0	0.0	2	2	0
fam6221	2	2	2	2.0	0.0	0.0	2	2	0
fam6222	2	2	2	2.0	0.0	0.0	2	2	0
fam6223	2	2	2	2.0	0.0	0.0	2	2	0
fam6224	2	2	2	2.0	0.0	0.0	2	2	0
fam6225	2	2	2	2.0	0.0	0.0	2	2	0
fam6226	2	2	2	2.0	0.0	0.0	2	2	0
fam6227	2	2	2	2.0	0.0	0.0	2	2	0
fam6228	2	2	2	2.0	0.0	0.0	2	2	0
fam6229	2	2	2	2.0	0.0	0.0	2	2	0
fam6230	2	2	2	2.0	0.0	0.0	2	2	0
fam6231	2	2	2	2.0	0.0	0.0	2	2	0
fam6232	2	2	2	2.0	0.0	0.0	2	2	0
fam6233	2	2	2	2.0	0.0	0.0	2	2	0
fam6234	2	2	2	2.0	0.0	0.0	2	2	0
fam6235	2	2	2	2.0	0.0	0.0	2	2	0
fam6236	2	2	2	2.0	0.0	0.0	2	2	0
fam6237	2	2	2	2.0	0.0	0.0	2	2	0
fam6238	2	2	2	2.0	0.0	0.0	2	2	0
fam6239	2	2	2	2.0	0.0	0.0	2	2	0
fam6240	2	2	2	2.0	0.0	0.0	2	2	0
fam6241	2	2	2	2.0	0.0	0.0	2	2	0
fam6242	2	2	2	2.0	0.0	0.0	2	2	0
fam6243	2	2	2	2.0	0.0	0.0	2	2	0
fam6244	2	2	2	2.0	0.0	0.0	2	2	0
fam6245	2	2	2	2.0	0.0	0.0	2	2	0
fam6246	2	2	2	2.0	0.0	0.0	2	2	0
fam6247	2	2	2	2.0	0.0	0.0	2	2	0
fam6248	2	2	2	2.0	0.0	0.0	2	2	0
fam6249	2	2	2	2.0	0.0	0.0	2	2	0
fam6250	2	2	2	2.0	0.0	0.0	2	2	0
fam6251	2	2	2	2.0	0.0	0.0	2	2	0
fam6252	2	2	2	2.0	0.0	0.0	2	2	0
fam6253	2	2	2	2.0	0.0	0.0	2	2	0
fam6254	2	2	2	2.0	0.0	0.0	2	2	0
fam6255	2	2	2	2.0	0.0	0.0	2	2	0
fam6256	2	2	2	2.0	0.0	0.0	2	2	0
fam6257	2	2	2	2.0	0.0	0.0	2	2	0
fam6258	2	2	2	2.0	0.0	0.0	2	2	0
fam6259	2	2	2	2.0	0.0	0.0	2	2	0
fam6260	2	2	2	2.0	0.0	0.0	2	2	0
fam6261	2	2	2	2.0	0.0	0.0	2	2	0
fam6262	2	2	2	2.0	0.0	0.0	2	2	0
fam6263	2	2	2	2.0	0.0	0.0	2	2	0
fam6264	2	2	2	2.0	0.0	0.0	2	2	0
fam6265	2	2	2	2.0	0.0	0.0	2	2	0
fam6266	2	2	2	2.0	0.0	0.0	2	2	0
fam6267	2	2	2	2.0	0.0	0.0	2	2	0
fam6268	2	2	2	2.0	0.0	0.0	2	2	0
fam6269	2	2	2	2.0	0.0	0.0	2	2	0
fam6270	2	2	2	2.0	0.0	0.0	2	2	0
fam6271	2	2	2	2.0	0.0	0.0	2	2	0
fam6272	2	2	2	2.0	0.0	0.0	2	2	0
fam6273	2	2	2	2.0	0.0	0.0	2	2	0
fam6274	2	2	2	2.0	0.0	0.0	2	2	0
fam6275	2	2	2	2.0	0.0	0.0	2	2	0
fam6276	2	2	2	2.0	0.0	0.0	2	2	0
fam6277	2	2	2	2.0	0.0	0.0	2	2	0
fam6278	2	2	2	2.0	0.0	0.0	2	2	0
fam6279	2	2	2	2.0	0.0	0.0	2	2	0
fam6280	2	2	2	2.0	0.0	0.0	2	2	0
fam6281	2	2	2	2.0	0.0	0.0	2	2	0
fam6282	2	2	2	2.0	0.0	0.0	2	2	0
fam6283	2	2	2	2.0	0.0	0.0	2	2	0
fam6284	2	2	2	2.0	0.0	0.0	2	2	0
fam6285	2	2	2	2.0	0.0	0.0	2	2	0
fam6286	2	2	2	2.0	0.0	0.0	2	2	0
fam6287	2	2	2	2.0	0.0	0.0	2	2	0
fam6288	2	2	2	2.0	0.0	0.0	2	2	0
fam6289	2	2	2	2.0	0.0	0.0	2	2	0
fam6290	2	2	2	2.0	0.0	0.0	2	2	0
fam6291	2	2	2	2.0	0.0	0.0	2	2	0
fam6292	2	2	2	2.0	0.0	0.0	2	2	0
fam6293	2	2	2	2.0	0.0	0.0	2	2	0
fam6294	2	2	2	2.0	0.0	0.0	2	2	0
fam6295	2	2	2	2.0	0.0	0.0	2	2	0
fam6296	2	2	2	2.0	0.0	0.0	2	2	0
fam6297	2	2	2	2.0	0.0	0.0	2	2	0
fam6298	2	2	2	2.0	0.0	0.0	2	2	0
fam6299	2	2	2	2.0	0.0	0.0	2	2	0
fam6300	2	2	2	2.0	0.0	0.0	2	2	0
fam6301	2	2	2	2.0	0.0	0.0	2	2	0
fam6302	2	2	2	2.0	0.0	0.0	2	2	0
fam6303	2	2	2	2.0	0.0	0.0	2	2	0
fam6304	2	2	2	2.0	0.0	0.0	2	2	0
fam6305	2	2	2	2.0	0.0	0.0	2	2	0
fam6306	2	2	2	2.0	0.0	0.0	2	2	0
fam6307	2	2	2	2.0	0.0	0.0	2	2	0
fam6308	2	2	2	2.0	0.0	0.0	2	2	0
fam6309	2	2	2	2.0	0.0	0.0	2	2	0
fam6310	2	2	2	2.0	0.0	0.0	2	2	0
fam6311	2	2	2	2.0	0.0	0.0	2	2	0
fam6312	2	2	2	2.0	0.0	0.0	2	2	0
fam6313	2	2	2	2.0	0.0	0.0	2	2	0
fam6314	2	2	2	2.0	0.0	0.0	2	2	0
fam6315	2	2	2	2.0	0.0	0.0	2	2	0
fam6316	2	2	2	2.0	0.0	0.0	2	2	0
fam6317	2	2	2	2.0	0.0	0.0	2	2	0
fam6318	2	2	2	2.0	0.0	0.0	2	2	0
fam6319	2	2	2	2.0	0.0	0.0	2	2	0
fam6320	2	2	2	2.0	0.0	0.0	2	2	0
fam6321	2	2	2	2.0	0.0	0.0	2	2	0
fam6322	2	2	2	2.0	0.0	0.0	2	2	0
fam6323	2	2	2	2.0	0.0	0.0	2	2	0
fam6324	2	2	2	2.0	0.0	0.0	2	2	0
fam6325	2	2	2	2.0	0.0	0.0	2	2	0
fam6326	2	2	2	2.0	0.0	0.0	2	2	0
fam6327	2	2	2	2.0	0.0	0.0	2	2	0
fam6328	2	2	2	2.0	0.0	0.0	2	2	0
fam6329	2	2	2	2.0	0.0	0.0	2	2	0
fam6330	2	2	2	2.0	0.0	0.0	2	2	0
fam6331	2	2	2	2.0	0.0	0.0	2	2	0
fam6332	2	2	2	2.0	0.0	0.0	2	2	0
fam6333	2	2	2	2.0	0.0	0.0	2	2	0
fam6334	2	2	2	2.0	0.0	0.0	2	2	0
fam6335	2	2	2	2.0	0.0	0.0	2	2	0
fam6336	2	2	2	2.0	0.0	0.0	2	2	0
fam6337	2	2	2	2.0	0.0	0.0	2	2	0
fam6338	2	2	2	2.0	0.0	0.0	2	2	0
fam6339	2	2	2	2.0	0.0	0.0	2	2	0
fam6340	2	2	2	2.0	0.0	0.0	2	2	0
fam6341	2	2	2	2.0	0.0	0.0	2	2	0
fam6342	2	2	2	2.0	0.0	0.0	2	2	0
fam6343	2	2	2	2.0	0.0	0.0	2	2	0
fam6344	2	2	2	2.0	0.0	0.0	2	2	0
fam6345	2	2	2	2.0	0.0	0.0	2	2	0
fam6346	2	2	2	2.0	0.0	0.0	2	2	0
fam6347	2	2	2	2.0	0.0	0.0	2	2	0
fam6348	2	2	2	2.0	0.0	0.0	2	2	0
fam6349	2	2	2	2.0	0.0	0.0	2	2	0
fam6350	2	2	2	2.0	0.0	0.0	2	2	0
fam6351	2	2	2	2.0	0.0	0.0	2	2	0
fam6352	2	2	2	2.0	0.0	0.0	2	2	0
fam6353	2	2	2	2.0	0.0	0.0	2	2	0
fam6354	2	2	2	2.0	0.0	0.0	2	2	0
fam6355	2	2	2	2.0	0.0	0.0	2	2	0
fam6356	2	2	2	2.0	0.0	0.0	2	2	0
fam6357	2	2	2	2.0	0.0	0.0	2	2	0
fam6358	2	2	2	2.0	0.0	0.0	2	2	0
fam6359	2	2	2	2.0	0.0	0.0	2	2	0
fam6360	2	2	2	2.0	0.0	0.0	2	2	0
fam6361	2	2	2	2.0	0.0	0.0	2	2	0
fam6362	2	2	2	2.0	0.0	0.0	2	2	0
fam6363	2	2	2	2.0	0.0	0.0	2	2	0
fam6364	2	2	2	2.0	0.0	0.0	2	2	0
fam6365	2	2	2	2.0	0.0	0.0	2	2	0
fam6366	2	2	2	2.0	0.0	0.0	2	2	0
fam6367	2	2	2	2.0	0.0	0.0	2	2	0
fam6368	2	2	2	2.0	0.0	0.0	2	2	0
fam6369	2	2	2	2.0	0.0	0.0	2	2	0
fam6370	2	2	2	2.0	0.0	0.0	2	2	0
fam6371	2	2	2	2.0	0.0	0.0	2	2	0
fam6372	2	2	2	2.0	0.0	0.0	2	2	0
fam6373	2	2	2	2.0	0.0	0.0	2	2	0
fam6374	2	2	2	2.0	0.0	0.0	2	2	0
fam6375	2	2	2	2.0	0.0	0.0	2	2	0
fam6376	2	2	2	2.0	0.0	0.0	2	2	0
fam6377	2	2	2	2.0	0.0	0.0	2	2	0
fam6378	2	2	2	2.0	0.0	0.0	2	2	0
fam6379	2	2	2	2.0	0.0	0.0	2	2	0
fam6380	2	2	2	2.0	0.0	0.0	2	2	0
fam6381	2	2	2	2.0	0.0	0.0	2	2	0
fam6382	2	2	2	2.0	0.0	0.0	2	2	0
fam6383	2	2	2	2.0	0.0	0.0	2	2	0
fam6384	2	2	2	2.0	0.0	0.0	2	2	0
fam6385	2	2	2	2.0	0.0	0.0	2	2	0
fam6386	2	2	2	2.0	0.0	0.0	2	2	0
fam6387	2	2	2	2.0	0.0	0.0	2	2	0
fam6388	2	2	2	2.0	0.0	0.0	2	2	0
fam6389	2	2	2	2.0	0.0	0.0	2	2	0
fam6390	2	2	2	2.0	0.0	0.0	2	2	0
fam6391	2	2	2	2.0	0.0	0.0	2	2	0
fam6392	2	2	2	2.0	0.0	0.0	2	2	0
fam6393	2	2	2	2.0	0.0	0.0	2	2	0
fam6394	2	2	2	2.0	0.0	0.0	2	2	0
fam6395	2	2	2	2.0	0.0	0.0	2	2	0
fam6396	2	2	2	2.0	0.0	0.0	2	2	0
fam6397	2	2	2	2.0	0.0	0.0	2	2	0
fam6398	2	2	2	2.0	0.0	0.0	2	2	0
fam6399	2	2	2	2.0	0.0	0.0	2	2	0
fam6400	2	2	2	2.0	0.0	0.0	2	2	0
fam6401	2	2	2	2.0	0.0	0.0	2	2	0
fam6402	2	2	2	2.0	0.0	0.0	2	2	0
fam6403	2	2	2	2.0	0.0	0.0	2	2	0
fam6404	2	2	2	2.0	0.0	0.0	2	2	0
fam6405	2	2	2	2.0	0.0	0.0	2	2	0
fam6406	2	2	2	2.0	0.0	0.0	2	2	0
fam6407	2	2	2	2.0	0.0	0.0	2	2	0
fam6408	2	2	2	2.0	0.0	0.0	2	2	0
fam6409	2	2	2	2.0	0.0	0.0	2	2	0
fam6410	2	2	2	2.0	0.0	0.0	2	2	0
fam6411	2	2	2	2.0	0.0	0.0	2	2	0
fam6412	2	2	2	2.0	0.0	0.0	2	2	0
fam6413	2	2	2	2.0	0.0	0.0	2	2	0
fam6414	2	2	2	2.0	0.0	0.0	2	2	0
fam6415	2	2	2	2.0	0.0	0.0	2	2	0
fam6416	2	2	2	2.0	0.0	0.0	2	2	0
fam6417	2	2	2	2.0	0.0	0.0	2	2	0
fam6418	2	2	2	2.0	0.0	0.0	2	2	0
fam6419	2	2	2	2.0	0.0	0.0	2	2	0
fam6420	2	2	2	2.0	0.0	0.0	2	2	0
fam6421	2	2	2	2.0	0.0	0.0	2	2	0
fam6422	2	2	2	2.0	0.0	0.0	2	2	0
fam6423	2	2	2	2.0	0.0	0.0	2	2	0
fam6424	2	2	2	2.0	0.0	0.0	2	2	0
fam6425	2	2	2	2.0	0.0	0.0	2	2	0
fam6426	2	2	2	2.0	0.0	0.0	2	2	0
fam6427	2	2	2	2.0	0.0	0.0	2	2	0
fam6428	2	2	2	2.0	0.0	0.0	2	2	0
fam6429	2	2	2	2.0	0.0	0.0	2	2	0
fam6430	2	2	2	2.0	0.0	0.0	2	2	0
fam6431	2	2	2	2.0	0.0	0.0	2	2	0
fam6432	2	2	2	2.0	0.0	0.0	2	2	0
fam6433	2	2	2	2.0	0.0	0.0	2	2	0
fam6434	2	2	2	2.0	0.0	0.0	2	2	0
fam6435	2	2	2	2.0	0.0	0.0	2	2	0
fam6436	2	2	2	2.0	0.0	0.0	2	2	0
fam6437	2	2	2	2.0	0.0	0.0	2	2	0
fam6438	2	2	2	2.0	0.0	0.0	2	2	0
fam6439	2	2	2	2.0	0.0	0.0	2	2	0
fam6440	2	2	2	2.0	0.0	0.0	2	2	0
fam6441	2	2	2	2.0	0.0	0.0	2	2	0
fam6442	2	2	2	2.0	0.0	0.0	2	2	0
fam6443	2	2	2	2.0	0.0	0.0	2	2	0
fam6444	2	2	2	2.0	0.0	0.0	2	2	0
fam6445	2	2	2	2.0	0.0	0.0	2	2	0
fam6446	2	2	2	2.0	0.0	0.0	2	2	0
fam6447	2	2	2	2.0	0.0	0.0	2	2	0
fam6448	2	2	2	2.0	0.0	0.0	2	2	0
fam6449	2	2	2	2.0	0.0	0.0	2	2	0
fam6450	2	2	2	2.0	0.0	0.0	2	2	0
fam6451	2	2	2	2.0	0.0	0.0	2	2	0
fam6452	2	2	2	2.0	0.0	0.0	2	2	0
fam6453	2	2	2	2.0	0.0	0.0	2	2	0
fam6454	2	2	2	2.0	0.0	0.0	2	2	0
fam6455	2	2	2	2.0	0.0	0.0	2	2	0
fam6456	2	2	2	2.0	0.0	0.0	2	2	0
fam6457	2	2	2	2.0	0.0	0.0	2	2	0
fam6458	2	2	2	2.0	0.0	0.0	2	2	0
fam6459	2	2	2	2.0	0.0	0.0	2	2	0
fam6460	2	2	2	2.0	0.0	0.0	2	2	0
fam6461	2	2	2	2.0	0.0	0.0	2	2	0
fam6462	2	2	2	2.0	0.0	0.0	2	2	0
fam6463	2	2	2	2.0	0.0	0.0	2	2	0
fam6464	2	2	2	2.0	0.0	0.0	2	2	0
fam6465	2	2	2	2.0	0.0	0.0	2	2	0
fam6466	2	2	2	2.0	0.0	0.0	2	2	0
fam6467	2	2	2	2.0	0.0	0.0	2	2	0
fam6468	2	2	2	2.0	0.0	0.0	2	2	0
fam6469	2	2	2	2.0	0.0	0.0	2	2	0
fam6470	2	2	2	2.0	0.0	0.0	2	2	0
fam6471	2	2	2	2.0	0.0	0.0	2	2	0
fam6472	2	2	2	2.0	0.0	0.0	2	2	0
fam6473	2	2	2	2.0	0.0	0.0	2	2	0
fam6474	2	2	2	2.0	0.0	0.0	2	2	0
fam6475	2	2	2	2.0	0.0	0.0	2	2	0
fam6476	2	2	2	2.0	0.0	0.0	2	2	0
fam6477	2	2	2	2.0	0.0	0.0	2	2	0
fam6478	2	2	2	2.0	0.0	0.0	2	2	0
fam6479	2	2	2	2.0	0.0	0.0	2	2	0
fam6480	2	2	2	2.0	0.0	0.0	2	2	0
fam6481	2	2	2	2.0	0.0	0.0	2	2	0
fam6482	2	2	2	2.0	0.0	0.0	2	2	0
fam6483	2	2	2	2.0	0.0	0.0	2	2	0
fam6484	2	2	2	2.0	0.0	0.0	2	2	0
fam6485	2	2	2	2.0	0.0	0.0	2	2	0
fam6486	2	2	2	2.0	0.0	0.0	2	2	0
fam6487	2	2	2	2.0	0.0	0.0	2	2	0
fam6488	2	2	2	2.0	0.0	0.0	2	2	0
fam6489	2	2	2	2.0	0.0	0.0	2	2	0
fam6490	2	2	2	2.0	0.0	0.0	2	2	0
fam6491	2	2	2	2.0	0.0	0.0	2	2	0
fam6492	2	2	2	2.0	0.0	0.0	2	2	0
fam6493	2	2	2	2.0	0.0	0.0	2	2	0
fam6494	2	2	2	2.0	0.0	0.0	2	2	0
fam6495	2	2	2	2.0	0.0	0.0	2	2	0
fam6496	2	2	2	2.0	0.0	0.0	2	2	0
fam6497	2	2	2	2.0	0.0	0.0	2	2	0
fam6498	2	2	2	2.0	0.0	0.0	2	2	0
fam6499	2	2	2	2.0	0.0	0.0	2	2	0
fam6500	2	2	2	2.0	0.0	0.0	2	2	0
fam6501	2	2	2	2.0	0.0	0.0	2	2	0
fam6502	2	2	2	2.0	0.0	0.0	2	2	0
fam6503	2	2	2	2.0	0.0	0.0	2	2	0
fam6504	2	2	2	2.0	0.0	0.0	2	2	0
fam6505	2	2	2	2.0	0.0	0.0	2	2	0
fam6506	2	2	2	2.0	0.0	0.0	2	2	0
fam6507	2	2	2	2.0	0.0	0.0	2	2	0
fam6508	2	2	2	2.0	0.0	0.0	2	2	0
fam6509	2	2	2	2.0	0.0	0.0	2	2	0
fam6510	2	2	2	2.0	0.0	0.0	2	2	0
fam6511	2	2	2	2.0	0.0	0.0	2	2	0
fam6512	2	2	2	2.0	0.0	0.0	2	2	0
fam6513	2	2	2	2.0	0.0	0.0	2	2	0
fam6514	2	2	2	2.0	0.0	0.0	2	2	0
fam6515	2	2	2	2.0	0.0	0.0	2	2	0
fam6516	2	2	2	2.0	0.0	0.0	2	2	0
fam6517	2	2	2	2.0	0.0	0.0	2	2	0
fam6518	2	2	2	2.0	0.0	0.0	2	2	0
fam6519	2	2	2	2.0	0.0	0.0	2	2	0
fam6520	2	2	2	2.0	0.0	0.0	2	2	0
fam6521	2	2	2	2.0	0.0	0.0	2	2	0
fam6522	2	2	2	2.0	0.0	0.0	2	2	0
fam6523	2	2	2	2.0	0.0	0.0	2	2	0
fam6524	2	2	2	2.0	0.0	0.0	2	2	0
fam6525	2	2	2	2.0	0.0	0.0	2	2	0
fam6526	2	2	2	2.0	0.0	0.0	2	2	0
fam6527	2	2	2	2.0	0.0	0.0	2	2	0
fam6528	2	2	2	2.0	0.0	0.0	2	2	0
fam6529	2	2	2	2.0	0.0	0.0	2	2	0
fam6530	2	2	2	2.0	0.0	0.0	2	2	0
fam6531	2	2	2	2.0	0.0	0.0	2	2	0
fam6532	2	2	2	2.0	0.0	0.0	2	2	0
fam6533	2	2	2	2.0	0.0	0.0	2	2	0
fam6534	2	2	2	2.0	0.0	0.0	2	2	0
fam6535	2	2	2	2.0	0.0	0.0	2	2	0
fam6536	2	2	2	2.0	0.0	0.0	2	2	0
fam6537	2	2	2	2.0	0.0	0.0	2	2	0
fam6538	2	2	2	2.0	0.0	0.0	2	2	0
fam6539	2	2	2	2.0	0.0	0.0	2	2	0
fam6540	2	2	2	2.0	0.0	0.0	2	2	0
fam6541	2	2	2	2.0	0.0	0.0	2	2	0
fam6542	2	2	2	2.0	0.0	0.0	2	2	0
fam6543	2	2	2	2.0	0.0	0.0	2	2	0
fam6544	2	2	2	2.0	0.0	0.0	2	2	0
fam6545	2	2	2	2.0	0.0	0.0	2	2	0
fam6546	2	2	2	2.0	0.0	0.0	2	2	0
fam6547	2	2	2	2.0	0.0	0.0	2	2	0
fam6548	2	2	2	2.0	0.0	0.0	2	2	0
fam6549	2	2	2	2.0	0.0	0.0	2	2	0
fam6550	2	2	2	2.0	0.0	0.0	2	2	0
fam6551	2	2	2	2.0	0.0	0.0	2	2	0
fam6552	2	2	2	2.0	0.0	0.0	2	2	0
fam6553	2	2	2	2.0	0.0	0.0	2	2	0
fam6554	2	2	2	2.0	0.0	0.0	2	2	0
fam6555	2	2	2	2.0	0.0	0.0	2	2	0
fam6556	2	2	2	2.0	0.0	0.0	2	2	0
fam6557	2	2	2	2.0	0.0	0.0	2	2	0
fam6558	2	2	2	2.0	0.0	0.0	2	2	0
fam6559	2	2	2	2.0	0.0	0.0	2	2	0
fam6560	2	2	2	2.0	0.0	0.0	2	2	0
fam6561	2	2	2	2.0	0.0	0.0	2	2	0
fam6562	2	2	2	2.0	0.0	0.0	2	2	0
fam6563	2	2	2	2.0	0.0	0.0	2	2	0
fam6564	2	2	2	2.0	0.0	0.0	2	2	0
fam6565	2	2	2	2.0	0.0	0.0	2	2	0
fam6566	2	2	2	2.0	0.0	0.0	2	2	0
fam6567	2	2	2	2.0	0.0	0.0	2	2	0
fam6568	2	2	2	2.0	0.0	0.0	2	2	0
fam6569	2	2	2	2.0	0.0	0.0	2	2	0
fam6570	2	2	2	2.0	0.0	0.0	2	2	0
fam6571	2	2	2	2.0	0.0	0.0	2	2	0
fam6572	2	2	2	2.0	0.0	0.0	2	2	0
fam6573	2	2	2	2.0	0.0	0.0	2	2	0
fam6574	2	2	2	2.0	0.0	0.0	2	2	0
fam6575	2	2	2	2.0	0.0	0.0	2	2	0
fam6576	2	2	2	2.0	0.0	0.0	2	2	0
fam6577	2	2	2	2.0	0.0	0.0	2	2	0
fam6578	2	2	2	2.0	0.0	0.0	2	2	0
fam6579	2	2	2	2.0	0.0	0.0	2	2	0
fam6580	2	2	2	2.0	0.0	0.0	2	2	0
fam6581	2	2	2	2.0	0.0	0.0	2	2	0
fam6582	2	2	3	2.3333333333333335	0.5773502691896258	0.24743582965269678	3	2	1
fam6583	2	3	2	2.3333333333333335	0.5773502691896258	0.24743582965269678	3	2	1
fam6584	2	3	2	2.3333333333333335	0.5773502691896258	0.24743582965269678	3	2	1
fam6585	2	3	2	2.3333333333333335	0.5773502691896258	0.24743582965269678	3	2	1
fam6586	2	3	2	2.3333333333333335	0.5773502691896258	0.24743582965269678	3	2	1
fam6587	2	3	2	2.3333333333333335	0.5773502691896258	0.24743582965269678	3	2	1
fam6588	2	3	2	2.3333333333333335	0.5773502691896258	0.24743582965269678	3	2	1
fam6589	2	3	2	2.3333333333333335	0.5773502691896258	0.24743582965269678	3	2	1
fam6590	2	2	3	2.3333333333333335	0.5773502691896258	0.24743582965269678	3	2	1
fam6591	2	3	2	2.3333333333333335	0.5773502691896258	0.24743582965269678	3	2	1
fam6592	2	2	3	2.3333333333333335	0.5773502691896258	0.24743582965269678	3	2	1
fam6593	2	3	2	2.3333333333333335	0.5773502691896258	0.24743582965269678	3	2	1
fam6594	2	3	2	2.3333333333333335	0.5773502691896258	0.24743582965269678	3	2	1
fam6595	3	2	2	2.3333333333333335	0.5773502691896258	0.24743582965269678	3	2	1
fam6596	2	3	2	2.3333333333333335	0.5773502691896258	0.24743582965269678	3	2	1
fam6597	2	3	2	2.3333333333333335	0.5773502691896258	0.24743582965269678	3	2	1
fam6598	2	3	2	2.3333333333333335	0.5773502691896258	0.24743582965269678	3	2	1
fam6599	2	2	3	2.3333333333333335	0.5773502691896258	0.24743582965269678	3	2	1
fam6600	3	2	2	2.3333333333333335	0.5773502691896258	0.24743582965269678	3	2	1
fam6601	3	2	2	2.3333333333333335	0.5773502691896258	0.24743582965269678	3	2	1
fam6602	2	3	2	2.3333333333333335	0.5773502691896258	0.24743582965269678	3	2	1
fam6603	2	3	2	2.3333333333333335	0.5773502691896258	0.24743582965269678	3	2	1
fam6604	2	2	3	2.3333333333333335	0.5773502691896258	0.24743582965269678	3	2	1
fam6605	2	3	2	2.3333333333333335	0.5773502691896258	0.24743582965269678	3	2	1
fam6606	2	3	2	2.3333333333333335	0.5773502691896258	0.24743582965269678	3	2	1
fam6607	2	2	3	2.3333333333333335	0.5773502691896258	0.24743582965269678	3	2	1
fam6608	2	3	2	2.3333333333333335	0.5773502691896258	0.24743582965269678	3	2	1
fam6609	2	2	2	2.0	0.0	0.0	2	2	0
fam6610	2	3	2	2.3333333333333335	0.5773502691896258	0.24743582965269678	3	2	1
fam6611	2	3	2	2.3333333333333335	0.5773502691896258	0.24743582965269678	3	2	1
fam6612	2	2	3	2.3333333333333335	0.5773502691896258	0.24743582965269678	3	2	1
fam6613	2	3	2	2.3333333333333335	0.5773502691896258	0.24743582965269678	3	2	1
fam6614	2	3	2	2.3333333333333335	0.5773502691896258	0.24743582965269678	3	2	1
fam6615	2	2	3	2.3333333333333335	0.5773502691896258	0.24743582965269678	3	2	1
fam6616	2	2	3	2.3333333333333335	0.5773502691896258	0.24743582965269678	3	2	1
fam6617	2	3	2	2.3333333333333335	0.5773502691896258	0.24743582965269678	3	2	1
fam6618	2	2	3	2.3333333333333335	0.5773502691896258	0.24743582965269678	3	2	1
fam6619	2	3	2	2.3333333333333335	0.5773502691896258	0.24743582965269678	3	2	1
fam6620	2	2	3	2.3333333333333335	0.5773502691896258	0.24743582965269678	3	2	1
fam6621	3	2	2	2.3333333333333335	0.5773502691896258	0.24743582965269678	3	2	1
fam6622	2	3	2	2.3333333333333335	0.5773502691896258	0.24743582965269678	3	2	1
fam6623	2	2	3	2.3333333333333335	0.5773502691896258	0.24743582965269678	3	2	1
fam6624	2	2	3	2.3333333333333335	0.5773502691896258	0.24743582965269678	3	2	1
fam6625	2	3	2	2.3333333333333335	0.5773502691896258	0.24743582965269678	3	2	1
fam6626	2	3	2	2.3333333333333335	0.5773502691896258	0.24743582965269678	3	2	1
fam6627	2	3	2	2.3333333333333335	0.5773502691896258	0.24743582965269678	3	2	1
fam6628	3	2	2	2.3333333333333335	0.5773502691896258	0.24743582965269678	3	2	1
fam6629	2	2	3	2.3333333333333335	0.5773502691896258	0.24743582965269678	3	2	1
fam6630	2	3	2	2.3333333333333335	0.5773502691896258	0.24743582965269678	3	2	1
fam6631	2	3	2	2.3333333333333335	0.5773502691896258	0.24743582965269678	3	2	1
fam6632	2	2	3	2.3333333333333335	0.5773502691896258	0.24743582965269678	3	2	1
fam6633	2	3	2	2.3333333333333335	0.5773502691896258	0.24743582965269678	3	2	1
fam6634	2	3	2	2.3333333333333335	0.5773502691896258	0.24743582965269678	3	2	1
fam6635	2	3	2	2.3333333333333335	0.5773502691896258	0.24743582965269678	3	2	1
fam6636	2	2	3	2.3333333333333335	0.5773502691896258	0.24743582965269678	3	2	1
fam6637	2	3	2	2.3333333333333335	0.5773502691896258	0.24743582965269678	3	2	1
fam6638	2	3	2	2.3333333333333335	0.5773502691896258	0.24743582965269678	3	2	1
fam6639	2	3	2	2.3333333333333335	0.5773502691896258	0.24743582965269678	3	2	1
fam6640	2	3	2	2.3333333333333335	0.5773502691896258	0.24743582965269678	3	2	1
fam6641	2	2	3	2.3333333333333335	0.5773502691896258	0.24743582965269678	3	2	1
fam6642	2	2	3	2.3333333333333335	0.5773502691896258	0.24743582965269678	3	2	1
fam6643	2	3	2	2.3333333333333335	0.5773502691896258	0.24743582965269678	3	2	1
fam6644	2	2	3	2.3333333333333335	0.5773502691896258	0.24743582965269678	3	2	1
fam6645	2	3	2	2.3333333333333335	0.5773502691896258	0.24743582965269678	3	2	1
fam6646	2	3	2	2.3333333333333335	0.5773502691896258	0.24743582965269678	3	2	1
fam6647	2	3	2	2.3333333333333335	0.5773502691896258	0.24743582965269678	3	2	1
fam6648	2	2	3	2.3333333333333335	0.5773502691896258	0.24743582965269678	3	2	1
fam6649	2	3	2	2.3333333333333335	0.5773502691896258	0.24743582965269678	3	2	1
fam6650	2	3	2	2.3333333333333335	0.5773502691896258	0.24743582965269678	3	2	1
fam6651	2	3	2	2.3333333333333335	0.5773502691896258	0.24743582965269678	3	2	1
fam6652	2	3	2	2.3333333333333335	0.5773502691896258	0.24743582965269678	3	2	1
fam6653	2	3	2	2.3333333333333335	0.5773502691896258	0.24743582965269678	3	2	1
fam6654	3	2	2	2.3333333333333335	0.5773502691896258	0.24743582965269678	3	2	1
fam6655	2	2	2	2.0	0.0	0.0	2	2	0
fam6656	2	3	2	2.3333333333333335	0.5773502691896258	0.24743582965269678	3	2	1
fam6657	2	3	2	2.3333333333333335	0.5773502691896258	0.24743582965269678	3	2	1
fam6658	2	3	2	2.3333333333333335	0.5773502691896258	0.24743582965269678	3	2	1
fam6659	3	2	2	2.3333333333333335	0.5773502691896258	0.24743582965269678	3	2	1
fam6660	2	3	2	2.3333333333333335	0.5773502691896258	0.24743582965269678	3	2	1
fam6661	2	3	2	2.3333333333333335	0.5773502691896258	0.24743582965269678	3	2	1
fam6662	2	3	2	2.3333333333333335	0.5773502691896258	0.24743582965269678	3	2	1
fam6663	2	3	2	2.3333333333333335	0.5773502691896258	0.24743582965269678	3	2	1
fam6664	2	2	2	2.0	0.0	0.0	2	2	0
fam6665	2	3	2	2.3333333333333335	0.5773502691896258	0.24743582965269678	3	2	1
fam6666	2	3	2	2.3333333333333335	0.5773502691896258	0.24743582965269678	3	2	1
fam6667	2	3	2	2.3333333333333335	0.5773502691896258	0.24743582965269678	3	2	1
fam6668	2	3	2	2.3333333333333335	0.5773502691896258	0.24743582965269678	3	2	1
fam6669	2	3	2	2.3333333333333335	0.5773502691896258	0.24743582965269678	3	2	1
fam6670	2	3	2	2.3333333333333335	0.5773502691896258	0.24743582965269678	3	2	1
fam6671	2	3	2	2.3333333333333335	0.5773502691896258	0.24743582965269678	3	2	1
fam6672	2	3	2	2.3333333333333335	0.5773502691896258	0.24743582965269678	3	2	1
fam6673	2	3	2	2.3333333333333335	0.5773502691896258	0.24743582965269678	3	2	1
fam6674	2	3	2	2.3333333333333335	0.5773502691896258	0.24743582965269678	3	2	1
fam6675	2	3	2	2.3333333333333335	0.5773502691896258	0.24743582965269678	3	2	1
fam6676	2	3	2	2.3333333333333335	0.5773502691896258	0.24743582965269678	3	2	1
fam6677	2	2	3	2.3333333333333335	0.5773502691896258	0.24743582965269678	3	2	1
fam6678	2	3	2	2.3333333333333335	0.5773502691896258	0.24743582965269678	3	2	1
fam6679	2	3	2	2.3333333333333335	0.5773502691896258	0.24743582965269678	3	2	1
fam6680	2	3	2	2.3333333333333335	0.5773502691896258	0.24743582965269678	3	2	1
fam6681	2	3	2	2.3333333333333335	0.5773502691896258	0.24743582965269678	3	2	1
fam6682	2	3	2	2.3333333333333335	0.5773502691896258	0.24743582965269678	3	2	1
fam6683	2	3	2	2.3333333333333335	0.5773502691896258	0.24743582965269678	3	2	1
fam6684	2	3	2	2.3333333333333335	0.5773502691896258	0.24743582965269678	3	2	1
fam6685	2	3	2	2.3333333333333335	0.5773502691896258	0.24743582965269678	3	2	1
fam6686	2	3	2	2.3333333333333335	0.5773502691896258	0.24743582965269678	3	2	1
fam6687	2	3	2	2.3333333333333335	0.5773502691896258	0.24743582965269678	3	2	1
fam6688	3	2	2	2.3333333333333335	0.5773502691896258	0.24743582965269678	3	2	1
fam6689	2	2	2	2.0	0.0	0.0	2	2	0
fam6690	2	3	2	2.3333333333333335	0.5773502691896258	0.24743582965269678	3	2	1
fam6691	2	3	2	2.3333333333333335	0.5773502691896258	0.24743582965269678	3	2	1
fam6692	2	3	2	2.3333333333333335	0.5773502691896258	0.24743582965269678	3	2	1
fam6693	2	3	2	2.3333333333333335	0.5773502691896258	0.24743582965269678	3	2	1
fam6694	2	3	2	2.3333333333333335	0.5773502691896258	0.24743582965269678	3	2	1
fam6695	2	3	2	2.3333333333333335	0.5773502691896258	0.24743582965269678	3	2	1
fam6696	2	2	3	2.3333333333333335	0.5773502691896258	0.24743582965269678	3	2	1
fam6697	2	3	2	2.3333333333333335	0.5773502691896258	0.24743582965269678	3	2	1
fam6698	2	3	2	2.3333333333333335	0.5773502691896258	0.24743582965269678	3	2	1
fam6699	2	3	2	2.3333333333333335	0.5773502691896258	0.24743582965269678	3	2	1
fam6700	2	3	2	2.3333333333333335	0.5773502691896258	0.24743582965269678	3	2	1
fam6701	2	3	2	2.3333333333333335	0.5773502691896258	0.24743582965269678	3	2	1
fam6702	2	2	3	2.3333333333333335	0.5773502691896258	0.24743582965269678	3	2	1
fam6703	3	2	2	2.3333333333333335	0.5773502691896258	0.24743582965269678	3	2	1
fam6704	2	2	3	2.3333333333333335	0.5773502691896258	0.24743582965269678	3	2	1
fam6705	2	3	2	2.3333333333333335	0.5773502691896258	0.24743582965269678	3	2	1
fam6706	2	2	3	2.3333333333333335	0.5773502691896258	0.24743582965269678	3	2	1
fam6707	3	2	2	2.3333333333333335	0.5773502691896258	0.24743582965269678	3	2	1
fam6708	2	3	2	2.3333333333333335	0.5773502691896258	0.24743582965269678	3	2	1
fam6709	2	3	2	2.3333333333333335	0.5773502691896258	0.24743582965269678	3	2	1
fam6710	2	3	2	2.3333333333333335	0.5773502691896258	0.24743582965269678	3	2	1
fam6711	2	2	2	2.0	0.0	0.0	2	2	0
fam6712	2	3	2	2.3333333333333335	0.5773502691896258	0.24743582965269678	3	2	1
fam6713	2	2	3	2.3333333333333335	0.5773502691896258	0.24743582965269678	3	2	1
fam6714	2	2	2	2.0	0.0	0.0	2	2	0
fam6715	2	3	2	2.3333333333333335	0.5773502691896258	0.24743582965269678	3	2	1
fam6716	2	3	2	2.3333333333333335	0.5773502691896258	0.24743582965269678	3	2	1
fam6717	2	3	2	2.3333333333333335	0.5773502691896258	0.24743582965269678	3	2	1
fam6718	2	3	2	2.3333333333333335	0.5773502691896258	0.24743582965269678	3	2	1
fam6719	2	3	2	2.3333333333333335	0.5773502691896258	0.24743582965269678	3	2	1
fam6720	2	3	2	2.3333333333333335	0.5773502691896258	0.24743582965269678	3	2	1
fam6721	2	3	2	2.3333333333333335	0.5773502691896258	0.24743582965269678	3	2	1
fam6722	2	3	2	2.3333333333333335	0.5773502691896258	0.24743582965269678	3	2	1
fam6723	2	3	2	2.3333333333333335	0.5773502691896258	0.24743582965269678	3	2	1
fam6724	2	3	2	2.3333333333333335	0.5773502691896258	0.24743582965269678	3	2	1
fam6725	3	2	2	2.3333333333333335	0.5773502691896258	0.24743582965269678	3	2	1
fam6726	2	3	2	2.3333333333333335	0.5773502691896258	0.24743582965269678	3	2	1
fam6727	2	3	2	2.3333333333333335	0.5773502691896258	0.24743582965269678	3	2	1
fam6728	2	3	2	2.3333333333333335	0.5773502691896258	0.24743582965269678	3	2	1
fam6729	2	2	3	2.3333333333333335	0.5773502691896258	0.24743582965269678	3	2	1
fam6730	2	3	2	2.3333333333333335	0.5773502691896258	0.24743582965269678	3	2	1
fam6731	2	3	2	2.3333333333333335	0.5773502691896258	0.24743582965269678	3	2	1
fam6732	2	3	2	2.3333333333333335	0.5773502691896258	0.24743582965269678	3	2	1
fam6733	2	3	2	2.3333333333333335	0.5773502691896258	0.24743582965269678	3	2	1
fam6734	2	2	3	2.3333333333333335	0.5773502691896258	0.24743582965269678	3	2	1
fam6735	2	3	2	2.3333333333333335	0.5773502691896258	0.24743582965269678	3	2	1
fam6736	2	3	2	2.3333333333333335	0.5773502691896258	0.24743582965269678	3	2	1
fam6737	2	2	3	2.3333333333333335	0.5773502691896258	0.24743582965269678	3	2	1
fam6738	2	3	2	2.3333333333333335	0.5773502691896258	0.24743582965269678	3	2	1
fam6739	2	3	2	2.3333333333333335	0.5773502691896258	0.24743582965269678	3	2	1
fam6740	2	2	3	2.3333333333333335	0.5773502691896258	0.24743582965269678	3	2	1
fam6741	2	3	2	2.3333333333333335	0.5773502691896258	0.24743582965269678	3	2	1
fam6742	2	3	2	2.3333333333333335	0.5773502691896258	0.24743582965269678	3	2	1
fam6743	2	2	3	2.3333333333333335	0.5773502691896258	0.24743582965269678	3	2	1
fam6744	3	2	2	2.3333333333333335	0.5773502691896258	0.24743582965269678	3	2	1
fam6745	3	2	2	2.3333333333333335	0.5773502691896258	0.24743582965269678	3	2	1
fam6746	2	3	2	2.3333333333333335	0.5773502691896258	0.24743582965269678	3	2	1
fam6747	2	3	2	2.3333333333333335	0.5773502691896258	0.24743582965269678	3	2	1
fam6748	2	3	2	2.3333333333333335	0.5773502691896258	0.24743582965269678	3	2	1
fam6749	2	3	2	2.3333333333333335	0.5773502691896258	0.24743582965269678	3	2	1
fam6750	2	3	2	2.3333333333333335	0.5773502691896258	0.24743582965269678	3	2	1
fam6751	2	2	3	2.3333333333333335	0.5773502691896258	0.24743582965269678	3	2	1
fam6752	2	2	3	2.3333333333333335	0.5773502691896258	0.24743582965269678	3	2	1
fam6753	2	3	2	2.3333333333333335	0.5773502691896258	0.24743582965269678	3	2	1
fam6754	2	3	2	2.3333333333333335	0.5773502691896258	0.24743582965269678	3	2	1
fam6755	2	2	2	2.0	0.0	0.0	2	2	0
fam6756	2	3	2	2.3333333333333335	0.5773502691896258	0.24743582965269678	3	2	1
fam6757	2	3	2	2.3333333333333335	0.5773502691896258	0.24743582965269678	3	2	1
fam6758	2	3	2	2.3333333333333335	0.5773502691896258	0.24743582965269678	3	2	1
fam6759	2	3	2	2.3333333333333335	0.5773502691896258	0.24743582965269678	3	2	1
fam6760	2	3	2	2.3333333333333335	0.5773502691896258	0.24743582965269678	3	2	1
fam6761	2	3	2	2.3333333333333335	0.5773502691896258	0.24743582965269678	3	2	1
fam6762	2	3	2	2.3333333333333335	0.5773502691896258	0.24743582965269678	3	2	1
fam6763	2	2	2	2.0	0.0	0.0	2	2	0
fam6764	3	2	2	2.3333333333333335	0.5773502691896258	0.24743582965269678	3	2	1
fam6765	2	3	2	2.3333333333333335	0.5773502691896258	0.24743582965269678	3	2	1
fam6766	2	3	2	2.3333333333333335	0.5773502691896258	0.24743582965269678	3	2	1
fam6767	2	3	2	2.3333333333333335	0.5773502691896258	0.24743582965269678	3	2	1
fam6768	2	3	2	2.3333333333333335	0.5773502691896258	0.24743582965269678	3	2	1
fam6769	2	2	2	2.0	0.0	0.0	2	2	0
fam6770	2	3	2	2.3333333333333335	0.5773502691896258	0.24743582965269678	3	2	1
fam6771	2	2	2	2.0	0.0	0.0	2	2	0
fam6772	2	3	2	2.3333333333333335	0.5773502691896258	0.24743582965269678	3	2	1
fam6773	2	3	2	2.3333333333333335	0.5773502691896258	0.24743582965269678	3	2	1
fam6774	2	3	2	2.3333333333333335	0.5773502691896258	0.24743582965269678	3	2	1
fam6775	2	3	2	2.3333333333333335	0.5773502691896258	0.24743582965269678	3	2	1
fam6776	2	2	3	2.3333333333333335	0.5773502691896258	0.24743582965269678	3	2	1
fam6777	2	3	2	2.3333333333333335	0.5773502691896258	0.24743582965269678	3	2	1
fam6778	2	3	2	2.3333333333333335	0.5773502691896258	0.24743582965269678	3	2	1
fam6779	2	3	2	2.3333333333333335	0.5773502691896258	0.24743582965269678	3	2	1
fam6780	2	3	2	2.3333333333333335	0.5773502691896258	0.24743582965269678	3	2	1
fam6781	2	3	2	2.3333333333333335	0.5773502691896258	0.24743582965269678	3	2	1
fam6782	3	2	2	2.3333333333333335	0.5773502691896258	0.24743582965269678	3	2	1
fam6783	2	2	3	2.3333333333333335	0.5773502691896258	0.24743582965269678	3	2	1
fam6784	2	3	2	2.3333333333333335	0.5773502691896258	0.24743582965269678	3	2	1
fam6785	2	3	2	2.3333333333333335	0.5773502691896258	0.24743582965269678	3	2	1
fam6786	2	3	2	2.3333333333333335	0.5773502691896258	0.24743582965269678	3	2	1
fam6787	2	2	2	2.0	0.0	0.0	2	2	0
fam6788	2	3	2	2.3333333333333335	0.5773502691896258	0.24743582965269678	3	2	1
fam6789	2	3	2	2.3333333333333335	0.5773502691896258	0.24743582965269678	3	2	1
fam6790	2	2	3	2.3333333333333335	0.5773502691896258	0.24743582965269678	3	2	1
fam6791	2	2	2	2.0	0.0	0.0	2	2	0
fam6792	2	2	3	2.3333333333333335	0.5773502691896258	0.24743582965269678	3	2	1
fam6793	2	3	2	2.3333333333333335	0.5773502691896258	0.24743582965269678	3	2	1
fam6794	2	3	2	2.3333333333333335	0.5773502691896258	0.24743582965269678	3	2	1
fam6795	2	3	2	2.3333333333333335	0.5773502691896258	0.24743582965269678	3	2	1
fam6796	2	2	3	2.3333333333333335	0.5773502691896258	0.24743582965269678	3	2	1
fam6797	2	2	3	2.3333333333333335	0.5773502691896258	0.24743582965269678	3	2	1
fam6798	2	3	2	2.3333333333333335	0.5773502691896258	0.24743582965269678	3	2	1
fam6799	2	3	2	2.3333333333333335	0.5773502691896258	0.24743582965269678	3	2	1
fam6800	2	3	2	2.3333333333333335	0.5773502691896258	0.24743582965269678	3	2	1
fam6801	2	2	2	2.0	0.0	0.0	2	2	0
fam6802	2	2	3	2.3333333333333335	0.5773502691896258	0.24743582965269678	3	2	1
fam6803	2	3	2	2.3333333333333335	0.5773502691896258	0.24743582965269678	3	2	1
fam6804	2	3	2	2.3333333333333335	0.5773502691896258	0.24743582965269678	3	2	1
fam6805	2	3	2	2.3333333333333335	0.5773502691896258	0.24743582965269678	3	2	1
fam6806	2	2	2	2.0	0.0	0.0	2	2	0
fam6807	2	3	2	2.3333333333333335	0.5773502691896258	0.24743582965269678	3	2	1
fam6808	2	3	2	2.3333333333333335	0.5773502691896258	0.24743582965269678	3	2	1
fam6809	2	3	2	2.3333333333333335	0.5773502691896258	0.24743582965269678	3	2	1
fam6810	2	2	3	2.3333333333333335	0.5773502691896258	0.24743582965269678	3	2	1
fam6811	2	3	2	2.3333333333333335	0.5773502691896258	0.24743582965269678	3	2	1
fam6812	2	3	2	2.3333333333333335	0.5773502691896258	0.24743582965269678	3	2	1
fam6813	2	2	2	2.0	0.0	0.0	2	2	0
fam6814	2	3	2	2.3333333333333335	0.5773502691896258	0.24743582965269678	3	2	1
fam6815	2	2	3	2.3333333333333335	0.5773502691896258	0.24743582965269678	3	2	1
fam6816	2	3	2	2.3333333333333335	0.5773502691896258	0.24743582965269678	3	2	1
fam6817	3	2	2	2.3333333333333335	0.5773502691896258	0.24743582965269678	3	2	1
fam6818	2	3	2	2.3333333333333335	0.5773502691896258	0.24743582965269678	3	2	1
fam6819	2	3	2	2.3333333333333335	0.5773502691896258	0.24743582965269678	3	2	1
fam6820	2	3	2	2.3333333333333335	0.5773502691896258	0.24743582965269678	3	2	1
fam6821	2	2	3	2.3333333333333335	0.5773502691896258	0.24743582965269678	3	2	1
fam6822	2	3	2	2.3333333333333335	0.5773502691896258	0.24743582965269678	3	2	1
fam6823	2	2	3	2.3333333333333335	0.5773502691896258	0.24743582965269678	3	2	1
fam6824	2	3	2	2.3333333333333335	0.5773502691896258	0.24743582965269678	3	2	1
fam6825	2	3	2	2.3333333333333335	0.5773502691896258	0.24743582965269678	3	2	1
fam6826	2	3	2	2.3333333333333335	0.5773502691896258	0.24743582965269678	3	2	1
fam6827	2	3	2	2.3333333333333335	0.5773502691896258	0.24743582965269678	3	2	1
fam6828	2	3	2	2.3333333333333335	0.5773502691896258	0.24743582965269678	3	2	1
fam6829	2	3	2	2.3333333333333335	0.5773502691896258	0.24743582965269678	3	2	1
fam6830	2	3	2	2.3333333333333335	0.5773502691896258	0.24743582965269678	3	2	1
fam6831	2	3	2	2.3333333333333335	0.5773502691896258	0.24743582965269678	3	2	1
fam6832	2	3	2	2.3333333333333335	0.5773502691896258	0.24743582965269678	3	2	1
fam6833	3	2	2	2.3333333333333335	0.5773502691896258	0.24743582965269678	3	2	1
fam6834	2	3	2	2.3333333333333335	0.5773502691896258	0.24743582965269678	3	2	1
fam6835	2	2	3	2.3333333333333335	0.5773502691896258	0.24743582965269678	3	2	1
fam6836	3	2	2	2.3333333333333335	0.5773502691896258	0.24743582965269678	3	2	1
fam6837	2	3	2	2.3333333333333335	0.5773502691896258	0.24743582965269678	3	2	1
fam6838	2	3	2	2.3333333333333335	0.5773502691896258	0.24743582965269678	3	2	1
fam6839	2	3	2	2.3333333333333335	0.5773502691896258	0.24743582965269678	3	2	1
fam6840	2	3	2	2.3333333333333335	0.5773502691896258	0.24743582965269678	3	2	1
fam6841	2	3	2	2.3333333333333335	0.5773502691896258	0.24743582965269678	3	2	1
fam6842	2	3	2	2.3333333333333335	0.5773502691896258	0.24743582965269678	3	2	1
fam6843	2	3	2	2.3333333333333335	0.5773502691896258	0.24743582965269678	3	2	1
fam6844	2	3	2	2.3333333333333335	0.5773502691896258	0.24743582965269678	3	2	1
fam6845	2	3	2	2.3333333333333335	0.5773502691896258	0.24743582965269678	3	2	1
fam6846	2	2	3	2.3333333333333335	0.5773502691896258	0.24743582965269678	3	2	1
fam6847	2	2	3	2.3333333333333335	0.5773502691896258	0.24743582965269678	3	2	1
fam6848	2	3	2	2.3333333333333335	0.5773502691896258	0.24743582965269678	3	2	1
fam6849	2	3	2	2.3333333333333335	0.5773502691896258	0.24743582965269678	3	2	1
fam6850	2	3	2	2.3333333333333335	0.5773502691896258	0.24743582965269678	3	2	1
fam6851	2	3	2	2.3333333333333335	0.5773502691896258	0.24743582965269678	3	2	1
fam6852	2	3	2	2.3333333333333335	0.5773502691896258	0.24743582965269678	3	2	1
fam6853	2	3	2	2.3333333333333335	0.5773502691896258	0.24743582965269678	3	2	1
fam6854	2	3	2	2.3333333333333335	0.5773502691896258	0.24743582965269678	3	2	1
fam6855	2	3	2	2.3333333333333335	0.5773502691896258	0.24743582965269678	3	2	1
fam6856	2	3	2	2.3333333333333335	0.5773502691896258	0.24743582965269678	3	2	1
fam6857	2	3	2	2.3333333333333335	0.5773502691896258	0.24743582965269678	3	2	1
fam6858	2	2	3	2.3333333333333335	0.5773502691896258	0.24743582965269678	3	2	1
fam6859	2	2	3	2.3333333333333335	0.5773502691896258	0.24743582965269678	3	2	1
fam6860	2	2	3	2.3333333333333335	0.5773502691896258	0.24743582965269678	3	2	1
fam6861	2	3	2	2.3333333333333335	0.5773502691896258	0.24743582965269678	3	2	1
fam6862	2	3	2	2.3333333333333335	0.5773502691896258	0.24743582965269678	3	2	1
fam6863	2	3	2	2.3333333333333335	0.5773502691896258	0.24743582965269678	3	2	1
fam6864	2	2	3	2.3333333333333335	0.5773502691896258	0.24743582965269678	3	2	1
fam6865	2	3	2	2.3333333333333335	0.5773502691896258	0.24743582965269678	3	2	1
fam6866	3	2	2	2.3333333333333335	0.5773502691896258	0.24743582965269678	3	2	1
fam6867	2	2	3	2.3333333333333335	0.5773502691896258	0.24743582965269678	3	2	1
fam6868	2	3	2	2.3333333333333335	0.5773502691896258	0.24743582965269678	3	2	1
fam6869	2	2	3	2.3333333333333335	0.5773502691896258	0.24743582965269678	3	2	1
fam6870	2	3	2	2.3333333333333335	0.5773502691896258	0.24743582965269678	3	2	1
fam6871	2	3	2	2.3333333333333335	0.5773502691896258	0.24743582965269678	3	2	1
fam6872	2	3	2	2.3333333333333335	0.5773502691896258	0.24743582965269678	3	2	1
fam6873	2	2	2	2.0	0.0	0.0	2	2	0
fam6874	2	3	2	2.3333333333333335	0.5773502691896258	0.24743582965269678	3	2	1
fam6875	2	3	2	2.3333333333333335	0.5773502691896258	0.24743582965269678	3	2	1
fam6876	2	3	2	2.3333333333333335	0.5773502691896258	0.24743582965269678	3	2	1
fam6877	2	3	2	2.3333333333333335	0.5773502691896258	0.24743582965269678	3	2	1
fam6878	2	2	2	2.0	0.0	0.0	2	2	0
fam6879	2	3	2	2.3333333333333335	0.5773502691896258	0.24743582965269678	3	2	1
fam6880	2	3	2	2.3333333333333335	0.5773502691896258	0.24743582965269678	3	2	1
fam6881	2	3	2	2.3333333333333335	0.5773502691896258	0.24743582965269678	3	2	1
fam6882	2	3	2	2.3333333333333335	0.5773502691896258	0.24743582965269678	3	2	1
fam6883	2	3	2	2.3333333333333335	0.5773502691896258	0.24743582965269678	3	2	1
fam6884	2	2	3	2.3333333333333335	0.5773502691896258	0.24743582965269678	3	2	1
fam6885	2	3	2	2.3333333333333335	0.5773502691896258	0.24743582965269678	3	2	1
fam6886	2	3	2	2.3333333333333335	0.5773502691896258	0.24743582965269678	3	2	1
fam6887	2	3	2	2.3333333333333335	0.5773502691896258	0.24743582965269678	3	2	1
fam6888	2	3	2	2.3333333333333335	0.5773502691896258	0.24743582965269678	3	2	1
fam6889	2	2	3	2.3333333333333335	0.5773502691896258	0.24743582965269678	3	2	1
fam6890	2	3	2	2.3333333333333335	0.5773502691896258	0.24743582965269678	3	2	1
fam6891	2	3	2	2.3333333333333335	0.5773502691896258	0.24743582965269678	3	2	1
fam6892	2	3	2	2.3333333333333335	0.5773502691896258	0.24743582965269678	3	2	1
fam6893	2	2	3	2.3333333333333335	0.5773502691896258	0.24743582965269678	3	2	1
fam6894	3	2	2	2.3333333333333335	0.5773502691896258	0.24743582965269678	3	2	1
fam6895	2	3	2	2.3333333333333335	0.5773502691896258	0.24743582965269678	3	2	1
fam6896	2	3	2	2.3333333333333335	0.5773502691896258	0.24743582965269678	3	2	1
fam6897	3	2	2	2.3333333333333335	0.5773502691896258	0.24743582965269678	3	2	1
fam6898	2	3	2	2.3333333333333335	0.5773502691896258	0.24743582965269678	3	2	1
fam6899	3	2	2	2.3333333333333335	0.5773502691896258	0.24743582965269678	3	2	1
fam6900	2	2	3	2.3333333333333335	0.5773502691896258	0.24743582965269678	3	2	1
fam6901	2	3	2	2.3333333333333335	0.5773502691896258	0.24743582965269678	3	2	1
fam6902	2	3	2	2.3333333333333335	0.5773502691896258	0.24743582965269678	3	2	1
fam6903	2	3	2	2.3333333333333335	0.5773502691896258	0.24743582965269678	3	2	1
fam6904	2	3	2	2.3333333333333335	0.5773502691896258	0.24743582965269678	3	2	1
fam6905	2	3	2	2.3333333333333335	0.5773502691896258	0.24743582965269678	3	2	1
fam6906	2	3	2	2.3333333333333335	0.5773502691896258	0.24743582965269678	3	2	1
fam6907	2	3	2	2.3333333333333335	0.5773502691896258	0.24743582965269678	3	2	1
fam6908	2	3	2	2.3333333333333335	0.5773502691896258	0.24743582965269678	3	2	1
fam6909	2	3	2	2.3333333333333335	0.5773502691896258	0.24743582965269678	3	2	1
fam6910	2	2	3	2.3333333333333335	0.5773502691896258	0.24743582965269678	3	2	1
fam6911	2	3	2	2.3333333333333335	0.5773502691896258	0.24743582965269678	3	2	1
fam6912	2	3	2	2.3333333333333335	0.5773502691896258	0.24743582965269678	3	2	1
fam6913	2	3	2	2.3333333333333335	0.5773502691896258	0.24743582965269678	3	2	1
fam6914	2	3	2	2.3333333333333335	0.5773502691896258	0.24743582965269678	3	2	1
fam6915	3	2	2	2.3333333333333335	0.5773502691896258	0.24743582965269678	3	2	1
fam6916	2	3	2	2.3333333333333335	0.5773502691896258	0.24743582965269678	3	2	1
fam6917	2	3	2	2.3333333333333335	0.5773502691896258	0.24743582965269678	3	2	1
fam6918	2	3	2	2.3333333333333335	0.5773502691896258	0.24743582965269678	3	2	1
fam6919	2	3	2	2.3333333333333335	0.5773502691896258	0.24743582965269678	3	2	1
fam6920	3	2	2	2.3333333333333335	0.5773502691896258	0.24743582965269678	3	2	1
fam6921	2	3	2	2.3333333333333335	0.5773502691896258	0.24743582965269678	3	2	1
fam6922	2	3	2	2.3333333333333335	0.5773502691896258	0.24743582965269678	3	2	1
fam6923	2	3	2	2.3333333333333335	0.5773502691896258	0.24743582965269678	3	2	1
fam6924	2	3	2	2.3333333333333335	0.5773502691896258	0.24743582965269678	3	2	1
fam6925	2	3	2	2.3333333333333335	0.5773502691896258	0.24743582965269678	3	2	1
fam6926	2	3	2	2.3333333333333335	0.5773502691896258	0.24743582965269678	3	2	1
fam6927	2	2	3	2.3333333333333335	0.5773502691896258	0.24743582965269678	3	2	1
fam6928	2	3	2	2.3333333333333335	0.5773502691896258	0.24743582965269678	3	2	1
fam6929	2	3	2	2.3333333333333335	0.5773502691896258	0.24743582965269678	3	2	1
fam6930	3	2	2	2.3333333333333335	0.5773502691896258	0.24743582965269678	3	2	1
fam6931	2	3	2	2.3333333333333335	0.5773502691896258	0.24743582965269678	3	2	1
fam6932	2	3	2	2.3333333333333335	0.5773502691896258	0.24743582965269678	3	2	1
fam6933	2	2	3	2.3333333333333335	0.5773502691896258	0.24743582965269678	3	2	1
fam6934	2	2	3	2.3333333333333335	0.5773502691896258	0.24743582965269678	3	2	1
fam6935	2	3	2	2.3333333333333335	0.5773502691896258	0.24743582965269678	3	2	1
fam6936	2	3	2	2.3333333333333335	0.5773502691896258	0.24743582965269678	3	2	1
fam6937	3	2	2	2.3333333333333335	0.5773502691896258	0.24743582965269678	3	2	1
fam6938	2	2	3	2.3333333333333335	0.5773502691896258	0.24743582965269678	3	2	1
fam6939	2	2	3	2.3333333333333335	0.5773502691896258	0.24743582965269678	3	2	1
fam6940	2	2	3	2.3333333333333335	0.5773502691896258	0.24743582965269678	3	2	1
fam6941	2	3	2	2.3333333333333335	0.5773502691896258	0.24743582965269678	3	2	1
fam6942	2	2	3	2.3333333333333335	0.5773502691896258	0.24743582965269678	3	2	1
fam6943	2	3	2	2.3333333333333335	0.5773502691896258	0.24743582965269678	3	2	1
fam6944	2	3	2	2.3333333333333335	0.5773502691896258	0.24743582965269678	3	2	1
fam6945	2	3	2	2.3333333333333335	0.5773502691896258	0.24743582965269678	3	2	1
fam6946	2	2	3	2.3333333333333335	0.5773502691896258	0.24743582965269678	3	2	1
fam6947	3	2	2	2.3333333333333335	0.5773502691896258	0.24743582965269678	3	2	1
fam6948	2	2	3	2.3333333333333335	0.5773502691896258	0.24743582965269678	3	2	1
fam6949	2	3	2	2.3333333333333335	0.5773502691896258	0.24743582965269678	3	2	1
fam6950	2	3	2	2.3333333333333335	0.5773502691896258	0.24743582965269678	3	2	1
fam6951	2	2	3	2.3333333333333335	0.5773502691896258	0.24743582965269678	3	2	1
fam6952	2	3	2	2.3333333333333335	0.5773502691896258	0.24743582965269678	3	2	1
fam6953	2	3	2	2.3333333333333335	0.5773502691896258	0.24743582965269678	3	2	1
fam6954	2	3	2	2.3333333333333335	0.5773502691896258	0.24743582965269678	3	2	1
fam6955	2	3	2	2.3333333333333335	0.5773502691896258	0.24743582965269678	3	2	1
fam6956	2	3	2	2.3333333333333335	0.5773502691896258	0.24743582965269678	3	2	1
fam6957	2	3	2	2.3333333333333335	0.5773502691896258	0.24743582965269678	3	2	1
fam6958	2	3	2	2.3333333333333335	0.5773502691896258	0.24743582965269678	3	2	1
fam6959	2	3	2	2.3333333333333335	0.5773502691896258	0.24743582965269678	3	2	1
fam6960	2	3	2	2.3333333333333335	0.5773502691896258	0.24743582965269678	3	2	1
fam6961	2	3	2	2.3333333333333335	0.5773502691896258	0.24743582965269678	3	2	1
fam6962	2	3	2	2.3333333333333335	0.5773502691896258	0.24743582965269678	3	2	1
fam6963	2	2	3	2.3333333333333335	0.5773502691896258	0.24743582965269678	3	2	1
fam6964	2	3	2	2.3333333333333335	0.5773502691896258	0.24743582965269678	3	2	1
fam6965	2	3	2	2.3333333333333335	0.5773502691896258	0.24743582965269678	3	2	1
fam6966	2	2	3	2.3333333333333335	0.5773502691896258	0.24743582965269678	3	2	1
fam6967	2	2	3	2.3333333333333335	0.5773502691896258	0.24743582965269678	3	2	1
fam6968	2	3	2	2.3333333333333335	0.5773502691896258	0.24743582965269678	3	2	1
fam6969	2	2	2	2.0	0.0	0.0	2	2	0
fam6970	2	2	3	2.3333333333333335	0.5773502691896258	0.24743582965269678	3	2	1
fam6971	2	3	2	2.3333333333333335	0.5773502691896258	0.24743582965269678	3	2	1
fam6972	2	3	2	2.3333333333333335	0.5773502691896258	0.24743582965269678	3	2	1
fam6973	2	2	3	2.3333333333333335	0.5773502691896258	0.24743582965269678	3	2	1
fam6974	2	3	2	2.3333333333333335	0.5773502691896258	0.24743582965269678	3	2	1
fam6975	2	3	2	2.3333333333333335	0.5773502691896258	0.24743582965269678	3	2	1
fam6976	2	3	2	2.3333333333333335	0.5773502691896258	0.24743582965269678	3	2	1
fam6977	2	3	2	2.3333333333333335	0.5773502691896258	0.24743582965269678	3	2	1
fam6978	2	3	2	2.3333333333333335	0.5773502691896258	0.24743582965269678	3	2	1
fam6979	2	2	3	2.3333333333333335	0.5773502691896258	0.24743582965269678	3	2	1
fam6980	2	3	2	2.3333333333333335	0.5773502691896258	0.24743582965269678	3	2	1
fam6981	2	3	2	2.3333333333333335	0.5773502691896258	0.24743582965269678	3	2	1
fam6982	2	2	2	2.0	0.0	0.0	2	2	0
fam6983	2	3	2	2.3333333333333335	0.5773502691896258	0.24743582965269678	3	2	1
fam6984	2	3	2	2.3333333333333335	0.5773502691896258	0.24743582965269678	3	2	1
fam6985	2	3	2	2.3333333333333335	0.5773502691896258	0.24743582965269678	3	2	1
fam6986	2	3	2	2.3333333333333335	0.5773502691896258	0.24743582965269678	3	2	1
fam6987	2	3	2	2.3333333333333335	0.5773502691896258	0.24743582965269678	3	2	1
fam6988	2	3	2	2.3333333333333335	0.5773502691896258	0.24743582965269678	3	2	1
fam6989	2	2	3	2.3333333333333335	0.5773502691896258	0.24743582965269678	3	2	1
fam6990	2	3	2	2.3333333333333335	0.5773502691896258	0.24743582965269678	3	2	1
fam6991	2	3	2	2.3333333333333335	0.5773502691896258	0.24743582965269678	3	2	1
fam6992	2	3	2	2.3333333333333335	0.5773502691896258	0.24743582965269678	3	2	1
fam6993	2	3	2	2.3333333333333335	0.5773502691896258	0.24743582965269678	3	2	1
fam6994	2	3	2	2.3333333333333335	0.5773502691896258	0.24743582965269678	3	2	1
fam6995	2	3	2	2.3333333333333335	0.5773502691896258	0.24743582965269678	3	2	1
fam6996	2	3	2	2.3333333333333335	0.5773502691896258	0.24743582965269678	3	2	1
fam6997	2	3	2	2.3333333333333335	0.5773502691896258	0.24743582965269678	3	2	1
fam6998	2	3	2	2.3333333333333335	0.5773502691896258	0.24743582965269678	3	2	1
fam6999	2	3	2	2.3333333333333335	0.5773502691896258	0.24743582965269678	3	2	1
fam7000	2	3	2	2.3333333333333335	0.5773502691896258	0.24743582965269678	3	2	1
fam7001	2	3	2	2.3333333333333335	0.5773502691896258	0.24743582965269678	3	2	1
fam7002	2	3	2	2.3333333333333335	0.5773502691896258	0.24743582965269678	3	2	1
fam7003	2	3	2	2.3333333333333335	0.5773502691896258	0.24743582965269678	3	2	1
fam7004	2	2	3	2.3333333333333335	0.5773502691896258	0.24743582965269678	3	2	1
fam7005	3	2	2	2.3333333333333335	0.5773502691896258	0.24743582965269678	3	2	1
fam7006	2	3	2	2.3333333333333335	0.5773502691896258	0.24743582965269678	3	2	1
fam7007	2	3	2	2.3333333333333335	0.5773502691896258	0.24743582965269678	3	2	1
fam7008	2	3	2	2.3333333333333335	0.5773502691896258	0.24743582965269678	3	2	1
fam7009	2	3	2	2.3333333333333335	0.5773502691896258	0.24743582965269678	3	2	1
fam7010	2	3	2	2.3333333333333335	0.5773502691896258	0.24743582965269678	3	2	1
fam7011	3	2	2	2.3333333333333335	0.5773502691896258	0.24743582965269678	3	2	1
fam7012	2	3	2	2.3333333333333335	0.5773502691896258	0.24743582965269678	3	2	1
fam7013	2	3	2	2.3333333333333335	0.5773502691896258	0.24743582965269678	3	2	1
fam7014	2	3	2	2.3333333333333335	0.5773502691896258	0.24743582965269678	3	2	1
fam7015	2	3	2	2.3333333333333335	0.5773502691896258	0.24743582965269678	3	2	1
fam7016	2	3	2	2.3333333333333335	0.5773502691896258	0.24743582965269678	3	2	1
fam7017	2	2	3	2.3333333333333335	0.5773502691896258	0.24743582965269678	3	2	1
fam7018	2	3	2	2.3333333333333335	0.5773502691896258	0.24743582965269678	3	2	1
fam7019	2	3	2	2.3333333333333335	0.5773502691896258	0.24743582965269678	3	2	1
fam7020	2	3	2	2.3333333333333335	0.5773502691896258	0.24743582965269678	3	2	1
fam7021	2	3	2	2.3333333333333335	0.5773502691896258	0.24743582965269678	3	2	1
fam7022	2	3	2	2.3333333333333335	0.5773502691896258	0.24743582965269678	3	2	1
fam7023	2	3	2	2.3333333333333335	0.5773502691896258	0.24743582965269678	3	2	1
fam7024	2	3	2	2.3333333333333335	0.5773502691896258	0.24743582965269678	3	2	1
fam7025	2	3	2	2.3333333333333335	0.5773502691896258	0.24743582965269678	3	2	1
fam7026	2	2	3	2.3333333333333335	0.5773502691896258	0.24743582965269678	3	2	1
fam7027	2	3	2	2.3333333333333335	0.5773502691896258	0.24743582965269678	3	2	1
fam7028	2	3	2	2.3333333333333335	0.5773502691896258	0.24743582965269678	3	2	1
fam7029	2	3	2	2.3333333333333335	0.5773502691896258	0.24743582965269678	3	2	1
fam7030	2	3	2	2.3333333333333335	0.5773502691896258	0.24743582965269678	3	2	1
fam7031	2	3	2	2.3333333333333335	0.5773502691896258	0.24743582965269678	3	2	1
fam7032	2	2	3	2.3333333333333335	0.5773502691896258	0.24743582965269678	3	2	1
fam7033	2	3	2	2.3333333333333335	0.5773502691896258	0.24743582965269678	3	2	1
fam7034	2	2	3	2.3333333333333335	0.5773502691896258	0.24743582965269678	3	2	1
fam7035	2	2	3	2.3333333333333335	0.5773502691896258	0.24743582965269678	3	2	1
fam7036	3	2	2	2.3333333333333335	0.5773502691896258	0.24743582965269678	3	2	1
fam7037	3	2	2	2.3333333333333335	0.5773502691896258	0.24743582965269678	3	2	1
fam7038	2	3	2	2.3333333333333335	0.5773502691896258	0.24743582965269678	3	2	1
fam7039	2	3	2	2.3333333333333335	0.5773502691896258	0.24743582965269678	3	2	1
fam7040	2	3	2	2.3333333333333335	0.5773502691896258	0.24743582965269678	3	2	1
fam7041	2	2	3	2.3333333333333335	0.5773502691896258	0.24743582965269678	3	2	1
fam7042	3	2	2	2.3333333333333335	0.5773502691896258	0.24743582965269678	3	2	1
fam7043	2	2	3	2.3333333333333335	0.5773502691896258	0.24743582965269678	3	2	1
fam7044	3	2	2	2.3333333333333335	0.5773502691896258	0.24743582965269678	3	2	1
fam7045	2	3	2	2.3333333333333335	0.5773502691896258	0.24743582965269678	3	2	1
fam7046	3	2	2	2.3333333333333335	0.5773502691896258	0.24743582965269678	3	2	1
fam7047	2	3	2	2.3333333333333335	0.5773502691896258	0.24743582965269678	3	2	1
fam7048	2	3	2	2.3333333333333335	0.5773502691896258	0.24743582965269678	3	2	1
fam7049	2	2	2	2.0	0.0	0.0	2	2	0
fam7050	3	2	2	2.3333333333333335	0.5773502691896258	0.24743582965269678	3	2	1
fam7051	2	2	3	2.3333333333333335	0.5773502691896258	0.24743582965269678	3	2	1
fam7052	2	3	2	2.3333333333333335	0.5773502691896258	0.24743582965269678	3	2	1
fam7053	2	2	3	2.3333333333333335	0.5773502691896258	0.24743582965269678	3	2	1
fam7054	2	3	2	2.3333333333333335	0.5773502691896258	0.24743582965269678	3	2	1
fam7055	2	3	2	2.3333333333333335	0.5773502691896258	0.24743582965269678	3	2	1
fam7056	3	2	2	2.3333333333333335	0.5773502691896258	0.24743582965269678	3	2	1
fam7057	2	2	2	2.0	0.0	0.0	2	2	0
fam7058	2	2	3	2.3333333333333335	0.5773502691896258	0.24743582965269678	3	2	1
fam7059	2	3	2	2.3333333333333335	0.5773502691896258	0.24743582965269678	3	2	1
fam7060	2	3	2	2.3333333333333335	0.5773502691896258	0.24743582965269678	3	2	1
fam7061	2	3	2	2.3333333333333335	0.5773502691896258	0.24743582965269678	3	2	1
fam7062	2	3	2	2.3333333333333335	0.5773502691896258	0.24743582965269678	3	2	1
fam7063	2	2	3	2.3333333333333335	0.5773502691896258	0.24743582965269678	3	2	1
fam7064	2	3	2	2.3333333333333335	0.5773502691896258	0.24743582965269678	3	2	1
fam7065	2	3	2	2.3333333333333335	0.5773502691896258	0.24743582965269678	3	2	1
fam7066	2	3	2	2.3333333333333335	0.5773502691896258	0.24743582965269678	3	2	1
fam7067	2	3	2	2.3333333333333335	0.5773502691896258	0.24743582965269678	3	2	1
fam7068	3	2	2	2.3333333333333335	0.5773502691896258	0.24743582965269678	3	2	1
fam7069	2	3	2	2.3333333333333335	0.5773502691896258	0.24743582965269678	3	2	1
fam7070	2	3	2	2.3333333333333335	0.5773502691896258	0.24743582965269678	3	2	1
fam7071	3	2	2	2.3333333333333335	0.5773502691896258	0.24743582965269678	3	2	1
fam7072	2	3	2	2.3333333333333335	0.5773502691896258	0.24743582965269678	3	2	1
fam7073	3	2	2	2.3333333333333335	0.5773502691896258	0.24743582965269678	3	2	1
fam7074	2	2	3	2.3333333333333335	0.5773502691896258	0.24743582965269678	3	2	1
fam7075	2	3	2	2.3333333333333335	0.5773502691896258	0.24743582965269678	3	2	1
fam7076	2	3	2	2.3333333333333335	0.5773502691896258	0.24743582965269678	3	2	1
fam7077	2	3	2	2.3333333333333335	0.5773502691896258	0.24743582965269678	3	2	1
fam7078	2	2	3	2.3333333333333335	0.5773502691896258	0.24743582965269678	3	2	1
fam7079	2	2	3	2.3333333333333335	0.5773502691896258	0.24743582965269678	3	2	1
fam7080	2	3	2	2.3333333333333335	0.5773502691896258	0.24743582965269678	3	2	1
fam7081	2	2	3	2.3333333333333335	0.5773502691896258	0.24743582965269678	3	2	1
fam7082	3	2	2	2.3333333333333335	0.5773502691896258	0.24743582965269678	3	2	1
fam7083	2	3	2	2.3333333333333335	0.5773502691896258	0.24743582965269678	3	2	1
fam7084	2	3	2	2.3333333333333335	0.5773502691896258	0.24743582965269678	3	2	1
fam7085	2	2	3	2.3333333333333335	0.5773502691896258	0.24743582965269678	3	2	1
fam7086	2	3	2	2.3333333333333335	0.5773502691896258	0.24743582965269678	3	2	1
fam7087	2	3	2	2.3333333333333335	0.5773502691896258	0.24743582965269678	3	2	1
fam7088	2	3	2	2.3333333333333335	0.5773502691896258	0.24743582965269678	3	2	1
fam7089	2	2	3	2.3333333333333335	0.5773502691896258	0.24743582965269678	3	2	1
fam7090	2	3	2	2.3333333333333335	0.5773502691896258	0.24743582965269678	3	2	1
fam7091	2	2	3	2.3333333333333335	0.5773502691896258	0.24743582965269678	3	2	1
fam7092	2	2	3	2.3333333333333335	0.5773502691896258	0.24743582965269678	3	2	1
fam7093	2	3	2	2.3333333333333335	0.5773502691896258	0.24743582965269678	3	2	1
fam7094	2	3	2	2.3333333333333335	0.5773502691896258	0.24743582965269678	3	2	1
fam7095	3	2	2	2.3333333333333335	0.5773502691896258	0.24743582965269678	3	2	1
fam7096	2	3	2	2.3333333333333335	0.5773502691896258	0.24743582965269678	3	2	1
fam7097	2	3	2	2.3333333333333335	0.5773502691896258	0.24743582965269678	3	2	1
fam7098	2	3	2	2.3333333333333335	0.5773502691896258	0.24743582965269678	3	2	1
fam7099	2	3	2	2.3333333333333335	0.5773502691896258	0.24743582965269678	3	2	1
fam7100	2	3	2	2.3333333333333335	0.5773502691896258	0.24743582965269678	3	2	1
fam7101	2	2	3	2.3333333333333335	0.5773502691896258	0.24743582965269678	3	2	1
fam7102	2	3	2	2.3333333333333335	0.5773502691896258	0.24743582965269678	3	2	1
fam7103	2	3	2	2.3333333333333335	0.5773502691896258	0.24743582965269678	3	2	1
fam7104	2	3	2	2.3333333333333335	0.5773502691896258	0.24743582965269678	3	2	1
fam7105	2	2	3	2.3333333333333335	0.5773502691896258	0.24743582965269678	3	2	1
fam7106	2	3	2	2.3333333333333335	0.5773502691896258	0.24743582965269678	3	2	1
fam7107	2	3	2	2.3333333333333335	0.5773502691896258	0.24743582965269678	3	2	1
fam7108	2	3	2	2.3333333333333335	0.5773502691896258	0.24743582965269678	3	2	1
fam7109	2	3	2	2.3333333333333335	0.5773502691896258	0.24743582965269678	3	2	1
fam7110	2	3	2	2.3333333333333335	0.5773502691896258	0.24743582965269678	3	2	1
fam7111	2	3	2	2.3333333333333335	0.5773502691896258	0.24743582965269678	3	2	1
fam7112	2	3	2	2.3333333333333335	0.5773502691896258	0.24743582965269678	3	2	1
fam7113	2	3	2	2.3333333333333335	0.5773502691896258	0.24743582965269678	3	2	1
fam7114	2	3	2	2.3333333333333335	0.5773502691896258	0.24743582965269678	3	2	1
fam7115	3	2	2	2.3333333333333335	0.5773502691896258	0.24743582965269678	3	2	1
fam7116	2	3	2	2.3333333333333335	0.5773502691896258	0.24743582965269678	3	2	1
fam7117	2	3	2	2.3333333333333335	0.5773502691896258	0.24743582965269678	3	2	1
fam7118	2	2	3	2.3333333333333335	0.5773502691896258	0.24743582965269678	3	2	1
fam7119	2	3	2	2.3333333333333335	0.5773502691896258	0.24743582965269678	3	2	1
fam7120	2	3	2	2.3333333333333335	0.5773502691896258	0.24743582965269678	3	2	1
fam7121	2	3	2	2.3333333333333335	0.5773502691896258	0.24743582965269678	3	2	1
fam7122	2	3	2	2.3333333333333335	0.5773502691896258	0.24743582965269678	3	2	1
fam7123	2	2	3	2.3333333333333335	0.5773502691896258	0.24743582965269678	3	2	1
fam7124	3	2	2	2.3333333333333335	0.5773502691896258	0.24743582965269678	3	2	1
fam7125	2	3	2	2.3333333333333335	0.5773502691896258	0.24743582965269678	3	2	1
fam7126	2	3	2	2.3333333333333335	0.5773502691896258	0.24743582965269678	3	2	1
fam7127	2	3	2	2.3333333333333335	0.5773502691896258	0.24743582965269678	3	2	1
fam7128	2	3	2	2.3333333333333335	0.5773502691896258	0.24743582965269678	3	2	1
fam7129	2	3	2	2.3333333333333335	0.5773502691896258	0.24743582965269678	3	2	1
fam7130	2	3	2	2.3333333333333335	0.5773502691896258	0.24743582965269678	3	2	1
fam7131	2	3	2	2.3333333333333335	0.5773502691896258	0.24743582965269678	3	2	1
fam7132	2	3	2	2.3333333333333335	0.5773502691896258	0.24743582965269678	3	2	1
fam7133	2	3	2	2.3333333333333335	0.5773502691896258	0.24743582965269678	3	2	1
fam7134	2	3	2	2.3333333333333335	0.5773502691896258	0.24743582965269678	3	2	1
fam7135	2	3	2	2.3333333333333335	0.5773502691896258	0.24743582965269678	3	2	1
fam7136	3	2	2	2.3333333333333335	0.5773502691896258	0.24743582965269678	3	2	1
fam7137	2	3	2	2.3333333333333335	0.5773502691896258	0.24743582965269678	3	2	1
fam7138	3	2	2	2.3333333333333335	0.5773502691896258	0.24743582965269678	3	2	1
fam7139	2	2	3	2.3333333333333335	0.5773502691896258	0.24743582965269678	3	2	1
fam7140	2	3	2	2.3333333333333335	0.5773502691896258	0.24743582965269678	3	2	1
fam7141	2	2	3	2.3333333333333335	0.5773502691896258	0.24743582965269678	3	2	1
fam7142	2	2	3	2.3333333333333335	0.5773502691896258	0.24743582965269678	3	2	1
fam7143	2	3	2	2.3333333333333335	0.5773502691896258	0.24743582965269678	3	2	1
fam7144	2	3	2	2.3333333333333335	0.5773502691896258	0.24743582965269678	3	2	1
fam7145	2	3	2	2.3333333333333335	0.5773502691896258	0.24743582965269678	3	2	1
fam7146	2	3	2	2.3333333333333335	0.5773502691896258	0.24743582965269678	3	2	1
fam7147	2	3	2	2.3333333333333335	0.5773502691896258	0.24743582965269678	3	2	1
fam7148	2	2	3	2.3333333333333335	0.5773502691896258	0.24743582965269678	3	2	1
fam7149	2	2	3	2.3333333333333335	0.5773502691896258	0.24743582965269678	3	2	1
fam7150	2	2	3	2.3333333333333335	0.5773502691896258	0.24743582965269678	3	2	1
fam7151	2	3	2	2.3333333333333335	0.5773502691896258	0.24743582965269678	3	2	1
fam7152	2	3	2	2.3333333333333335	0.5773502691896258	0.24743582965269678	3	2	1
fam7153	2	3	2	2.3333333333333335	0.5773502691896258	0.24743582965269678	3	2	1
fam7154	2	3	2	2.3333333333333335	0.5773502691896258	0.24743582965269678	3	2	1
fam7155	2	3	2	2.3333333333333335	0.5773502691896258	0.24743582965269678	3	2	1
fam7156	3	2	2	2.3333333333333335	0.5773502691896258	0.24743582965269678	3	2	1
fam7157	2	2	2	2.0	0.0	0.0	2	2	0
fam7158	2	3	2	2.3333333333333335	0.5773502691896258	0.24743582965269678	3	2	1
fam7159	2	3	2	2.3333333333333335	0.5773502691896258	0.24743582965269678	3	2	1
fam7160	2	3	2	2.3333333333333335	0.5773502691896258	0.24743582965269678	3	2	1
fam7161	2	3	2	2.3333333333333335	0.5773502691896258	0.24743582965269678	3	2	1
fam7162	2	3	2	2.3333333333333335	0.5773502691896258	0.24743582965269678	3	2	1
fam7163	2	3	2	2.3333333333333335	0.5773502691896258	0.24743582965269678	3	2	1
fam7164	2	3	2	2.3333333333333335	0.5773502691896258	0.24743582965269678	3	2	1
fam7165	2	3	2	2.3333333333333335	0.5773502691896258	0.24743582965269678	3	2	1
fam7166	2	3	2	2.3333333333333335	0.5773502691896258	0.24743582965269678	3	2	1
fam7167	3	2	2	2.3333333333333335	0.5773502691896258	0.24743582965269678	3	2	1
fam7168	2	3	2	2.3333333333333335	0.5773502691896258	0.24743582965269678	3	2	1
fam7169	2	3	2	2.3333333333333335	0.5773502691896258	0.24743582965269678	3	2	1
fam7170	2	3	2	2.3333333333333335	0.5773502691896258	0.24743582965269678	3	2	1
fam7171	2	2	3	2.3333333333333335	0.5773502691896258	0.24743582965269678	3	2	1
fam7172	2	3	2	2.3333333333333335	0.5773502691896258	0.24743582965269678	3	2	1
fam7173	3	2	2	2.3333333333333335	0.5773502691896258	0.24743582965269678	3	2	1
fam7174	2	3	2	2.3333333333333335	0.5773502691896258	0.24743582965269678	3	2	1
fam7175	2	3	2	2.3333333333333335	0.5773502691896258	0.24743582965269678	3	2	1
fam7176	2	3	2	2.3333333333333335	0.5773502691896258	0.24743582965269678	3	2	1
fam7177	2	2	3	2.3333333333333335	0.5773502691896258	0.24743582965269678	3	2	1
fam7178	2	2	3	2.3333333333333335	0.5773502691896258	0.24743582965269678	3	2	1
fam7179	2	2	2	2.0	0.0	0.0	2	2	0
fam7180	3	2	2	2.3333333333333335	0.5773502691896258	0.24743582965269678	3	2	1
fam7181	2	2	3	2.3333333333333335	0.5773502691896258	0.24743582965269678	3	2	1
fam7182	2	3	2	2.3333333333333335	0.5773502691896258	0.24743582965269678	3	2	1
fam7183	2	3	2	2.3333333333333335	0.5773502691896258	0.24743582965269678	3	2	1
fam7184	2	3	2	2.3333333333333335	0.5773502691896258	0.24743582965269678	3	2	1
fam7185	2	3	2	2.3333333333333335	0.5773502691896258	0.24743582965269678	3	2	1
fam7186	3	2	2	2.3333333333333335	0.5773502691896258	0.24743582965269678	3	2	1
fam7187	2	3	2	2.3333333333333335	0.5773502691896258	0.24743582965269678	3	2	1
fam7188	2	3	2	2.3333333333333335	0.5773502691896258	0.24743582965269678	3	2	1
fam7189	2	3	2	2.3333333333333335	0.5773502691896258	0.24743582965269678	3	2	1
fam7190	3	2	2	2.3333333333333335	0.5773502691896258	0.24743582965269678	3	2	1
fam7191	2	3	2	2.3333333333333335	0.5773502691896258	0.24743582965269678	3	2	1
fam7192	2	3	2	2.3333333333333335	0.5773502691896258	0.24743582965269678	3	2	1
fam7193	2	2	3	2.3333333333333335	0.5773502691896258	0.24743582965269678	3	2	1
fam7194	2	3	2	2.3333333333333335	0.5773502691896258	0.24743582965269678	3	2	1
fam7195	3	2	2	2.3333333333333335	0.5773502691896258	0.24743582965269678	3	2	1
fam7196	2	3	2	2.3333333333333335	0.5773502691896258	0.24743582965269678	3	2	1
fam7197	2	2	3	2.3333333333333335	0.5773502691896258	0.24743582965269678	3	2	1
fam7198	2	3	2	2.3333333333333335	0.5773502691896258	0.24743582965269678	3	2	1
fam7199	2	3	2	2.3333333333333335	0.5773502691896258	0.24743582965269678	3	2	1
fam7200	2	2	3	2.3333333333333335	0.5773502691896258	0.24743582965269678	3	2	1
fam7201	2	3	2	2.3333333333333335	0.5773502691896258	0.24743582965269678	3	2	1
fam7202	3	2	2	2.3333333333333335	0.5773502691896258	0.24743582965269678	3	2	1
fam7203	2	3	2	2.3333333333333335	0.5773502691896258	0.24743582965269678	3	2	1
fam7204	2	3	2	2.3333333333333335	0.5773502691896258	0.24743582965269678	3	2	1
fam7205	2	3	2	2.3333333333333335	0.5773502691896258	0.24743582965269678	3	2	1
fam7206	3	2	2	2.3333333333333335	0.5773502691896258	0.24743582965269678	3	2	1
fam7207	2	3	2	2.3333333333333335	0.5773502691896258	0.24743582965269678	3	2	1
fam7208	2	3	2	2.3333333333333335	0.5773502691896258	0.24743582965269678	3	2	1
fam7209	2	3	2	2.3333333333333335	0.5773502691896258	0.24743582965269678	3	2	1
fam7210	2	3	2	2.3333333333333335	0.5773502691896258	0.24743582965269678	3	2	1
fam7211	2	3	2	2.3333333333333335	0.5773502691896258	0.24743582965269678	3	2	1
fam7212	2	2	3	2.3333333333333335	0.5773502691896258	0.24743582965269678	3	2	1
fam7213	2	3	2	2.3333333333333335	0.5773502691896258	0.24743582965269678	3	2	1
fam7214	3	2	2	2.3333333333333335	0.5773502691896258	0.24743582965269678	3	2	1
fam7215	3	2	2	2.3333333333333335	0.5773502691896258	0.24743582965269678	3	2	1
fam7216	2	3	2	2.3333333333333335	0.5773502691896258	0.24743582965269678	3	2	1
fam7217	2	2	2	2.0	0.0	0.0	2	2	0
fam7218	2	2	2	2.0	0.0	0.0	2	2	0
fam7219	2	2	2	2.0	0.0	0.0	2	2	0
fam7220	2	2	2	2.0	0.0	0.0	2	2	0
fam7221	2	2	2	2.0	0.0	0.0	2	2	0
fam7222	2	2	2	2.0	0.0	0.0	2	2	0
fam7223	2	2	2	2.0	0.0	0.0	2	2	0
fam7224	2	2	2	2.0	0.0	0.0	2	2	0
fam7225	2	2	2	2.0	0.0	0.0	2	2	0
fam7226	2	2	2	2.0	0.0	0.0	2	2	0
fam7227	2	2	2	2.0	0.0	0.0	2	2	0
fam7228	2	2	2	2.0	0.0	0.0	2	2	0
fam7229	2	2	2	2.0	0.0	0.0	2	2	0
fam7230	2	2	2	2.0	0.0	0.0	2	2	0
fam7231	2	2	2	2.0	0.0	0.0	2	2	0
fam7232	2	2	2	2.0	0.0	0.0	2	2	0
fam7233	2	2	2	2.0	0.0	0.0	2	2	0
fam7234	2	2	2	2.0	0.0	0.0	2	2	0
fam7235	2	2	2	2.0	0.0	0.0	2	2	0
fam7236	2	2	2	2.0	0.0	0.0	2	2	0
fam7237	2	2	2	2.0	0.0	0.0	2	2	0
fam7238	2	2	2	2.0	0.0	0.0	2	2	0
fam7239	2	2	2	2.0	0.0	0.0	2	2	0
fam7240	2	3	2	2.3333333333333335	0.5773502691896258	0.24743582965269678	3	2	1
fam7241	3	2	2	2.3333333333333335	0.5773502691896258	0.24743582965269678	3	2	1
fam7242	2	2	2	2.0	0.0	0.0	2	2	0
fam7243	2	2	3	2.3333333333333335	0.5773502691896258	0.24743582965269678	3	2	1
fam7244	2	3	2	2.3333333333333335	0.5773502691896258	0.24743582965269678	3	2	1
fam7245	2	2	3	2.3333333333333335	0.5773502691896258	0.24743582965269678	3	2	1
fam7246	2	3	2	2.3333333333333335	0.5773502691896258	0.24743582965269678	3	2	1
fam7247	2	2	2	2.0	0.0	0.0	2	2	0
fam7248	2	3	2	2.3333333333333335	0.5773502691896258	0.24743582965269678	3	2	1
fam7249	2	2	2	2.0	0.0	0.0	2	2	0
fam7250	2	2	2	2.0	0.0	0.0	2	2	0
fam7251	2	2	2	2.0	0.0	0.0	2	2	0
fam7252	2	2	2	2.0	0.0	0.0	2	2	0
fam7253	2	3	2	2.3333333333333335	0.5773502691896258	0.24743582965269678	3	2	1
fam7254	2	3	2	2.3333333333333335	0.5773502691896258	0.24743582965269678	3	2	1
fam7255	2	3	2	2.3333333333333335	0.5773502691896258	0.24743582965269678	3	2	1
fam7256	2	3	2	2.3333333333333335	0.5773502691896258	0.24743582965269678	3	2	1
fam7257	2	2	2	2.0	0.0	0.0	2	2	0
fam7258	2	2	2	2.0	0.0	0.0	2	2	0
fam7259	2	2	2	2.0	0.0	0.0	2	2	0
fam7260	2	2	2	2.0	0.0	0.0	2	2	0
fam7261	2	2	2	2.0	0.0	0.0	2	2	0
fam7262	2	2	2	2.0	0.0	0.0	2	2	0
fam7263	2	2	2	2.0	0.0	0.0	2	2	0
fam7264	2	2	2	2.0	0.0	0.0	2	2	0
fam7265	2	2	3	2.3333333333333335	0.5773502691896258	0.24743582965269678	3	2	1
fam7266	2	2	2	2.0	0.0	0.0	2	2	0
fam7267	2	2	2	2.0	0.0	0.0	2	2	0
fam7268	2	2	2	2.0	0.0	0.0	2	2	0
fam7269	2	2	3	2.3333333333333335	0.5773502691896258	0.24743582965269678	3	2	1
fam7270	2	2	2	2.0	0.0	0.0	2	2	0
fam7271	2	3	2	2.3333333333333335	0.5773502691896258	0.24743582965269678	3	2	1
fam7272	2	3	2	2.3333333333333335	0.5773502691896258	0.24743582965269678	3	2	1
fam7273	2	2	2	2.0	0.0	0.0	2	2	0
fam7274	2	2	2	2.0	0.0	0.0	2	2	0
fam7275	2	3	2	2.3333333333333335	0.5773502691896258	0.24743582965269678	3	2	1
fam7276	2	2	2	2.0	0.0	0.0	2	2	0
fam7277	2	3	2	2.3333333333333335	0.5773502691896258	0.24743582965269678	3	2	1
fam7278	2	2	2	2.0	0.0	0.0	2	2	0
fam7279	2	2	2	2.0	0.0	0.0	2	2	0
fam7280	2	2	2	2.0	0.0	0.0	2	2	0
fam7281	2	2	3	2.3333333333333335	0.5773502691896258	0.24743582965269678	3	2	1
fam7282	2	2	3	2.3333333333333335	0.5773502691896258	0.24743582965269678	3	2	1
fam7283	2	3	2	2.3333333333333335	0.5773502691896258	0.24743582965269678	3	2	1
fam7284	2	2	2	2.0	0.0	0.0	2	2	0
fam7285	2	2	2	2.0	0.0	0.0	2	2	0
fam7286	2	2	3	2.3333333333333335	0.5773502691896258	0.24743582965269678	3	2	1
fam7287	2	3	2	2.3333333333333335	0.5773502691896258	0.24743582965269678	3	2	1
fam7288	2	3	2	2.3333333333333335	0.5773502691896258	0.24743582965269678	3	2	1
fam7289	2	2	2	2.0	0.0	0.0	2	2	0
fam7290	2	2	2	2.0	0.0	0.0	2	2	0
fam7291	2	2	2	2.0	0.0	0.0	2	2	0
fam7292	2	3	2	2.3333333333333335	0.5773502691896258	0.24743582965269678	3	2	1
fam7293	2	2	3	2.3333333333333335	0.5773502691896258	0.24743582965269678	3	2	1
fam7294	2	3	2	2.3333333333333335	0.5773502691896258	0.24743582965269678	3	2	1
fam7295	2	2	2	2.0	0.0	0.0	2	2	0
fam7296	2	2	3	2.3333333333333335	0.5773502691896258	0.24743582965269678	3	2	1
fam7297	2	3	2	2.3333333333333335	0.5773502691896258	0.24743582965269678	3	2	1
fam7298	2	2	2	2.0	0.0	0.0	2	2	0
fam7299	2	2	2	2.0	0.0	0.0	2	2	0
fam7300	2	2	2	2.0	0.0	0.0	2	2	0
fam7301	2	2	2	2.0	0.0	0.0	2	2	0
fam7302	2	3	2	2.3333333333333335	0.5773502691896258	0.24743582965269678	3	2	1
fam7303	2	2	2	2.0	0.0	0.0	2	2	0
fam7304	2	2	2	2.0	0.0	0.0	2	2	0
fam7305	2	2	2	2.0	0.0	0.0	2	2	0
fam7306	2	2	2	2.0	0.0	0.0	2	2	0
fam7307	2	2	2	2.0	0.0	0.0	2	2	0
fam7308	2	2	2	2.0	0.0	0.0	2	2	0
fam7309	2	3	2	2.3333333333333335	0.5773502691896258	0.24743582965269678	3	2	1
fam7310	2	2	2	2.0	0.0	0.0	2	2	0
fam7311	2	3	2	2.3333333333333335	0.5773502691896258	0.24743582965269678	3	2	1
fam7312	2	3	2	2.3333333333333335	0.5773502691896258	0.24743582965269678	3	2	1
fam7313	2	2	2	2.0	0.0	0.0	2	2	0
fam7314	2	2	2	2.0	0.0	0.0	2	2	0
fam7315	2	2	2	2.0	0.0	0.0	2	2	0
fam7316	2	2	2	2.0	0.0	0.0	2	2	0
fam7317	2	2	2	2.0	0.0	0.0	2	2	0
fam7318	2	2	2	2.0	0.0	0.0	2	2	0
fam7319	2	2	2	2.0	0.0	0.0	2	2	0
fam7320	2	2	2	2.0	0.0	0.0	2	2	0
fam7321	2	2	2	2.0	0.0	0.0	2	2	0
fam7322	2	2	3	2.3333333333333335	0.5773502691896258	0.24743582965269678	3	2	1
fam7323	2	3	2	2.3333333333333335	0.5773502691896258	0.24743582965269678	3	2	1
fam7324	2	2	2	2.0	0.0	0.0	2	2	0
fam7325	2	2	2	2.0	0.0	0.0	2	2	0
fam7326	2	2	2	2.0	0.0	0.0	2	2	0
fam7327	2	2	2	2.0	0.0	0.0	2	2	0
fam7328	2	2	2	2.0	0.0	0.0	2	2	0
fam7329	2	3	2	2.3333333333333335	0.5773502691896258	0.24743582965269678	3	2	1
fam7330	2	2	2	2.0	0.0	0.0	2	2	0
fam7331	2	2	2	2.0	0.0	0.0	2	2	0
fam7332	2	3	2	2.3333333333333335	0.5773502691896258	0.24743582965269678	3	2	1
fam7333	2	2	2	2.0	0.0	0.0	2	2	0
fam7334	2	2	2	2.0	0.0	0.0	2	2	0
fam7335	2	2	2	2.0	0.0	0.0	2	2	0
fam7336	2	3	2	2.3333333333333335	0.5773502691896258	0.24743582965269678	3	2	1
fam7337	2	3	2	2.3333333333333335	0.5773502691896258	0.24743582965269678	3	2	1
fam7338	2	2	2	2.0	0.0	0.0	2	2	0
fam7339	2	2	2	2.0	0.0	0.0	2	2	0
fam7340	2	2	2	2.0	0.0	0.0	2	2	0
fam7341	2	2	2	2.0	0.0	0.0	2	2	0
fam7342	2	3	2	2.3333333333333335	0.5773502691896258	0.24743582965269678	3	2	1
fam7343	2	3	2	2.3333333333333335	0.5773502691896258	0.24743582965269678	3	2	1
fam7344	2	2	2	2.0	0.0	0.0	2	2	0
fam7345	2	2	2	2.0	0.0	0.0	2	2	0
fam7346	2	2	2	2.0	0.0	0.0	2	2	0
fam7347	2	3	2	2.3333333333333335	0.5773502691896258	0.24743582965269678	3	2	1
fam7348	2	3	2	2.3333333333333335	0.5773502691896258	0.24743582965269678	3	2	1
fam7349	2	2	2	2.0	0.0	0.0	2	2	0
fam7350	2	2	2	2.0	0.0	0.0	2	2	0
fam7351	2	3	2	2.3333333333333335	0.5773502691896258	0.24743582965269678	3	2	1
fam7352	2	3	2	2.3333333333333335	0.5773502691896258	0.24743582965269678	3	2	1
fam7353	2	2	2	2.0	0.0	0.0	2	2	0
fam7354	2	2	2	2.0	0.0	0.0	2	2	0
fam7355	2	3	2	2.3333333333333335	0.5773502691896258	0.24743582965269678	3	2	1
fam7356	2	2	2	2.0	0.0	0.0	2	2	0
fam7357	2	2	2	2.0	0.0	0.0	2	2	0
fam7358	2	2	2	2.0	0.0	0.0	2	2	0
fam7359	2	2	2	2.0	0.0	0.0	2	2	0
fam7360	2	2	2	2.0	0.0	0.0	2	2	0
fam7361	2	2	2	2.0	0.0	0.0	2	2	0
fam7362	2	2	2	2.0	0.0	0.0	2	2	0
fam7363	2	3	2	2.3333333333333335	0.5773502691896258	0.24743582965269678	3	2	1
fam7364	2	2	2	2.0	0.0	0.0	2	2	0
fam7365	2	3	2	2.3333333333333335	0.5773502691896258	0.24743582965269678	3	2	1
fam7366	2	2	2	2.0	0.0	0.0	2	2	0
fam7367	2	2	2	2.0	0.0	0.0	2	2	0
fam7368	2	3	2	2.3333333333333335	0.5773502691896258	0.24743582965269678	3	2	1
fam7369	2	3	2	2.3333333333333335	0.5773502691896258	0.24743582965269678	3	2	1
fam7370	2	3	2	2.3333333333333335	0.5773502691896258	0.24743582965269678	3	2	1
fam7371	2	3	2	2.3333333333333335	0.5773502691896258	0.24743582965269678	3	2	1
fam7372	2	3	2	2.3333333333333335	0.5773502691896258	0.24743582965269678	3	2	1
fam7373	2	3	2	2.3333333333333335	0.5773502691896258	0.24743582965269678	3	2	1
fam7374	2	3	2	2.3333333333333335	0.5773502691896258	0.24743582965269678	3	2	1
fam7375	2	3	2	2.3333333333333335	0.5773502691896258	0.24743582965269678	3	2	1
fam7376	2	2	2	2.0	0.0	0.0	2	2	0
fam7377	2	2	2	2.0	0.0	0.0	2	2	0
fam7378	2	2	2	2.0	0.0	0.0	2	2	0
fam7379	2	2	2	2.0	0.0	0.0	2	2	0
fam7380	2	2	2	2.0	0.0	0.0	2	2	0
fam7381	2	3	2	2.3333333333333335	0.5773502691896258	0.24743582965269678	3	2	1
fam7382	2	3	2	2.3333333333333335	0.5773502691896258	0.24743582965269678	3	2	1
fam7383	2	3	2	2.3333333333333335	0.5773502691896258	0.24743582965269678	3	2	1
fam7384	2	2	2	2.0	0.0	0.0	2	2	0
fam7385	2	2	2	2.0	0.0	0.0	2	2	0
fam7386	2	2	2	2.0	0.0	0.0	2	2	0
fam7387	2	2	3	2.3333333333333335	0.5773502691896258	0.24743582965269678	3	2	1
fam7388	2	2	3	2.3333333333333335	0.5773502691896258	0.24743582965269678	3	2	1
fam7389	2	3	2	2.3333333333333335	0.5773502691896258	0.24743582965269678	3	2	1
fam7390	2	3	2	2.3333333333333335	0.5773502691896258	0.24743582965269678	3	2	1
fam7391	2	2	2	2.0	0.0	0.0	2	2	0
fam7392	2	3	2	2.3333333333333335	0.5773502691896258	0.24743582965269678	3	2	1
fam7393	2	2	3	2.3333333333333335	0.5773502691896258	0.24743582965269678	3	2	1
fam7394	2	3	2	2.3333333333333335	0.5773502691896258	0.24743582965269678	3	2	1
fam7395	2	2	2	2.0	0.0	0.0	2	2	0
fam7396	2	3	2	2.3333333333333335	0.5773502691896258	0.24743582965269678	3	2	1
fam7397	2	2	2	2.0	0.0	0.0	2	2	0
fam7398	2	3	2	2.3333333333333335	0.5773502691896258	0.24743582965269678	3	2	1
fam7399	2	3	2	2.3333333333333335	0.5773502691896258	0.24743582965269678	3	2	1
fam7400	2	2	2	2.0	0.0	0.0	2	2	0
fam7401	2	3	2	2.3333333333333335	0.5773502691896258	0.24743582965269678	3	2	1
fam7402	2	3	2	2.3333333333333335	0.5773502691896258	0.24743582965269678	3	2	1
fam7403	2	2	2	2.0	0.0	0.0	2	2	0
fam7404	2	2	2	2.0	0.0	0.0	2	2	0
fam7405	2	2	2	2.0	0.0	0.0	2	2	0
fam7406	2	3	2	2.3333333333333335	0.5773502691896258	0.24743582965269678	3	2	1
fam7407	2	2	2	2.0	0.0	0.0	2	2	0
fam7408	2	2	2	2.0	0.0	0.0	2	2	0
fam7409	2	2	2	2.0	0.0	0.0	2	2	0
fam7410	2	2	2	2.0	0.0	0.0	2	2	0
fam7411	2	2	3	2.3333333333333335	0.5773502691896258	0.24743582965269678	3	2	1
fam7412	2	2	2	2.0	0.0	0.0	2	2	0
fam7413	2	2	2	2.0	0.0	0.0	2	2	0
fam7414	2	3	2	2.3333333333333335	0.5773502691896258	0.24743582965269678	3	2	1
fam7415	2	2	2	2.0	0.0	0.0	2	2	0
fam7416	2	2	2	2.0	0.0	0.0	2	2	0
fam7417	2	2	2	2.0	0.0	0.0	2	2	0
fam7418	2	2	2	2.0	0.0	0.0	2	2	0
fam7419	2	2	2	2.0	0.0	0.0	2	2	0
fam7420	2	3	2	2.3333333333333335	0.5773502691896258	0.24743582965269678	3	2	1
fam7421	2	2	2	2.0	0.0	0.0	2	2	0
fam7422	2	2	2	2.0	0.0	0.0	2	2	0
fam7423	2	2	2	2.0	0.0	0.0	2	2	0
fam7424	2	2	2	2.0	0.0	0.0	2	2	0
fam7425	2	2	2	2.0	0.0	0.0	2	2	0
fam7426	2	2	2	2.0	0.0	0.0	2	2	0
fam7427	2	2	2	2.0	0.0	0.0	2	2	0
fam7428	2	2	2	2.0	0.0	0.0	2	2	0
fam7429	2	3	2	2.3333333333333335	0.5773502691896258	0.24743582965269678	3	2	1
fam7430	2	2	2	2.0	0.0	0.0	2	2	0
fam7431	2	2	2	2.0	0.0	0.0	2	2	0
fam7432	2	2	2	2.0	0.0	0.0	2	2	0
fam7433	2	2	2	2.0	0.0	0.0	2	2	0
fam7434	2	2	2	2.0	0.0	0.0	2	2	0
fam7435	2	2	2	2.0	0.0	0.0	2	2	0
fam7436	2	2	2	2.0	0.0	0.0	2	2	0
fam7437	2	2	2	2.0	0.0	0.0	2	2	0
fam7438	2	2	2	2.0	0.0	0.0	2	2	0
fam7439	2	2	2	2.0	0.0	0.0	2	2	0
fam7440	2	2	2	2.0	0.0	0.0	2	2	0
fam7441	2	2	2	2.0	0.0	0.0	2	2	0
fam7442	2	2	2	2.0	0.0	0.0	2	2	0
fam7443	2	2	2	2.0	0.0	0.0	2	2	0
fam7444	2	2	2	2.0	0.0	0.0	2	2	0
fam7445	2	2	2	2.0	0.0	0.0	2	2	0
fam7446	2	2	2	2.0	0.0	0.0	2	2	0
fam7447	2	2	2	2.0	0.0	0.0	2	2	0
fam7448	2	2	2	2.0	0.0	0.0	2	2	0
fam7449	2	2	2	2.0	0.0	0.0	2	2	0
fam7450	2	2	2	2.0	0.0	0.0	2	2	0
fam7451	2	2	2	2.0	0.0	0.0	2	2	0
fam7452	2	2	2	2.0	0.0	0.0	2	2	0
fam7453	2	2	2	2.0	0.0	0.0	2	2	0
fam7454	2	2	2	2.0	0.0	0.0	2	2	0
fam7455	2	2	2	2.0	0.0	0.0	2	2	0
fam7456	2	2	2	2.0	0.0	0.0	2	2	0
fam7457	2	2	2	2.0	0.0	0.0	2	2	0
fam7458	2	2	2	2.0	0.0	0.0	2	2	0
fam7459	2	2	2	2.0	0.0	0.0	2	2	0
fam7460	2	3	2	2.3333333333333335	0.5773502691896258	0.24743582965269678	3	2	1
fam7461	2	3	2	2.3333333333333335	0.5773502691896258	0.24743582965269678	3	2	1
fam7462	2	3	2	2.3333333333333335	0.5773502691896258	0.24743582965269678	3	2	1
fam7463	2	2	3	2.3333333333333335	0.5773502691896258	0.24743582965269678	3	2	1
fam7464	2	2	2	2.0	0.0	0.0	2	2	0
fam7465	2	3	2	2.3333333333333335	0.5773502691896258	0.24743582965269678	3	2	1
fam7466	2	3	2	2.3333333333333335	0.5773502691896258	0.24743582965269678	3	2	1
fam7467	2	3	2	2.3333333333333335	0.5773502691896258	0.24743582965269678	3	2	1
fam7468	3	2	2	2.3333333333333335	0.5773502691896258	0.24743582965269678	3	2	1
fam7469	2	3	2	2.3333333333333335	0.5773502691896258	0.24743582965269678	3	2	1
fam7470	2	3	2	2.3333333333333335	0.5773502691896258	0.24743582965269678	3	2	1
fam7471	2	2	2	2.0	0.0	0.0	2	2	0
fam7472	2	2	2	2.0	0.0	0.0	2	2	0
fam7473	2	2	2	2.0	0.0	0.0	2	2	0
fam7474	2	2	2	2.0	0.0	0.0	2	2	0
fam7475	2	2	2	2.0	0.0	0.0	2	2	0
fam7476	2	2	2	2.0	0.0	0.0	2	2	0
fam7477	2	2	2	2.0	0.0	0.0	2	2	0
fam7478	2	2	2	2.0	0.0	0.0	2	2	0
fam7479	2	2	2	2.0	0.0	0.0	2	2	0
fam7480	2	2	2	2.0	0.0	0.0	2	2	0
fam7481	2	2	2	2.0	0.0	0.0	2	2	0
fam7482	2	2	2	2.0	0.0	0.0	2	2	0
fam7483	2	2	3	2.3333333333333335	0.5773502691896258	0.24743582965269678	3	2	1
fam7484	2	2	2	2.0	0.0	0.0	2	2	0
fam7485	2	3	2	2.3333333333333335	0.5773502691896258	0.24743582965269678	3	2	1
fam7486	2	3	2	2.3333333333333335	0.5773502691896258	0.24743582965269678	3	2	1
fam7487	2	2	2	2.0	0.0	0.0	2	2	0
fam7488	2	3	2	2.3333333333333335	0.5773502691896258	0.24743582965269678	3	2	1
fam7489	2	2	2	2.0	0.0	0.0	2	2	0
fam7490	2	2	2	2.0	0.0	0.0	2	2	0
fam7491	2	2	2	2.0	0.0	0.0	2	2	0
fam7492	2	2	3	2.3333333333333335	0.5773502691896258	0.24743582965269678	3	2	1
fam7493	2	2	2	2.0	0.0	0.0	2	2	0
fam7494	2	2	2	2.0	0.0	0.0	2	2	0
fam7495	2	3	2	2.3333333333333335	0.5773502691896258	0.24743582965269678	3	2	1
fam7496	2	3	2	2.3333333333333335	0.5773502691896258	0.24743582965269678	3	2	1
fam7497	2	2	2	2.0	0.0	0.0	2	2	0
fam7498	2	2	2	2.0	0.0	0.0	2	2	0
fam7499	2	2	2	2.0	0.0	0.0	2	2	0
fam7500	2	2	2	2.0	0.0	0.0	2	2	0
fam7501	2	2	2	2.0	0.0	0.0	2	2	0
fam7502	2	2	2	2.0	0.0	0.0	2	2	0
fam7503	2	2	2	2.0	0.0	0.0	2	2	0
fam7504	2	2	2	2.0	0.0	0.0	2	2	0
fam7505	2	2	2	2.0	0.0	0.0	2	2	0
fam7506	2	2	2	2.0	0.0	0.0	2	2	0
fam7507	2	2	2	2.0	0.0	0.0	2	2	0
fam7508	2	2	2	2.0	0.0	0.0	2	2	0
fam7509	2	2	2	2.0	0.0	0.0	2	2	0
fam7510	2	2	2	2.0	0.0	0.0	2	2	0
fam7511	2	2	2	2.0	0.0	0.0	2	2	0
fam7512	2	2	2	2.0	0.0	0.0	2	2	0
fam7513	2	2	2	2.0	0.0	0.0	2	2	0
fam7514	2	2	2	2.0	0.0	0.0	2	2	0
fam7515	2	2	2	2.0	0.0	0.0	2	2	0
fam7516	2	2	2	2.0	0.0	0.0	2	2	0
fam7517	2	2	2	2.0	0.0	0.0	2	2	0
fam7518	2	2	2	2.0	0.0	0.0	2	2	0
fam7519	2	2	2	2.0	0.0	0.0	2	2	0
fam7520	2	2	2	2.0	0.0	0.0	2	2	0
fam7521	2	2	2	2.0	0.0	0.0	2	2	0
fam7522	2	2	2	2.0	0.0	0.0	2	2	0
fam7523	2	2	2	2.0	0.0	0.0	2	2	0
fam7524	2	2	2	2.0	0.0	0.0	2	2	0
fam7525	2	2	2	2.0	0.0	0.0	2	2	0
fam7526	2	2	2	2.0	0.0	0.0	2	2	0
fam7527	2	2	2	2.0	0.0	0.0	2	2	0
fam7528	2	2	2	2.0	0.0	0.0	2	2	0
fam7529	2	2	2	2.0	0.0	0.0	2	2	0
fam7530	2	2	2	2.0	0.0	0.0	2	2	0
fam7531	2	2	2	2.0	0.0	0.0	2	2	0
fam7532	2	2	2	2.0	0.0	0.0	2	2	0
fam7533	2	2	2	2.0	0.0	0.0	2	2	0
fam7534	2	2	2	2.0	0.0	0.0	2	2	0
fam7535	2	2	2	2.0	0.0	0.0	2	2	0
fam7536	2	2	2	2.0	0.0	0.0	2	2	0
fam7537	2	2	2	2.0	0.0	0.0	2	2	0
fam7538	2	2	2	2.0	0.0	0.0	2	2	0
fam7539	2	2	2	2.0	0.0	0.0	2	2	0
fam7540	2	2	2	2.0	0.0	0.0	2	2	0
fam7541	2	2	2	2.0	0.0	0.0	2	2	0
fam7542	2	2	2	2.0	0.0	0.0	2	2	0
fam7543	2	2	2	2.0	0.0	0.0	2	2	0
fam7544	2	2	2	2.0	0.0	0.0	2	2	0
fam7545	2	2	2	2.0	0.0	0.0	2	2	0
fam7546	2	2	2	2.0	0.0	0.0	2	2	0
fam7547	2	2	2	2.0	0.0	0.0	2	2	0
fam7548	2	2	2	2.0	0.0	0.0	2	2	0
fam7549	2	2	2	2.0	0.0	0.0	2	2	0
fam7550	2	2	2	2.0	0.0	0.0	2	2	0
fam7551	2	2	2	2.0	0.0	0.0	2	2	0
fam7552	2	2	2	2.0	0.0	0.0	2	2	0
fam7553	2	2	2	2.0	0.0	0.0	2	2	0
fam7554	2	2	2	2.0	0.0	0.0	2	2	0
fam7555	2	2	2	2.0	0.0	0.0	2	2	0
fam7556	2	2	2	2.0	0.0	0.0	2	2	0
fam7557	2	2	2	2.0	0.0	0.0	2	2	0
fam7558	2	2	2	2.0	0.0	0.0	2	2	0
fam7559	2	2	2	2.0	0.0	0.0	2	2	0
fam7560	2	2	2	2.0	0.0	0.0	2	2	0
fam7561	2	2	2	2.0	0.0	0.0	2	2	0
fam7562	2	2	2	2.0	0.0	0.0	2	2	0
fam7563	2	2	2	2.0	0.0	0.0	2	2	0
fam7564	2	2	2	2.0	0.0	0.0	2	2	0
fam7565	2	2	2	2.0	0.0	0.0	2	2	0
fam7566	2	2	2	2.0	0.0	0.0	2	2	0
fam7567	2	2	2	2.0	0.0	0.0	2	2	0
fam7568	2	2	2	2.0	0.0	0.0	2	2	0
fam7569	2	2	2	2.0	0.0	0.0	2	2	0
fam7570	2	2	2	2.0	0.0	0.0	2	2	0
fam7571	2	2	2	2.0	0.0	0.0	2	2	0
fam7572	2	2	2	2.0	0.0	0.0	2	2	0
fam7573	2	2	2	2.0	0.0	0.0	2	2	0
fam7574	2	2	2	2.0	0.0	0.0	2	2	0
fam7575	2	2	2	2.0	0.0	0.0	2	2	0
fam7576	2	2	2	2.0	0.0	0.0	2	2	0
fam7577	2	2	2	2.0	0.0	0.0	2	2	0
fam7578	2	2	2	2.0	0.0	0.0	2	2	0
fam7579	2	2	2	2.0	0.0	0.0	2	2	0
fam7580	2	2	2	2.0	0.0	0.0	2	2	0
fam7581	2	2	2	2.0	0.0	0.0	2	2	0
fam7582	2	2	2	2.0	0.0	0.0	2	2	0
fam7583	2	2	2	2.0	0.0	0.0	2	2	0
fam7584	2	2	2	2.0	0.0	0.0	2	2	0
fam7585	2	2	2	2.0	0.0	0.0	2	2	0
fam7586	2	2	2	2.0	0.0	0.0	2	2	0
fam7587	2	2	2	2.0	0.0	0.0	2	2	0
fam7588	2	2	2	2.0	0.0	0.0	2	2	0
fam7589	2	2	2	2.0	0.0	0.0	2	2	0
fam7590	2	2	2	2.0	0.0	0.0	2	2	0
fam7591	2	2	2	2.0	0.0	0.0	2	2	0
fam7592	2	2	2	2.0	0.0	0.0	2	2	0
fam7593	2	2	2	2.0	0.0	0.0	2	2	0
fam7594	2	2	2	2.0	0.0	0.0	2	2	0
fam7595	2	2	2	2.0	0.0	0.0	2	2	0
fam7596	2	2	2	2.0	0.0	0.0	2	2	0
fam7597	2	2	2	2.0	0.0	0.0	2	2	0
fam7598	2	2	2	2.0	0.0	0.0	2	2	0
fam7599	2	2	2	2.0	0.0	0.0	2	2	0
fam7600	2	2	2	2.0	0.0	0.0	2	2	0
fam7601	2	2	2	2.0	0.0	0.0	2	2	0
fam7602	2	2	2	2.0	0.0	0.0	2	2	0
fam7603	2	2	2	2.0	0.0	0.0	2	2	0
fam7604	2	2	2	2.0	0.0	0.0	2	2	0
fam7605	2	2	2	2.0	0.0	0.0	2	2	0
fam7606	2	2	2	2.0	0.0	0.0	2	2	0
fam7607	2	2	2	2.0	0.0	0.0	2	2	0
fam7608	2	2	2	2.0	0.0	0.0	2	2	0
fam7609	2	2	2	2.0	0.0	0.0	2	2	0
fam7610	2	2	2	2.0	0.0	0.0	2	2	0
fam7611	2	2	2	2.0	0.0	0.0	2	2	0
fam7612	2	2	2	2.0	0.0	0.0	2	2	0
fam7613	2	2	2	2.0	0.0	0.0	2	2	0
fam7614	2	2	2	2.0	0.0	0.0	2	2	0
fam7615	2	2	2	2.0	0.0	0.0	2	2	0
fam7616	2	2	2	2.0	0.0	0.0	2	2	0
fam7617	2	2	2	2.0	0.0	0.0	2	2	0
fam7618	2	2	2	2.0	0.0	0.0	2	2	0
fam7619	2	2	2	2.0	0.0	0.0	2	2	0
fam7620	2	2	2	2.0	0.0	0.0	2	2	0
fam7621	2	2	2	2.0	0.0	0.0	2	2	0
fam7622	2	2	2	2.0	0.0	0.0	2	2	0
fam7623	2	2	2	2.0	0.0	0.0	2	2	0
fam7624	2	2	2	2.0	0.0	0.0	2	2	0
fam7625	2	2	2	2.0	0.0	0.0	2	2	0
fam7626	2	2	2	2.0	0.0	0.0	2	2	0
fam7627	2	2	2	2.0	0.0	0.0	2	2	0
fam7628	2	2	2	2.0	0.0	0.0	2	2	0
fam7629	2	2	2	2.0	0.0	0.0	2	2	0
fam7630	2	2	2	2.0	0.0	0.0	2	2	0
fam7631	2	2	2	2.0	0.0	0.0	2	2	0
fam7632	2	2	2	2.0	0.0	0.0	2	2	0
fam7633	2	2	2	2.0	0.0	0.0	2	2	0
fam7634	2	2	2	2.0	0.0	0.0	2	2	0
fam7635	2	2	2	2.0	0.0	0.0	2	2	0
fam7636	2	2	2	2.0	0.0	0.0	2	2	0
fam7637	2	2	2	2.0	0.0	0.0	2	2	0
fam7638	2	2	2	2.0	0.0	0.0	2	2	0
fam7639	2	2	2	2.0	0.0	0.0	2	2	0
fam7640	2	2	2	2.0	0.0	0.0	2	2	0
fam7641	2	2	2	2.0	0.0	0.0	2	2	0
fam7642	2	2	2	2.0	0.0	0.0	2	2	0
fam7643	2	2	2	2.0	0.0	0.0	2	2	0
fam7644	2	2	2	2.0	0.0	0.0	2	2	0
fam7645	2	2	2	2.0	0.0	0.0	2	2	0
fam7646	2	2	2	2.0	0.0	0.0	2	2	0
fam7647	2	2	2	2.0	0.0	0.0	2	2	0
fam7648	2	2	2	2.0	0.0	0.0	2	2	0
fam7649	2	2	2	2.0	0.0	0.0	2	2	0
fam7650	2	2	2	2.0	0.0	0.0	2	2	0
fam7651	2	2	2	2.0	0.0	0.0	2	2	0
fam7652	2	2	2	2.0	0.0	0.0	2	2	0
fam7653	2	2	2	2.0	0.0	0.0	2	2	0
fam7654	2	2	2	2.0	0.0	0.0	2	2	0
fam7655	2	2	2	2.0	0.0	0.0	2	2	0
fam7656	2	2	2	2.0	0.0	0.0	2	2	0
fam7657	2	2	2	2.0	0.0	0.0	2	2	0
fam7658	2	2	2	2.0	0.0	0.0	2	2	0
fam7659	2	2	2	2.0	0.0	0.0	2	2	0
fam7660	2	2	2	2.0	0.0	0.0	2	2	0
fam7661	2	2	2	2.0	0.0	0.0	2	2	0
fam7662	2	2	2	2.0	0.0	0.0	2	2	0
fam7663	2	2	2	2.0	0.0	0.0	2	2	0
fam7664	2	2	2	2.0	0.0	0.0	2	2	0
fam7665	2	2	2	2.0	0.0	0.0	2	2	0
fam7666	2	2	2	2.0	0.0	0.0	2	2	0
fam7667	2	2	2	2.0	0.0	0.0	2	2	0
fam7668	2	2	2	2.0	0.0	0.0	2	2	0
fam7669	2	2	2	2.0	0.0	0.0	2	2	0
fam7670	2	2	2	2.0	0.0	0.0	2	2	0
fam7671	2	2	2	2.0	0.0	0.0	2	2	0
fam7672	2	2	2	2.0	0.0	0.0	2	2	0
fam7673	2	2	2	2.0	0.0	0.0	2	2	0
fam7674	2	2	2	2.0	0.0	0.0	2	2	0
fam7675	2	2	2	2.0	0.0	0.0	2	2	0
fam7676	2	2	2	2.0	0.0	0.0	2	2	0
fam7677	2	2	2	2.0	0.0	0.0	2	2	0
fam7678	2	2	2	2.0	0.0	0.0	2	2	0
fam7679	2	2	2	2.0	0.0	0.0	2	2	0
fam7680	2	2	2	2.0	0.0	0.0	2	2	0
fam7681	2	2	2	2.0	0.0	0.0	2	2	0
fam7682	2	2	2	2.0	0.0	0.0	2	2	0
fam7683	2	2	2	2.0	0.0	0.0	2	2	0
fam7684	2	2	2	2.0	0.0	0.0	2	2	0
fam7685	2	2	2	2.0	0.0	0.0	2	2	0
fam7686	2	2	2	2.0	0.0	0.0	2	2	0
fam7687	2	2	2	2.0	0.0	0.0	2	2	0
fam7688	2	2	2	2.0	0.0	0.0	2	2	0
fam7689	2	2	2	2.0	0.0	0.0	2	2	0
fam7690	2	2	2	2.0	0.0	0.0	2	2	0
fam7691	2	2	2	2.0	0.0	0.0	2	2	0
fam7692	2	2	2	2.0	0.0	0.0	2	2	0
fam7693	2	2	2	2.0	0.0	0.0	2	2	0
fam7694	2	2	2	2.0	0.0	0.0	2	2	0
fam7695	2	2	2	2.0	0.0	0.0	2	2	0
fam7696	2	2	2	2.0	0.0	0.0	2	2	0
fam7697	2	2	2	2.0	0.0	0.0	2	2	0
fam7698	2	2	2	2.0	0.0	0.0	2	2	0
fam7699	2	2	2	2.0	0.0	0.0	2	2	0
fam7700	2	2	2	2.0	0.0	0.0	2	2	0
fam7701	2	2	2	2.0	0.0	0.0	2	2	0
fam7702	2	2	2	2.0	0.0	0.0	2	2	0
fam7703	2	2	2	2.0	0.0	0.0	2	2	0
fam7704	2	2	2	2.0	0.0	0.0	2	2	0
fam7705	2	2	2	2.0	0.0	0.0	2	2	0
fam7706	2	2	2	2.0	0.0	0.0	2	2	0
fam7707	2	2	2	2.0	0.0	0.0	2	2	0
fam7708	2	2	2	2.0	0.0	0.0	2	2	0
fam7709	2	2	2	2.0	0.0	0.0	2	2	0
fam7710	2	2	2	2.0	0.0	0.0	2	2	0
fam7711	2	2	2	2.0	0.0	0.0	2	2	0
fam7712	2	2	2	2.0	0.0	0.0	2	2	0
fam7713	2	2	2	2.0	0.0	0.0	2	2	0
fam7714	2	2	2	2.0	0.0	0.0	2	2	0
fam7715	2	2	2	2.0	0.0	0.0	2	2	0
fam7716	2	2	2	2.0	0.0	0.0	2	2	0
fam7717	2	2	2	2.0	0.0	0.0	2	2	0
fam7718	2	2	2	2.0	0.0	0.0	2	2	0
fam7719	2	2	2	2.0	0.0	0.0	2	2	0
fam7720	2	2	2	2.0	0.0	0.0	2	2	0
fam7721	2	2	2	2.0	0.0	0.0	2	2	0
fam7722	2	2	2	2.0	0.0	0.0	2	2	0
fam7723	2	2	2	2.0	0.0	0.0	2	2	0
fam7724	2	2	2	2.0	0.0	0.0	2	2	0
fam7725	2	2	2	2.0	0.0	0.0	2	2	0
fam7726	2	2	2	2.0	0.0	0.0	2	2	0
fam7727	2	2	2	2.0	0.0	0.0	2	2	0
fam7728	2	2	2	2.0	0.0	0.0	2	2	0
fam7729	2	2	2	2.0	0.0	0.0	2	2	0
fam7730	2	2	2	2.0	0.0	0.0	2	2	0
fam7731	2	2	2	2.0	0.0	0.0	2	2	0
fam7732	2	2	2	2.0	0.0	0.0	2	2	0
fam7733	2	2	2	2.0	0.0	0.0	2	2	0
fam7734	2	2	2	2.0	0.0	0.0	2	2	0
fam7735	2	2	2	2.0	0.0	0.0	2	2	0
fam7736	2	2	2	2.0	0.0	0.0	2	2	0
fam7737	2	2	2	2.0	0.0	0.0	2	2	0
fam7738	2	2	2	2.0	0.0	0.0	2	2	0
fam7739	2	2	2	2.0	0.0	0.0	2	2	0
fam7740	2	2	2	2.0	0.0	0.0	2	2	0
fam7741	2	2	2	2.0	0.0	0.0	2	2	0
fam7742	2	2	2	2.0	0.0	0.0	2	2	0
fam7743	2	2	2	2.0	0.0	0.0	2	2	0
fam7744	2	2	2	2.0	0.0	0.0	2	2	0
fam7745	2	2	2	2.0	0.0	0.0	2	2	0
fam7746	2	2	2	2.0	0.0	0.0	2	2	0
fam7747	2	2	2	2.0	0.0	0.0	2	2	0
fam7748	2	2	2	2.0	0.0	0.0	2	2	0
fam7749	2	2	2	2.0	0.0	0.0	2	2	0
fam7750	2	2	2	2.0	0.0	0.0	2	2	0
fam7751	2	2	2	2.0	0.0	0.0	2	2	0
fam7752	2	2	2	2.0	0.0	0.0	2	2	0
fam7753	2	2	2	2.0	0.0	0.0	2	2	0
fam7754	2	2	2	2.0	0.0	0.0	2	2	0
fam7755	2	2	2	2.0	0.0	0.0	2	2	0
fam7756	2	2	2	2.0	0.0	0.0	2	2	0
fam7757	2	2	2	2.0	0.0	0.0	2	2	0
fam7758	2	2	2	2.0	0.0	0.0	2	2	0
fam7759	2	2	2	2.0	0.0	0.0	2	2	0
fam7760	2	2	2	2.0	0.0	0.0	2	2	0
fam7761	2	2	2	2.0	0.0	0.0	2	2	0
fam7762	2	2	2	2.0	0.0	0.0	2	2	0
fam7763	2	2	2	2.0	0.0	0.0	2	2	0
fam7764	2	2	2	2.0	0.0	0.0	2	2	0
fam7765	2	2	2	2.0	0.0	0.0	2	2	0
fam7766	2	2	2	2.0	0.0	0.0	2	2	0
fam7767	2	2	2	2.0	0.0	0.0	2	2	0
fam7768	2	2	2	2.0	0.0	0.0	2	2	0
fam7769	2	2	2	2.0	0.0	0.0	2	2	0
fam7770	2	2	2	2.0	0.0	0.0	2	2	0
fam7771	2	2	2	2.0	0.0	0.0	2	2	0
fam7772	2	2	2	2.0	0.0	0.0	2	2	0
fam7773	2	2	2	2.0	0.0	0.0	2	2	0
fam7774	2	2	2	2.0	0.0	0.0	2	2	0
fam7775	2	2	2	2.0	0.0	0.0	2	2	0
fam7776	2	2	2	2.0	0.0	0.0	2	2	0
fam7777	2	2	2	2.0	0.0	0.0	2	2	0
fam7778	2	2	2	2.0	0.0	0.0	2	2	0
fam7779	2	2	2	2.0	0.0	0.0	2	2	0
fam7780	2	2	2	2.0	0.0	0.0	2	2	0
fam7781	2	2	2	2.0	0.0	0.0	2	2	0
fam7782	2	2	2	2.0	0.0	0.0	2	2	0
fam7783	2	2	2	2.0	0.0	0.0	2	2	0
fam7784	2	2	2	2.0	0.0	0.0	2	2	0
fam7785	2	2	2	2.0	0.0	0.0	2	2	0
fam7786	2	2	2	2.0	0.0	0.0	2	2	0
fam7787	2	2	2	2.0	0.0	0.0	2	2	0
fam7788	2	2	2	2.0	0.0	0.0	2	2	0
fam7789	2	2	2	2.0	0.0	0.0	2	2	0
fam7790	2	2	2	2.0	0.0	0.0	2	2	0
fam7791	2	2	2	2.0	0.0	0.0	2	2	0
fam7792	2	2	2	2.0	0.0	0.0	2	2	0
fam7793	2	2	2	2.0	0.0	0.0	2	2	0
fam7794	2	2	2	2.0	0.0	0.0	2	2	0
fam7795	2	2	2	2.0	0.0	0.0	2	2	0
fam7796	2	2	2	2.0	0.0	0.0	2	2	0
fam7797	2	2	2	2.0	0.0	0.0	2	2	0
fam7798	2	2	2	2.0	0.0	0.0	2	2	0
fam7799	2	2	2	2.0	0.0	0.0	2	2	0
fam7800	2	2	2	2.0	0.0	0.0	2	2	0
fam7801	2	2	2	2.0	0.0	0.0	2	2	0
fam7802	2	2	2	2.0	0.0	0.0	2	2	0
fam7803	2	2	2	2.0	0.0	0.0	2	2	0
fam7804	2	2	2	2.0	0.0	0.0	2	2	0
fam7805	2	2	2	2.0	0.0	0.0	2	2	0
fam7806	2	2	2	2.0	0.0	0.0	2	2	0
fam7807	2	2	2	2.0	0.0	0.0	2	2	0
fam7808	2	2	2	2.0	0.0	0.0	2	2	0
fam7809	2	2	2	2.0	0.0	0.0	2	2	0
fam7810	2	2	2	2.0	0.0	0.0	2	2	0
fam7811	2	2	2	2.0	0.0	0.0	2	2	0
fam7812	2	2	2	2.0	0.0	0.0	2	2	0
fam7813	2	2	2	2.0	0.0	0.0	2	2	0
fam7814	2	2	2	2.0	0.0	0.0	2	2	0
fam7815	2	2	2	2.0	0.0	0.0	2	2	0
fam7816	2	2	2	2.0	0.0	0.0	2	2	0
fam7817	2	2	2	2.0	0.0	0.0	2	2	0
fam7818	2	2	2	2.0	0.0	0.0	2	2	0
fam7819	2	2	2	2.0	0.0	0.0	2	2	0
fam7820	2	2	2	2.0	0.0	0.0	2	2	0
fam7821	2	2	2	2.0	0.0	0.0	2	2	0
fam7822	2	2	2	2.0	0.0	0.0	2	2	0
fam7823	2	2	2	2.0	0.0	0.0	2	2	0
fam7824	2	2	2	2.0	0.0	0.0	2	2	0
fam7825	2	2	2	2.0	0.0	0.0	2	2	0
fam7826	2	2	2	2.0	0.0	0.0	2	2	0
fam7827	2	2	2	2.0	0.0	0.0	2	2	0
fam7828	2	2	2	2.0	0.0	0.0	2	2	0
fam7829	2	2	2	2.0	0.0	0.0	2	2	0
fam7830	2	2	2	2.0	0.0	0.0	2	2	0
fam7831	2	2	2	2.0	0.0	0.0	2	2	0
fam7832	2	2	2	2.0	0.0	0.0	2	2	0
fam7833	2	2	2	2.0	0.0	0.0	2	2	0
fam7834	2	2	2	2.0	0.0	0.0	2	2	0
fam7835	2	2	2	2.0	0.0	0.0	2	2	0
fam7836	2	2	2	2.0	0.0	0.0	2	2	0
fam7837	2	2	2	2.0	0.0	0.0	2	2	0
fam7838	2	2	2	2.0	0.0	0.0	2	2	0
fam7839	2	2	2	2.0	0.0	0.0	2	2	0
fam7840	2	2	2	2.0	0.0	0.0	2	2	0
fam7841	2	2	2	2.0	0.0	0.0	2	2	0
fam7842	2	2	2	2.0	0.0	0.0	2	2	0
fam7843	2	2	2	2.0	0.0	0.0	2	2	0
fam7844	2	2	2	2.0	0.0	0.0	2	2	0
fam7845	2	2	2	2.0	0.0	0.0	2	2	0
fam7846	2	2	2	2.0	0.0	0.0	2	2	0
fam7847	2	2	2	2.0	0.0	0.0	2	2	0
fam7848	2	2	2	2.0	0.0	0.0	2	2	0
fam7849	2	2	2	2.0	0.0	0.0	2	2	0
fam7850	2	2	2	2.0	0.0	0.0	2	2	0
fam7851	2	2	2	2.0	0.0	0.0	2	2	0
fam7852	2	2	2	2.0	0.0	0.0	2	2	0
fam7853	2	2	2	2.0	0.0	0.0	2	2	0
fam7854	2	2	2	2.0	0.0	0.0	2	2	0
fam7855	2	2	2	2.0	0.0	0.0	2	2	0
fam7856	2	2	2	2.0	0.0	0.0	2	2	0
fam7857	2	2	2	2.0	0.0	0.0	2	2	0
fam7858	2	2	2	2.0	0.0	0.0	2	2	0
fam7859	2	2	2	2.0	0.0	0.0	2	2	0
fam7860	2	2	2	2.0	0.0	0.0	2	2	0
fam7861	2	2	2	2.0	0.0	0.0	2	2	0
fam7862	2	2	2	2.0	0.0	0.0	2	2	0
fam7863	2	2	2	2.0	0.0	0.0	2	2	0
fam7864	2	2	2	2.0	0.0	0.0	2	2	0
fam7865	2	2	2	2.0	0.0	0.0	2	2	0
fam7866	2	2	2	2.0	0.0	0.0	2	2	0
fam7867	2	2	2	2.0	0.0	0.0	2	2	0
fam7868	2	2	2	2.0	0.0	0.0	2	2	0
fam7869	2	2	2	2.0	0.0	0.0	2	2	0
fam7870	2	2	2	2.0	0.0	0.0	2	2	0
fam7871	2	2	2	2.0	0.0	0.0	2	2	0
fam7872	2	2	2	2.0	0.0	0.0	2	2	0
fam7873	2	2	2	2.0	0.0	0.0	2	2	0
fam7874	2	2	2	2.0	0.0	0.0	2	2	0
fam7875	2	2	2	2.0	0.0	0.0	2	2	0
fam7876	2	2	2	2.0	0.0	0.0	2	2	0
fam7877	2	2	2	2.0	0.0	0.0	2	2	0
fam7878	2	2	2	2.0	0.0	0.0	2	2	0
fam7879	2	2	2	2.0	0.0	0.0	2	2	0
fam7880	2	2	2	2.0	0.0	0.0	2	2	0
fam7881	2	2	2	2.0	0.0	0.0	2	2	0
fam7882	2	2	2	2.0	0.0	0.0	2	2	0
fam7883	2	2	2	2.0	0.0	0.0	2	2	0
fam7884	2	2	2	2.0	0.0	0.0	2	2	0
fam7885	2	2	2	2.0	0.0	0.0	2	2	0
fam7886	2	2	2	2.0	0.0	0.0	2	2	0
fam7887	2	2	2	2.0	0.0	0.0	2	2	0
fam7888	2	2	2	2.0	0.0	0.0	2	2	0
fam7889	2	2	2	2.0	0.0	0.0	2	2	0
fam7890	2	2	2	2.0	0.0	0.0	2	2	0
fam7891	2	2	2	2.0	0.0	0.0	2	2	0
fam7892	2	2	2	2.0	0.0	0.0	2	2	0
fam7893	2	2	2	2.0	0.0	0.0	2	2	0
fam7894	2	2	2	2.0	0.0	0.0	2	2	0
fam7895	2	2	2	2.0	0.0	0.0	2	2	0
fam7896	2	2	2	2.0	0.0	0.0	2	2	0
fam7897	2	2	2	2.0	0.0	0.0	2	2	0
fam7898	2	2	2	2.0	0.0	0.0	2	2	0
fam7899	2	2	2	2.0	0.0	0.0	2	2	0
fam7900	2	2	2	2.0	0.0	0.0	2	2	0
fam7901	2	2	2	2.0	0.0	0.0	2	2	0
fam7902	2	2	2	2.0	0.0	0.0	2	2	0
fam7903	2	2	2	2.0	0.0	0.0	2	2	0
fam7904	2	2	2	2.0	0.0	0.0	2	2	0
fam7905	2	2	2	2.0	0.0	0.0	2	2	0
fam7906	2	2	2	2.0	0.0	0.0	2	2	0
fam7907	2	2	2	2.0	0.0	0.0	2	2	0
fam7908	2	2	2	2.0	0.0	0.0	2	2	0
fam7909	2	2	2	2.0	0.0	0.0	2	2	0
fam7910	2	2	2	2.0	0.0	0.0	2	2	0
fam7911	2	2	2	2.0	0.0	0.0	2	2	0
fam7912	2	2	2	2.0	0.0	0.0	2	2	0
fam7913	2	2	2	2.0	0.0	0.0	2	2	0
fam7914	2	2	2	2.0	0.0	0.0	2	2	0
fam7915	2	2	2	2.0	0.0	0.0	2	2	0
fam7916	2	2	2	2.0	0.0	0.0	2	2	0
fam7917	2	2	2	2.0	0.0	0.0	2	2	0
fam7918	2	2	2	2.0	0.0	0.0	2	2	0
fam7919	2	2	2	2.0	0.0	0.0	2	2	0
fam7920	2	2	2	2.0	0.0	0.0	2	2	0
fam7921	2	2	2	2.0	0.0	0.0	2	2	0
fam7922	2	2	2	2.0	0.0	0.0	2	2	0
fam7923	2	2	2	2.0	0.0	0.0	2	2	0
fam7924	2	2	2	2.0	0.0	0.0	2	2	0
fam7925	2	2	2	2.0	0.0	0.0	2	2	0
fam7926	2	2	2	2.0	0.0	0.0	2	2	0
fam7927	2	2	2	2.0	0.0	0.0	2	2	0
fam7928	2	2	2	2.0	0.0	0.0	2	2	0
fam7929	2	2	2	2.0	0.0	0.0	2	2	0
fam7930	2	2	2	2.0	0.0	0.0	2	2	0
fam7931	2	2	2	2.0	0.0	0.0	2	2	0
fam7932	2	2	2	2.0	0.0	0.0	2	2	0
fam7933	2	2	2	2.0	0.0	0.0	2	2	0
fam7934	2	2	2	2.0	0.0	0.0	2	2	0
fam7935	2	2	2	2.0	0.0	0.0	2	2	0
fam7936	2	2	2	2.0	0.0	0.0	2	2	0
fam7937	2	2	2	2.0	0.0	0.0	2	2	0
fam7938	2	2	2	2.0	0.0	0.0	2	2	0
fam7939	2	2	2	2.0	0.0	0.0	2	2	0
fam7940	2	2	2	2.0	0.0	0.0	2	2	0
fam7941	2	2	2	2.0	0.0	0.0	2	2	0
fam7942	2	2	2	2.0	0.0	0.0	2	2	0
fam7943	2	2	2	2.0	0.0	0.0	2	2	0
fam7944	2	2	2	2.0	0.0	0.0	2	2	0
fam7945	2	2	2	2.0	0.0	0.0	2	2	0
fam7946	2	2	2	2.0	0.0	0.0	2	2	0
fam7947	2	2	2	2.0	0.0	0.0	2	2	0
fam7948	2	2	2	2.0	0.0	0.0	2	2	0
fam7949	2	2	2	2.0	0.0	0.0	2	2	0
fam7950	2	2	2	2.0	0.0	0.0	2	2	0
fam7951	2	2	2	2.0	0.0	0.0	2	2	0
fam7952	2	2	2	2.0	0.0	0.0	2	2	0
fam7953	2	2	2	2.0	0.0	0.0	2	2	0
fam7954	2	2	2	2.0	0.0	0.0	2	2	0
fam7955	2	2	2	2.0	0.0	0.0	2	2	0
fam7956	2	2	2	2.0	0.0	0.0	2	2	0
fam7957	2	2	2	2.0	0.0	0.0	2	2	0
fam7958	2	2	2	2.0	0.0	0.0	2	2	0
fam7959	2	2	2	2.0	0.0	0.0	2	2	0
fam7960	2	2	2	2.0	0.0	0.0	2	2	0
fam7961	2	2	2	2.0	0.0	0.0	2	2	0
fam7962	2	2	2	2.0	0.0	0.0	2	2	0
fam7963	2	2	2	2.0	0.0	0.0	2	2	0
fam7964	2	2	2	2.0	0.0	0.0	2	2	0
fam7965	2	2	2	2.0	0.0	0.0	2	2	0
fam7966	2	2	2	2.0	0.0	0.0	2	2	0
fam7967	2	2	2	2.0	0.0	0.0	2	2	0
fam7968	2	2	2	2.0	0.0	0.0	2	2	0
fam7969	2	2	2	2.0	0.0	0.0	2	2	0
fam7970	2	2	2	2.0	0.0	0.0	2	2	0
fam7971	2	2	2	2.0	0.0	0.0	2	2	0
fam7972	2	2	2	2.0	0.0	0.0	2	2	0
fam7973	2	2	2	2.0	0.0	0.0	2	2	0
fam7974	2	2	2	2.0	0.0	0.0	2	2	0
fam7975	2	2	2	2.0	0.0	0.0	2	2	0
fam7976	2	2	2	2.0	0.0	0.0	2	2	0
fam7977	2	2	2	2.0	0.0	0.0	2	2	0
fam7978	2	2	2	2.0	0.0	0.0	2	2	0
fam7979	2	2	2	2.0	0.0	0.0	2	2	0
fam7980	2	2	2	2.0	0.0	0.0	2	2	0
fam7981	2	2	2	2.0	0.0	0.0	2	2	0
fam7982	2	2	2	2.0	0.0	0.0	2	2	0
fam7983	2	2	2	2.0	0.0	0.0	2	2	0
fam7984	2	2	2	2.0	0.0	0.0	2	2	0
fam7985	2	2	2	2.0	0.0	0.0	2	2	0
fam7986	2	2	2	2.0	0.0	0.0	2	2	0
fam7987	2	2	2	2.0	0.0	0.0	2	2	0
fam7988	2	2	2	2.0	0.0	0.0	2	2	0
fam7989	2	2	2	2.0	0.0	0.0	2	2	0
fam7990	2	2	2	2.0	0.0	0.0	2	2	0
fam7991	2	2	2	2.0	0.0	0.0	2	2	0
fam7992	2	2	2	2.0	0.0	0.0	2	2	0
fam7993	2	2	2	2.0	0.0	0.0	2	2	0
fam7994	2	2	2	2.0	0.0	0.0	2	2	0
fam7995	2	2	2	2.0	0.0	0.0	2	2	0
fam7996	2	2	2	2.0	0.0	0.0	2	2	0
fam7997	2	2	2	2.0	0.0	0.0	2	2	0
fam7998	2	2	2	2.0	0.0	0.0	2	2	0
fam7999	2	2	2	2.0	0.0	0.0	2	2	0
fam8000	2	2	2	2.0	0.0	0.0	2	2	0
fam8001	2	2	2	2.0	0.0	0.0	2	2	0
fam8002	2	2	2	2.0	0.0	0.0	2	2	0
fam8003	2	2	2	2.0	0.0	0.0	2	2	0
fam8004	2	2	2	2.0	0.0	0.0	2	2	0
fam8005	2	2	2	2.0	0.0	0.0	2	2	0
fam8006	2	2	2	2.0	0.0	0.0	2	2	0
fam8007	2	2	2	2.0	0.0	0.0	2	2	0
fam8008	2	2	2	2.0	0.0	0.0	2	2	0
fam8009	2	2	2	2.0	0.0	0.0	2	2	0
fam8010	2	2	2	2.0	0.0	0.0	2	2	0
fam8011	2	2	2	2.0	0.0	0.0	2	2	0
fam8012	2	2	2	2.0	0.0	0.0	2	2	0
fam8013	2	2	2	2.0	0.0	0.0	2	2	0
fam8014	2	2	2	2.0	0.0	0.0	2	2	0
fam8015	2	2	2	2.0	0.0	0.0	2	2	0
fam8016	2	2	2	2.0	0.0	0.0	2	2	0
fam8017	2	2	2	2.0	0.0	0.0	2	2	0
fam8018	2	2	2	2.0	0.0	0.0	2	2	0
fam8019	2	2	2	2.0	0.0	0.0	2	2	0
fam8020	2	2	2	2.0	0.0	0.0	2	2	0
fam8021	2	2	2	2.0	0.0	0.0	2	2	0
fam8022	2	2	2	2.0	0.0	0.0	2	2	0
fam8023	2	2	2	2.0	0.0	0.0	2	2	0
fam8024	2	2	2	2.0	0.0	0.0	2	2	0
fam8025	2	2	2	2.0	0.0	0.0	2	2	0
fam8026	2	2	2	2.0	0.0	0.0	2	2	0
fam8027	2	2	2	2.0	0.0	0.0	2	2	0
fam8028	2	2	2	2.0	0.0	0.0	2	2	0
fam8029	2	2	2	2.0	0.0	0.0	2	2	0
fam8030	2	2	2	2.0	0.0	0.0	2	2	0
fam8031	2	2	2	2.0	0.0	0.0	2	2	0
fam8032	2	2	2	2.0	0.0	0.0	2	2	0
fam8033	2	2	2	2.0	0.0	0.0	2	2	0
fam8034	2	2	2	2.0	0.0	0.0	2	2	0
fam8035	2	2	2	2.0	0.0	0.0	2	2	0
fam8036	2	2	2	2.0	0.0	0.0	2	2	0
fam8037	2	2	2	2.0	0.0	0.0	2	2	0
fam8038	2	2	2	2.0	0.0	0.0	2	2	0
fam8039	2	2	2	2.0	0.0	0.0	2	2	0
fam8040	2	2	2	2.0	0.0	0.0	2	2	0
fam8041	2	2	2	2.0	0.0	0.0	2	2	0
fam8042	2	2	2	2.0	0.0	0.0	2	2	0
fam8043	2	2	2	2.0	0.0	0.0	2	2	0
fam8044	2	2	2	2.0	0.0	0.0	2	2	0
fam8045	2	2	2	2.0	0.0	0.0	2	2	0
fam8046	2	2	2	2.0	0.0	0.0	2	2	0
fam8047	2	2	2	2.0	0.0	0.0	2	2	0
fam8048	2	2	2	2.0	0.0	0.0	2	2	0
fam8049	2	2	2	2.0	0.0	0.0	2	2	0
fam8050	2	2	2	2.0	0.0	0.0	2	2	0
fam8051	2	2	2	2.0	0.0	0.0	2	2	0
fam8052	2	2	2	2.0	0.0	0.0	2	2	0
fam8053	2	2	2	2.0	0.0	0.0	2	2	0
fam8054	2	2	2	2.0	0.0	0.0	2	2	0
fam8055	2	2	2	2.0	0.0	0.0	2	2	0
fam8056	2	2	2	2.0	0.0	0.0	2	2	0
fam8057	2	2	2	2.0	0.0	0.0	2	2	0
fam8058	2	2	2	2.0	0.0	0.0	2	2	0
fam8059	2	2	2	2.0	0.0	0.0	2	2	0
fam8060	2	2	2	2.0	0.0	0.0	2	2	0
fam8061	2	2	2	2.0	0.0	0.0	2	2	0
fam8062	2	2	2	2.0	0.0	0.0	2	2	0
fam8063	2	2	2	2.0	0.0	0.0	2	2	0
fam8064	2	2	2	2.0	0.0	0.0	2	2	0
fam8065	2	2	2	2.0	0.0	0.0	2	2	0
fam8066	2	2	2	2.0	0.0	0.0	2	2	0
fam8067	2	2	2	2.0	0.0	0.0	2	2	0
fam8068	2	2	2	2.0	0.0	0.0	2	2	0
fam8069	2	2	2	2.0	0.0	0.0	2	2	0
fam8070	2	2	2	2.0	0.0	0.0	2	2	0
fam8071	2	2	2	2.0	0.0	0.0	2	2	0
fam8072	2	2	2	2.0	0.0	0.0	2	2	0
fam8073	2	2	2	2.0	0.0	0.0	2	2	0
fam8074	2	2	2	2.0	0.0	0.0	2	2	0
fam8075	2	2	2	2.0	0.0	0.0	2	2	0
fam8076	2	2	2	2.0	0.0	0.0	2	2	0
fam8077	2	2	2	2.0	0.0	0.0	2	2	0
fam8078	2	2	2	2.0	0.0	0.0	2	2	0
fam8079	2	2	2	2.0	0.0	0.0	2	2	0
fam8080	2	2	2	2.0	0.0	0.0	2	2	0
fam8081	2	2	2	2.0	0.0	0.0	2	2	0
fam8082	2	2	2	2.0	0.0	0.0	2	2	0
fam8083	2	2	2	2.0	0.0	0.0	2	2	0
fam8084	2	2	2	2.0	0.0	0.0	2	2	0
fam8085	2	2	2	2.0	0.0	0.0	2	2	0
fam8086	2	2	2	2.0	0.0	0.0	2	2	0
fam8087	2	2	2	2.0	0.0	0.0	2	2	0
fam8088	2	2	2	2.0	0.0	0.0	2	2	0
fam8089	2	2	2	2.0	0.0	0.0	2	2	0
fam8090	2	2	2	2.0	0.0	0.0	2	2	0
fam8091	2	2	2	2.0	0.0	0.0	2	2	0
fam8092	2	2	2	2.0	0.0	0.0	2	2	0
fam8093	2	2	2	2.0	0.0	0.0	2	2	0
fam8094	2	2	2	2.0	0.0	0.0	2	2	0
fam8095	2	2	2	2.0	0.0	0.0	2	2	0
fam8096	2	2	2	2.0	0.0	0.0	2	2	0
fam8097	2	2	2	2.0	0.0	0.0	2	2	0
fam8098	2	2	2	2.0	0.0	0.0	2	2	0
fam8099	2	2	2	2.0	0.0	0.0	2	2	0
fam8100	2	2	2	2.0	0.0	0.0	2	2	0
fam8101	2	2	2	2.0	0.0	0.0	2	2	0
fam8102	2	2	2	2.0	0.0	0.0	2	2	0
fam8103	2	2	2	2.0	0.0	0.0	2	2	0
fam8104	2	2	2	2.0	0.0	0.0	2	2	0
fam8105	2	2	2	2.0	0.0	0.0	2	2	0
fam8106	2	2	2	2.0	0.0	0.0	2	2	0
fam8107	2	2	2	2.0	0.0	0.0	2	2	0
fam8108	2	2	2	2.0	0.0	0.0	2	2	0
fam8109	2	2	2	2.0	0.0	0.0	2	2	0
fam8110	2	2	2	2.0	0.0	0.0	2	2	0
fam8111	2	2	2	2.0	0.0	0.0	2	2	0
fam8112	2	2	2	2.0	0.0	0.0	2	2	0
fam8113	2	2	2	2.0	0.0	0.0	2	2	0
fam8114	2	2	2	2.0	0.0	0.0	2	2	0
fam8115	2	2	2	2.0	0.0	0.0	2	2	0
fam8116	2	2	2	2.0	0.0	0.0	2	2	0
fam8117	2	2	2	2.0	0.0	0.0	2	2	0
fam8118	2	2	2	2.0	0.0	0.0	2	2	0
fam8119	2	2	2	2.0	0.0	0.0	2	2	0
fam8120	2	2	2	2.0	0.0	0.0	2	2	0
fam8121	2	2	2	2.0	0.0	0.0	2	2	0
fam8122	2	2	2	2.0	0.0	0.0	2	2	0
fam8123	2	2	2	2.0	0.0	0.0	2	2	0
fam8124	2	2	2	2.0	0.0	0.0	2	2	0
fam8125	2	2	2	2.0	0.0	0.0	2	2	0
fam8126	2	2	2	2.0	0.0	0.0	2	2	0
fam8127	2	2	2	2.0	0.0	0.0	2	2	0
fam8128	2	2	2	2.0	0.0	0.0	2	2	0
fam8129	2	2	2	2.0	0.0	0.0	2	2	0
fam8130	2	2	2	2.0	0.0	0.0	2	2	0
fam8131	2	2	2	2.0	0.0	0.0	2	2	0
fam8132	2	2	2	2.0	0.0	0.0	2	2	0
fam8133	2	2	2	2.0	0.0	0.0	2	2	0
fam8134	2	2	2	2.0	0.0	0.0	2	2	0
fam8135	2	2	2	2.0	0.0	0.0	2	2	0
fam8136	2	2	2	2.0	0.0	0.0	2	2	0
fam8137	2	2	2	2.0	0.0	0.0	2	2	0
fam8138	2	2	2	2.0	0.0	0.0	2	2	0
fam8139	2	2	2	2.0	0.0	0.0	2	2	0
fam8140	2	2	2	2.0	0.0	0.0	2	2	0
fam8141	2	2	2	2.0	0.0	0.0	2	2	0
fam8142	2	2	2	2.0	0.0	0.0	2	2	0
fam8143	2	2	2	2.0	0.0	0.0	2	2	0
fam8144	2	2	2	2.0	0.0	0.0	2	2	0
fam8145	2	2	2	2.0	0.0	0.0	2	2	0
fam8146	2	2	2	2.0	0.0	0.0	2	2	0
fam8147	2	2	2	2.0	0.0	0.0	2	2	0
fam8148	2	2	2	2.0	0.0	0.0	2	2	0
fam8149	2	2	2	2.0	0.0	0.0	2	2	0
fam8150	2	2	2	2.0	0.0	0.0	2	2	0
fam8151	2	2	2	2.0	0.0	0.0	2	2	0
fam8152	2	2	2	2.0	0.0	0.0	2	2	0
fam8153	2	2	2	2.0	0.0	0.0	2	2	0
fam8154	2	2	2	2.0	0.0	0.0	2	2	0
fam8155	2	2	2	2.0	0.0	0.0	2	2	0
fam8156	2	2	2	2.0	0.0	0.0	2	2	0
fam8157	2	2	2	2.0	0.0	0.0	2	2	0
fam8158	2	2	2	2.0	0.0	0.0	2	2	0
fam8159	2	2	2	2.0	0.0	0.0	2	2	0
fam8160	2	2	2	2.0	0.0	0.0	2	2	0
fam8161	2	2	2	2.0	0.0	0.0	2	2	0
fam8162	2	2	2	2.0	0.0	0.0	2	2	0
fam8163	2	2	2	2.0	0.0	0.0	2	2	0
fam8164	2	2	2	2.0	0.0	0.0	2	2	0
fam8165	2	2	2	2.0	0.0	0.0	2	2	0
fam8166	2	2	2	2.0	0.0	0.0	2	2	0
fam8167	2	2	2	2.0	0.0	0.0	2	2	0
fam8168	2	2	2	2.0	0.0	0.0	2	2	0
fam8169	2	2	2	2.0	0.0	0.0	2	2	0
fam8170	2	2	2	2.0	0.0	0.0	2	2	0
fam8171	2	2	2	2.0	0.0	0.0	2	2	0
fam8172	2	2	2	2.0	0.0	0.0	2	2	0
fam8173	2	2	2	2.0	0.0	0.0	2	2	0
fam8174	2	2	2	2.0	0.0	0.0	2	2	0
fam8175	2	2	2	2.0	0.0	0.0	2	2	0
fam8176	2	2	2	2.0	0.0	0.0	2	2	0
fam8177	2	2	2	2.0	0.0	0.0	2	2	0
fam8178	2	2	2	2.0	0.0	0.0	2	2	0
fam8179	2	2	2	2.0	0.0	0.0	2	2	0
fam8180	2	2	2	2.0	0.0	0.0	2	2	0
fam8181	2	2	2	2.0	0.0	0.0	2	2	0
fam8182	2	2	2	2.0	0.0	0.0	2	2	0
fam8183	2	2	2	2.0	0.0	0.0	2	2	0
fam8184	2	2	2	2.0	0.0	0.0	2	2	0
fam8185	2	2	2	2.0	0.0	0.0	2	2	0
fam8186	2	2	2	2.0	0.0	0.0	2	2	0
fam8187	2	2	2	2.0	0.0	0.0	2	2	0
fam8188	2	2	2	2.0	0.0	0.0	2	2	0
fam8189	2	2	2	2.0	0.0	0.0	2	2	0
fam8190	2	2	2	2.0	0.0	0.0	2	2	0
fam8191	2	2	2	2.0	0.0	0.0	2	2	0
fam8192	2	2	2	2.0	0.0	0.0	2	2	0
fam8193	2	2	2	2.0	0.0	0.0	2	2	0
fam8194	2	2	2	2.0	0.0	0.0	2	2	0
fam8195	2	2	2	2.0	0.0	0.0	2	2	0
fam8196	2	2	2	2.0	0.0	0.0	2	2	0
fam8197	2	2	2	2.0	0.0	0.0	2	2	0
fam8198	2	2	2	2.0	0.0	0.0	2	2	0
fam8199	2	2	2	2.0	0.0	0.0	2	2	0
fam8200	2	2	2	2.0	0.0	0.0	2	2	0
fam8201	2	2	2	2.0	0.0	0.0	2	2	0
fam8202	2	2	2	2.0	0.0	0.0	2	2	0
fam8203	2	2	2	2.0	0.0	0.0	2	2	0
fam8204	2	2	2	2.0	0.0	0.0	2	2	0
fam8205	2	2	2	2.0	0.0	0.0	2	2	0
fam8206	2	2	2	2.0	0.0	0.0	2	2	0
fam8207	2	2	2	2.0	0.0	0.0	2	2	0
fam8208	2	2	2	2.0	0.0	0.0	2	2	0
fam8209	2	2	2	2.0	0.0	0.0	2	2	0
fam8210	2	2	2	2.0	0.0	0.0	2	2	0
fam8211	2	2	2	2.0	0.0	0.0	2	2	0
fam8212	2	2	2	2.0	0.0	0.0	2	2	0
fam8213	2	2	2	2.0	0.0	0.0	2	2	0
fam8214	2	2	2	2.0	0.0	0.0	2	2	0
fam8215	2	2	2	2.0	0.0	0.0	2	2	0
fam8216	2	2	2	2.0	0.0	0.0	2	2	0
fam8217	2	2	2	2.0	0.0	0.0	2	2	0
fam8218	2	2	2	2.0	0.0	0.0	2	2	0
fam8219	2	2	2	2.0	0.0	0.0	2	2	0
fam8220	2	2	2	2.0	0.0	0.0	2	2	0
fam8221	2	2	2	2.0	0.0	0.0	2	2	0
fam8222	2	2	2	2.0	0.0	0.0	2	2	0
fam8223	2	2	2	2.0	0.0	0.0	2	2	0
fam8224	2	2	2	2.0	0.0	0.0	2	2	0
fam8225	2	2	2	2.0	0.0	0.0	2	2	0
fam8226	2	2	2	2.0	0.0	0.0	2	2	0
fam8227	2	2	2	2.0	0.0	0.0	2	2	0
fam8228	2	2	2	2.0	0.0	0.0	2	2	0
fam8229	2	2	2	2.0	0.0	0.0	2	2	0
fam8230	2	2	2	2.0	0.0	0.0	2	2	0
fam8231	2	2	2	2.0	0.0	0.0	2	2	0
fam8232	2	2	2	2.0	0.0	0.0	2	2	0
fam8233	2	2	2	2.0	0.0	0.0	2	2	0
fam8234	2	2	2	2.0	0.0	0.0	2	2	0
fam8235	2	2	2	2.0	0.0	0.0	2	2	0
fam8236	2	2	2	2.0	0.0	0.0	2	2	0
fam8237	2	2	2	2.0	0.0	0.0	2	2	0
fam8238	2	2	2	2.0	0.0	0.0	2	2	0
fam8239	2	2	2	2.0	0.0	0.0	2	2	0
fam8240	2	2	2	2.0	0.0	0.0	2	2	0
fam8241	2	2	2	2.0	0.0	0.0	2	2	0
fam8242	2	2	2	2.0	0.0	0.0	2	2	0
fam8243	2	2	2	2.0	0.0	0.0	2	2	0
fam8244	2	2	2	2.0	0.0	0.0	2	2	0
fam8245	2	2	2	2.0	0.0	0.0	2	2	0
fam8246	2	2	2	2.0	0.0	0.0	2	2	0
fam8247	2	2	2	2.0	0.0	0.0	2	2	0
fam8248	2	2	2	2.0	0.0	0.0	2	2	0
fam8249	2	2	2	2.0	0.0	0.0	2	2	0
fam8250	2	2	2	2.0	0.0	0.0	2	2	0
fam8251	2	2	2	2.0	0.0	0.0	2	2	0
fam8252	2	2	2	2.0	0.0	0.0	2	2	0
fam8253	2	2	2	2.0	0.0	0.0	2	2	0
fam8254	2	2	2	2.0	0.0	0.0	2	2	0
fam8255	2	2	2	2.0	0.0	0.0	2	2	0
fam8256	2	2	2	2.0	0.0	0.0	2	2	0
fam8257	2	2	2	2.0	0.0	0.0	2	2	0
fam8258	2	2	2	2.0	0.0	0.0	2	2	0
fam8259	2	2	2	2.0	0.0	0.0	2	2	0
fam8260	2	2	2	2.0	0.0	0.0	2	2	0
fam8261	2	2	2	2.0	0.0	0.0	2	2	0
fam8262	2	2	2	2.0	0.0	0.0	2	2	0
fam8263	2	2	2	2.0	0.0	0.0	2	2	0
fam8264	2	2	2	2.0	0.0	0.0	2	2	0
fam8265	2	2	2	2.0	0.0	0.0	2	2	0
fam8266	2	2	2	2.0	0.0	0.0	2	2	0
fam8267	2	2	2	2.0	0.0	0.0	2	2	0
fam8268	2	2	2	2.0	0.0	0.0	2	2	0
fam8269	2	2	2	2.0	0.0	0.0	2	2	0
fam8270	2	2	2	2.0	0.0	0.0	2	2	0
fam8271	2	2	2	2.0	0.0	0.0	2	2	0
fam8272	2	2	2	2.0	0.0	0.0	2	2	0
fam8273	2	2	2	2.0	0.0	0.0	2	2	0
fam8274	2	2	2	2.0	0.0	0.0	2	2	0
fam8275	2	2	2	2.0	0.0	0.0	2	2	0
fam8276	2	2	2	2.0	0.0	0.0	2	2	0
fam8277	2	2	2	2.0	0.0	0.0	2	2	0
fam8278	2	2	2	2.0	0.0	0.0	2	2	0
fam8279	2	2	2	2.0	0.0	0.0	2	2	0
fam8280	2	2	2	2.0	0.0	0.0	2	2	0
fam8281	2	2	2	2.0	0.0	0.0	2	2	0
fam8282	2	2	2	2.0	0.0	0.0	2	2	0
fam8283	2	2	2	2.0	0.0	0.0	2	2	0
fam8284	2	2	2	2.0	0.0	0.0	2	2	0
fam8285	2	2	2	2.0	0.0	0.0	2	2	0
fam8286	2	2	2	2.0	0.0	0.0	2	2	0
fam8287	2	2	2	2.0	0.0	0.0	2	2	0
fam8288	2	2	2	2.0	0.0	0.0	2	2	0
fam8289	2	2	2	2.0	0.0	0.0	2	2	0
fam8290	2	2	2	2.0	0.0	0.0	2	2	0
fam8291	2	2	2	2.0	0.0	0.0	2	2	0
fam8292	2	2	2	2.0	0.0	0.0	2	2	0
fam8293	2	2	2	2.0	0.0	0.0	2	2	0
fam8294	2	2	2	2.0	0.0	0.0	2	2	0
fam8295	2	2	2	2.0	0.0	0.0	2	2	0
fam8296	2	2	2	2.0	0.0	0.0	2	2	0
fam8297	2	2	2	2.0	0.0	0.0	2	2	0
fam8298	2	2	2	2.0	0.0	0.0	2	2	0
fam8299	2	2	2	2.0	0.0	0.0	2	2	0
fam8300	2	2	2	2.0	0.0	0.0	2	2	0
fam8301	2	2	2	2.0	0.0	0.0	2	2	0
fam8302	2	2	2	2.0	0.0	0.0	2	2	0
fam8303	2	2	2	2.0	0.0	0.0	2	2	0
fam8304	2	2	2	2.0	0.0	0.0	2	2	0
fam8305	2	2	2	2.0	0.0	0.0	2	2	0
fam8306	2	2	2	2.0	0.0	0.0	2	2	0
fam8307	2	2	2	2.0	0.0	0.0	2	2	0
fam8308	2	2	2	2.0	0.0	0.0	2	2	0
fam8309	2	2	2	2.0	0.0	0.0	2	2	0
fam8310	2	2	2	2.0	0.0	0.0	2	2	0
fam8311	2	2	2	2.0	0.0	0.0	2	2	0
fam8312	2	2	2	2.0	0.0	0.0	2	2	0
fam8313	2	2	2	2.0	0.0	0.0	2	2	0
fam8314	2	2	2	2.0	0.0	0.0	2	2	0
fam8315	2	2	2	2.0	0.0	0.0	2	2	0
fam8316	2	2	2	2.0	0.0	0.0	2	2	0
fam8317	2	2	2	2.0	0.0	0.0	2	2	0
fam8318	2	2	2	2.0	0.0	0.0	2	2	0
fam8319	2	2	2	2.0	0.0	0.0	2	2	0
fam8320	2	2	2	2.0	0.0	0.0	2	2	0
fam8321	2	2	2	2.0	0.0	0.0	2	2	0
fam8322	2	2	2	2.0	0.0	0.0	2	2	0
fam8323	2	2	2	2.0	0.0	0.0	2	2	0
fam8324	2	2	2	2.0	0.0	0.0	2	2	0
fam8325	2	2	2	2.0	0.0	0.0	2	2	0
fam8326	2	2	2	2.0	0.0	0.0	2	2	0
fam8327	2	2	2	2.0	0.0	0.0	2	2	0
fam8328	2	2	2	2.0	0.0	0.0	2	2	0
fam8329	2	2	2	2.0	0.0	0.0	2	2	0
fam8330	2	2	2	2.0	0.0	0.0	2	2	0
fam8331	2	2	2	2.0	0.0	0.0	2	2	0
fam8332	2	2	2	2.0	0.0	0.0	2	2	0
fam8333	2	2	2	2.0	0.0	0.0	2	2	0
fam8334	2	2	2	2.0	0.0	0.0	2	2	0
fam8335	2	2	2	2.0	0.0	0.0	2	2	0
fam8336	2	2	2	2.0	0.0	0.0	2	2	0
fam8337	2	2	2	2.0	0.0	0.0	2	2	0
fam8338	2	2	2	2.0	0.0	0.0	2	2	0
fam8339	2	2	2	2.0	0.0	0.0	2	2	0
fam8340	2	2	2	2.0	0.0	0.0	2	2	0
fam8341	2	2	2	2.0	0.0	0.0	2	2	0
fam8342	2	2	2	2.0	0.0	0.0	2	2	0
fam8343	2	2	2	2.0	0.0	0.0	2	2	0
fam8344	2	2	2	2.0	0.0	0.0	2	2	0
fam8345	2	2	2	2.0	0.0	0.0	2	2	0
fam8346	2	2	2	2.0	0.0	0.0	2	2	0
fam8347	2	2	2	2.0	0.0	0.0	2	2	0
fam8348	2	2	2	2.0	0.0	0.0	2	2	0
fam8349	2	2	2	2.0	0.0	0.0	2	2	0
fam8350	2	2	2	2.0	0.0	0.0	2	2	0
fam8351	2	2	2	2.0	0.0	0.0	2	2	0
fam8352	2	2	2	2.0	0.0	0.0	2	2	0
fam8353	2	2	2	2.0	0.0	0.0	2	2	0
fam8354	2	2	2	2.0	0.0	0.0	2	2	0
fam8355	2	2	2	2.0	0.0	0.0	2	2	0
fam8356	2	2	2	2.0	0.0	0.0	2	2	0
fam8357	2	2	2	2.0	0.0	0.0	2	2	0
fam8358	2	2	2	2.0	0.0	0.0	2	2	0
fam8359	2	2	2	2.0	0.0	0.0	2	2	0
fam8360	2	2	2	2.0	0.0	0.0	2	2	0
fam8361	2	2	2	2.0	0.0	0.0	2	2	0
fam8362	2	2	2	2.0	0.0	0.0	2	2	0
fam8363	2	2	2	2.0	0.0	0.0	2	2	0
fam8364	2	2	2	2.0	0.0	0.0	2	2	0
fam8365	2	2	2	2.0	0.0	0.0	2	2	0
fam8366	2	2	2	2.0	0.0	0.0	2	2	0
fam8367	2	2	2	2.0	0.0	0.0	2	2	0
fam8368	2	2	2	2.0	0.0	0.0	2	2	0
fam8369	2	2	2	2.0	0.0	0.0	2	2	0
fam8370	2	2	2	2.0	0.0	0.0	2	2	0
fam8371	2	2	2	2.0	0.0	0.0	2	2	0
fam8372	2	2	2	2.0	0.0	0.0	2	2	0
fam8373	2	2	2	2.0	0.0	0.0	2	2	0
fam8374	2	2	2	2.0	0.0	0.0	2	2	0
fam8375	2	2	2	2.0	0.0	0.0	2	2	0
fam8376	2	2	2	2.0	0.0	0.0	2	2	0
fam8377	2	2	2	2.0	0.0	0.0	2	2	0
fam8378	2	2	2	2.0	0.0	0.0	2	2	0
fam8379	2	2	2	2.0	0.0	0.0	2	2	0
fam8380	2	2	2	2.0	0.0	0.0	2	2	0
fam8381	2	2	2	2.0	0.0	0.0	2	2	0
fam8382	2	2	2	2.0	0.0	0.0	2	2	0
fam8383	2	2	2	2.0	0.0	0.0	2	2	0
fam8384	2	2	2	2.0	0.0	0.0	2	2	0
fam8385	2	2	2	2.0	0.0	0.0	2	2	0
fam8386	2	2	2	2.0	0.0	0.0	2	2	0
fam8387	2	2	2	2.0	0.0	0.0	2	2	0
fam8388	2	2	2	2.0	0.0	0.0	2	2	0
fam8389	2	2	2	2.0	0.0	0.0	2	2	0
fam8390	2	2	2	2.0	0.0	0.0	2	2	0
fam8391	2	2	2	2.0	0.0	0.0	2	2	0
fam8392	2	2	2	2.0	0.0	0.0	2	2	0
fam8393	2	2	2	2.0	0.0	0.0	2	2	0
fam8394	2	2	2	2.0	0.0	0.0	2	2	0
fam8395	2	2	2	2.0	0.0	0.0	2	2	0
fam8396	2	2	2	2.0	0.0	0.0	2	2	0
fam8397	2	2	2	2.0	0.0	0.0	2	2	0
fam8398	2	2	2	2.0	0.0	0.0	2	2	0
fam8399	2	2	2	2.0	0.0	0.0	2	2	0
fam8400	2	2	2	2.0	0.0	0.0	2	2	0
fam8401	2	2	2	2.0	0.0	0.0	2	2	0
fam8402	2	2	2	2.0	0.0	0.0	2	2	0
fam8403	2	2	2	2.0	0.0	0.0	2	2	0
fam8404	2	2	2	2.0	0.0	0.0	2	2	0
fam8405	2	2	2	2.0	0.0	0.0	2	2	0
fam8406	2	2	2	2.0	0.0	0.0	2	2	0
fam8407	2	2	2	2.0	0.0	0.0	2	2	0
fam8408	2	2	2	2.0	0.0	0.0	2	2	0
fam8409	2	2	2	2.0	0.0	0.0	2	2	0
fam8410	2	2	2	2.0	0.0	0.0	2	2	0
fam8411	2	2	2	2.0	0.0	0.0	2	2	0
fam8412	2	2	2	2.0	0.0	0.0	2	2	0
fam8413	2	2	2	2.0	0.0	0.0	2	2	0
fam8414	2	2	2	2.0	0.0	0.0	2	2	0
fam8415	2	2	2	2.0	0.0	0.0	2	2	0
fam8416	2	2	2	2.0	0.0	0.0	2	2	0
fam8417	2	2	2	2.0	0.0	0.0	2	2	0
fam8418	2	2	2	2.0	0.0	0.0	2	2	0
fam8419	2	2	2	2.0	0.0	0.0	2	2	0
fam8420	2	2	2	2.0	0.0	0.0	2	2	0
fam8421	2	2	2	2.0	0.0	0.0	2	2	0
fam8422	2	2	2	2.0	0.0	0.0	2	2	0
fam8423	2	2	2	2.0	0.0	0.0	2	2	0
fam8424	2	2	2	2.0	0.0	0.0	2	2	0
fam8425	2	2	2	2.0	0.0	0.0	2	2	0
fam8426	2	2	2	2.0	0.0	0.0	2	2	0
fam8427	2	2	2	2.0	0.0	0.0	2	2	0
fam8428	2	2	2	2.0	0.0	0.0	2	2	0
fam8429	2	2	2	2.0	0.0	0.0	2	2	0
fam8430	2	2	2	2.0	0.0	0.0	2	2	0
fam8431	2	2	2	2.0	0.0	0.0	2	2	0
fam8432	2	2	2	2.0	0.0	0.0	2	2	0
fam8433	2	2	2	2.0	0.0	0.0	2	2	0
fam8434	2	2	2	2.0	0.0	0.0	2	2	0
fam8435	2	2	2	2.0	0.0	0.0	2	2	0
fam8436	2	2	2	2.0	0.0	0.0	2	2	0
fam8437	2	2	2	2.0	0.0	0.0	2	2	0
fam8438	2	2	2	2.0	0.0	0.0	2	2	0
fam8439	2	2	2	2.0	0.0	0.0	2	2	0
fam8440	2	2	2	2.0	0.0	0.0	2	2	0
fam8441	2	2	2	2.0	0.0	0.0	2	2	0
fam8442	2	2	2	2.0	0.0	0.0	2	2	0
fam8443	2	2	2	2.0	0.0	0.0	2	2	0
fam8444	2	2	2	2.0	0.0	0.0	2	2	0
fam8445	2	2	2	2.0	0.0	0.0	2	2	0
fam8446	2	2	2	2.0	0.0	0.0	2	2	0
fam8447	2	2	2	2.0	0.0	0.0	2	2	0
fam8448	2	2	2	2.0	0.0	0.0	2	2	0
fam8449	2	2	2	2.0	0.0	0.0	2	2	0
fam8450	2	2	2	2.0	0.0	0.0	2	2	0
fam8451	2	2	2	2.0	0.0	0.0	2	2	0
fam8452	2	2	2	2.0	0.0	0.0	2	2	0
fam8453	2	2	2	2.0	0.0	0.0	2	2	0
fam8454	2	2	2	2.0	0.0	0.0	2	2	0
fam8455	2	2	2	2.0	0.0	0.0	2	2	0
fam8456	2	2	2	2.0	0.0	0.0	2	2	0
fam8457	2	2	2	2.0	0.0	0.0	2	2	0
fam8458	2	2	2	2.0	0.0	0.0	2	2	0
fam8459	2	2	2	2.0	0.0	0.0	2	2	0
fam8460	2	2	2	2.0	0.0	0.0	2	2	0
fam8461	2	2	2	2.0	0.0	0.0	2	2	0
fam8462	2	2	2	2.0	0.0	0.0	2	2	0
fam8463	2	2	2	2.0	0.0	0.0	2	2	0
fam8464	2	2	2	2.0	0.0	0.0	2	2	0
fam8465	2	2	2	2.0	0.0	0.0	2	2	0
fam8466	2	2	2	2.0	0.0	0.0	2	2	0
fam8467	2	2	2	2.0	0.0	0.0	2	2	0
fam8468	2	2	2	2.0	0.0	0.0	2	2	0
fam8469	2	2	2	2.0	0.0	0.0	2	2	0
fam8470	2	2	2	2.0	0.0	0.0	2	2	0
fam8471	2	2	2	2.0	0.0	0.0	2	2	0
fam8472	2	2	2	2.0	0.0	0.0	2	2	0
fam8473	2	2	2	2.0	0.0	0.0	2	2	0
fam8474	2	2	2	2.0	0.0	0.0	2	2	0
fam8475	2	2	2	2.0	0.0	0.0	2	2	0
fam8476	2	2	2	2.0	0.0	0.0	2	2	0
fam8477	2	2	2	2.0	0.0	0.0	2	2	0
fam8478	2	2	2	2.0	0.0	0.0	2	2	0
fam8479	2	2	2	2.0	0.0	0.0	2	2	0
fam8480	2	2	2	2.0	0.0	0.0	2	2	0
fam8481	2	2	2	2.0	0.0	0.0	2	2	0
fam8482	2	2	2	2.0	0.0	0.0	2	2	0
fam8483	2	2	2	2.0	0.0	0.0	2	2	0
fam8484	2	2	2	2.0	0.0	0.0	2	2	0
fam8485	2	2	2	2.0	0.0	0.0	2	2	0
fam8486	2	2	2	2.0	0.0	0.0	2	2	0
fam8487	2	2	2	2.0	0.0	0.0	2	2	0
fam8488	2	2	2	2.0	0.0	0.0	2	2	0
fam8489	2	2	2	2.0	0.0	0.0	2	2	0
fam8490	2	2	2	2.0	0.0	0.0	2	2	0
fam8491	2	2	2	2.0	0.0	0.0	2	2	0
fam8492	2	2	2	2.0	0.0	0.0	2	2	0
fam8493	2	2	2	2.0	0.0	0.0	2	2	0
fam8494	2	2	2	2.0	0.0	0.0	2	2	0
fam8495	2	2	2	2.0	0.0	0.0	2	2	0
fam8496	2	2	2	2.0	0.0	0.0	2	2	0
fam8497	2	2	2	2.0	0.0	0.0	2	2	0
fam8498	2	2	2	2.0	0.0	0.0	2	2	0
fam8499	2	2	2	2.0	0.0	0.0	2	2	0
fam8500	2	2	2	2.0	0.0	0.0	2	2	0
fam8501	2	2	2	2.0	0.0	0.0	2	2	0
fam8502	2	2	2	2.0	0.0	0.0	2	2	0
fam8503	2	2	2	2.0	0.0	0.0	2	2	0
fam8504	2	2	2	2.0	0.0	0.0	2	2	0
fam8505	2	2	2	2.0	0.0	0.0	2	2	0
fam8506	2	2	2	2.0	0.0	0.0	2	2	0
fam8507	2	2	2	2.0	0.0	0.0	2	2	0
fam8508	2	2	2	2.0	0.0	0.0	2	2	0
fam8509	2	2	2	2.0	0.0	0.0	2	2	0
fam8510	2	2	2	2.0	0.0	0.0	2	2	0
fam8511	2	2	2	2.0	0.0	0.0	2	2	0
fam8512	2	2	2	2.0	0.0	0.0	2	2	0
fam8513	2	2	2	2.0	0.0	0.0	2	2	0
fam8514	2	2	2	2.0	0.0	0.0	2	2	0
fam8515	2	2	2	2.0	0.0	0.0	2	2	0
fam8516	2	2	2	2.0	0.0	0.0	2	2	0
fam8517	2	2	2	2.0	0.0	0.0	2	2	0
fam8518	2	2	2	2.0	0.0	0.0	2	2	0
fam8519	2	2	2	2.0	0.0	0.0	2	2	0
fam8520	2	2	2	2.0	0.0	0.0	2	2	0
fam8521	2	2	2	2.0	0.0	0.0	2	2	0
fam8522	2	2	2	2.0	0.0	0.0	2	2	0
fam8523	2	2	2	2.0	0.0	0.0	2	2	0
fam8524	2	2	2	2.0	0.0	0.0	2	2	0
fam8525	2	2	2	2.0	0.0	0.0	2	2	0
fam8526	2	2	2	2.0	0.0	0.0	2	2	0
fam8527	2	2	2	2.0	0.0	0.0	2	2	0
fam8528	2	2	2	2.0	0.0	0.0	2	2	0
fam8529	2	2	2	2.0	0.0	0.0	2	2	0
fam8530	2	2	2	2.0	0.0	0.0	2	2	0
fam8531	2	2	2	2.0	0.0	0.0	2	2	0
fam8532	2	2	2	2.0	0.0	0.0	2	2	0
fam8533	2	2	2	2.0	0.0	0.0	2	2	0
fam8534	2	2	2	2.0	0.0	0.0	2	2	0
fam8535	2	2	2	2.0	0.0	0.0	2	2	0
fam8536	2	2	2	2.0	0.0	0.0	2	2	0
fam8537	2	2	2	2.0	0.0	0.0	2	2	0
fam8538	2	2	2	2.0	0.0	0.0	2	2	0
fam8539	2	2	2	2.0	0.0	0.0	2	2	0
fam8540	2	2	2	2.0	0.0	0.0	2	2	0
fam8541	2	2	2	2.0	0.0	0.0	2	2	0
fam8542	2	2	2	2.0	0.0	0.0	2	2	0
fam8543	2	2	2	2.0	0.0	0.0	2	2	0
fam8544	2	2	2	2.0	0.0	0.0	2	2	0
fam8545	2	2	2	2.0	0.0	0.0	2	2	0
fam8546	2	2	2	2.0	0.0	0.0	2	2	0
fam8547	2	2	2	2.0	0.0	0.0	2	2	0
fam8548	2	2	2	2.0	0.0	0.0	2	2	0
fam8549	2	2	2	2.0	0.0	0.0	2	2	0
fam8550	2	2	2	2.0	0.0	0.0	2	2	0
fam8551	2	2	2	2.0	0.0	0.0	2	2	0
fam8552	2	2	2	2.0	0.0	0.0	2	2	0
fam8553	2	2	2	2.0	0.0	0.0	2	2	0
fam8554	2	2	2	2.0	0.0	0.0	2	2	0
fam8555	2	2	2	2.0	0.0	0.0	2	2	0
fam8556	2	2	2	2.0	0.0	0.0	2	2	0
fam8557	2	2	2	2.0	0.0	0.0	2	2	0
fam8558	2	2	2	2.0	0.0	0.0	2	2	0
fam8559	2	2	2	2.0	0.0	0.0	2	2	0
fam8560	2	2	2	2.0	0.0	0.0	2	2	0
fam8561	2	2	2	2.0	0.0	0.0	2	2	0
fam8562	2	2	2	2.0	0.0	0.0	2	2	0
fam8563	2	2	2	2.0	0.0	0.0	2	2	0
fam8564	2	2	2	2.0	0.0	0.0	2	2	0
fam8565	2	2	2	2.0	0.0	0.0	2	2	0
fam8566	2	2	2	2.0	0.0	0.0	2	2	0
fam8567	2	2	2	2.0	0.0	0.0	2	2	0
fam8568	2	2	2	2.0	0.0	0.0	2	2	0
fam8569	2	2	2	2.0	0.0	0.0	2	2	0
fam8570	2	2	2	2.0	0.0	0.0	2	2	0
fam8571	2	2	2	2.0	0.0	0.0	2	2	0
fam8572	2	2	2	2.0	0.0	0.0	2	2	0
fam8573	2	2	2	2.0	0.0	0.0	2	2	0
fam8574	2	2	2	2.0	0.0	0.0	2	2	0
fam8575	2	2	2	2.0	0.0	0.0	2	2	0
fam8576	2	2	2	2.0	0.0	0.0	2	2	0
fam8577	2	2	2	2.0	0.0	0.0	2	2	0
fam8578	2	2	2	2.0	0.0	0.0	2	2	0
fam8579	2	2	2	2.0	0.0	0.0	2	2	0
fam8580	2	2	2	2.0	0.0	0.0	2	2	0
fam8581	2	2	2	2.0	0.0	0.0	2	2	0
fam8582	2	2	2	2.0	0.0	0.0	2	2	0
fam8583	2	2	2	2.0	0.0	0.0	2	2	0
fam8584	2	2	2	2.0	0.0	0.0	2	2	0
fam8585	2	2	2	2.0	0.0	0.0	2	2	0
fam8586	2	2	2	2.0	0.0	0.0	2	2	0
fam8587	2	2	2	2.0	0.0	0.0	2	2	0
fam8588	2	2	2	2.0	0.0	0.0	2	2	0
fam8589	2	2	2	2.0	0.0	0.0	2	2	0
fam8590	2	2	2	2.0	0.0	0.0	2	2	0
fam8591	2	2	2	2.0	0.0	0.0	2	2	0
fam8592	2	2	2	2.0	0.0	0.0	2	2	0
fam8593	2	2	2	2.0	0.0	0.0	2	2	0
fam8594	2	2	2	2.0	0.0	0.0	2	2	0
fam8595	2	2	2	2.0	0.0	0.0	2	2	0
fam8596	2	2	2	2.0	0.0	0.0	2	2	0
fam8597	2	2	2	2.0	0.0	0.0	2	2	0
fam8598	2	2	2	2.0	0.0	0.0	2	2	0
fam8599	2	2	2	2.0	0.0	0.0	2	2	0
fam8600	2	2	2	2.0	0.0	0.0	2	2	0
fam8601	2	2	2	2.0	0.0	0.0	2	2	0
fam8602	2	2	2	2.0	0.0	0.0	2	2	0
fam8603	2	2	2	2.0	0.0	0.0	2	2	0
fam8604	2	2	2	2.0	0.0	0.0	2	2	0
fam8605	2	2	2	2.0	0.0	0.0	2	2	0
fam8606	2	2	2	2.0	0.0	0.0	2	2	0
fam8607	2	2	2	2.0	0.0	0.0	2	2	0
fam8608	2	2	2	2.0	0.0	0.0	2	2	0
fam8609	2	2	2	2.0	0.0	0.0	2	2	0
fam8610	2	2	2	2.0	0.0	0.0	2	2	0
fam8611	2	2	2	2.0	0.0	0.0	2	2	0
fam8612	2	2	2	2.0	0.0	0.0	2	2	0
fam8613	2	2	2	2.0	0.0	0.0	2	2	0
fam8614	2	2	2	2.0	0.0	0.0	2	2	0
fam8615	2	2	2	2.0	0.0	0.0	2	2	0
fam8616	2	2	2	2.0	0.0	0.0	2	2	0
fam8617	2	2	2	2.0	0.0	0.0	2	2	0
fam8618	2	2	2	2.0	0.0	0.0	2	2	0
fam8619	2	2	2	2.0	0.0	0.0	2	2	0
fam8620	2	2	2	2.0	0.0	0.0	2	2	0
fam8621	2	2	2	2.0	0.0	0.0	2	2	0
fam8622	2	2	2	2.0	0.0	0.0	2	2	0
fam8623	2	2	2	2.0	0.0	0.0	2	2	0
fam8624	2	2	2	2.0	0.0	0.0	2	2	0
fam8625	2	2	2	2.0	0.0	0.0	2	2	0
fam8626	2	2	2	2.0	0.0	0.0	2	2	0
fam8627	2	2	2	2.0	0.0	0.0	2	2	0
fam8628	2	2	2	2.0	0.0	0.0	2	2	0
fam8629	2	2	2	2.0	0.0	0.0	2	2	0
fam8630	2	2	2	2.0	0.0	0.0	2	2	0
fam8631	2	2	2	2.0	0.0	0.0	2	2	0
fam8632	2	2	2	2.0	0.0	0.0	2	2	0
fam8633	2	2	2	2.0	0.0	0.0	2	2	0
fam8634	2	2	2	2.0	0.0	0.0	2	2	0
fam8635	2	2	2	2.0	0.0	0.0	2	2	0
fam8636	2	2	2	2.0	0.0	0.0	2	2	0
fam8637	2	2	2	2.0	0.0	0.0	2	2	0
fam8638	2	2	2	2.0	0.0	0.0	2	2	0
fam8639	2	2	2	2.0	0.0	0.0	2	2	0
fam8640	2	2	2	2.0	0.0	0.0	2	2	0
fam8641	2	2	2	2.0	0.0	0.0	2	2	0
fam8642	2	2	2	2.0	0.0	0.0	2	2	0
fam8643	2	2	2	2.0	0.0	0.0	2	2	0
fam8644	2	2	2	2.0	0.0	0.0	2	2	0
fam8645	2	2	2	2.0	0.0	0.0	2	2	0
fam8646	2	2	2	2.0	0.0	0.0	2	2	0
fam8647	2	2	2	2.0	0.0	0.0	2	2	0
fam8648	2	2	2	2.0	0.0	0.0	2	2	0
fam8649	2	2	2	2.0	0.0	0.0	2	2	0
fam8650	2	2	2	2.0	0.0	0.0	2	2	0
fam8651	2	2	2	2.0	0.0	0.0	2	2	0
fam8652	2	2	2	2.0	0.0	0.0	2	2	0
fam8653	2	2	2	2.0	0.0	0.0	2	2	0
fam8654	2	2	2	2.0	0.0	0.0	2	2	0
fam8655	2	2	2	2.0	0.0	0.0	2	2	0
fam8656	2	2	2	2.0	0.0	0.0	2	2	0
fam8657	2	2	2	2.0	0.0	0.0	2	2	0
fam8658	2	2	2	2.0	0.0	0.0	2	2	0
fam8659	2	2	2	2.0	0.0	0.0	2	2	0
fam8660	2	2	2	2.0	0.0	0.0	2	2	0
fam8661	2	2	2	2.0	0.0	0.0	2	2	0
fam8662	2	2	2	2.0	0.0	0.0	2	2	0
fam8663	2	2	2	2.0	0.0	0.0	2	2	0
fam8664	2	2	2	2.0	0.0	0.0	2	2	0
fam8665	2	2	2	2.0	0.0	0.0	2	2	0
fam8666	2	2	2	2.0	0.0	0.0	2	2	0
fam8667	2	2	2	2.0	0.0	0.0	2	2	0
fam8668	2	2	2	2.0	0.0	0.0	2	2	0
fam8669	2	2	2	2.0	0.0	0.0	2	2	0
fam8670	2	2	2	2.0	0.0	0.0	2	2	0
fam8671	2	2	2	2.0	0.0	0.0	2	2	0
fam8672	2	2	2	2.0	0.0	0.0	2	2	0
fam8673	2	2	2	2.0	0.0	0.0	2	2	0
fam8674	2	2	2	2.0	0.0	0.0	2	2	0
fam8675	2	2	2	2.0	0.0	0.0	2	2	0
fam8676	2	2	2	2.0	0.0	0.0	2	2	0
fam8677	2	2	2	2.0	0.0	0.0	2	2	0
fam8678	2	2	2	2.0	0.0	0.0	2	2	0
fam8679	2	2	2	2.0	0.0	0.0	2	2	0
fam8680	2	2	2	2.0	0.0	0.0	2	2	0
fam8681	2	2	2	2.0	0.0	0.0	2	2	0
fam8682	2	2	2	2.0	0.0	0.0	2	2	0
fam8683	2	2	2	2.0	0.0	0.0	2	2	0
fam8684	2	2	2	2.0	0.0	0.0	2	2	0
fam8685	2	2	2	2.0	0.0	0.0	2	2	0
fam8686	2	2	2	2.0	0.0	0.0	2	2	0
fam8687	2	2	2	2.0	0.0	0.0	2	2	0
fam8688	2	2	2	2.0	0.0	0.0	2	2	0
fam8689	2	2	2	2.0	0.0	0.0	2	2	0
fam8690	2	2	2	2.0	0.0	0.0	2	2	0
fam8691	2	2	2	2.0	0.0	0.0	2	2	0
fam8692	2	2	2	2.0	0.0	0.0	2	2	0
fam8693	2	2	2	2.0	0.0	0.0	2	2	0
fam8694	2	2	2	2.0	0.0	0.0	2	2	0
fam8695	2	2	2	2.0	0.0	0.0	2	2	0
fam8696	2	2	2	2.0	0.0	0.0	2	2	0
fam8697	2	2	2	2.0	0.0	0.0	2	2	0
fam8698	2	2	2	2.0	0.0	0.0	2	2	0
fam8699	2	2	2	2.0	0.0	0.0	2	2	0
fam8700	2	2	2	2.0	0.0	0.0	2	2	0
fam8701	2	2	2	2.0	0.0	0.0	2	2	0
fam8702	2	2	2	2.0	0.0	0.0	2	2	0
fam8703	2	2	2	2.0	0.0	0.0	2	2	0
fam8704	2	2	2	2.0	0.0	0.0	2	2	0
fam8705	2	2	2	2.0	0.0	0.0	2	2	0
fam8706	2	2	2	2.0	0.0	0.0	2	2	0
fam8707	2	2	2	2.0	0.0	0.0	2	2	0
fam8708	2	2	2	2.0	0.0	0.0	2	2	0
fam8709	2	2	2	2.0	0.0	0.0	2	2	0
fam8710	2	2	2	2.0	0.0	0.0	2	2	0
fam8711	2	2	2	2.0	0.0	0.0	2	2	0
fam8712	2	2	2	2.0	0.0	0.0	2	2	0
fam8713	2	2	2	2.0	0.0	0.0	2	2	0
fam8714	2	2	2	2.0	0.0	0.0	2	2	0
fam8715	2	2	2	2.0	0.0	0.0	2	2	0
fam8716	2	2	2	2.0	0.0	0.0	2	2	0
fam8717	2	2	2	2.0	0.0	0.0	2	2	0
fam8718	2	2	2	2.0	0.0	0.0	2	2	0
fam8719	2	2	2	2.0	0.0	0.0	2	2	0
fam8720	2	2	2	2.0	0.0	0.0	2	2	0
fam8721	2	2	2	2.0	0.0	0.0	2	2	0
fam8722	2	2	2	2.0	0.0	0.0	2	2	0
fam8723	2	2	2	2.0	0.0	0.0	2	2	0
fam8724	2	2	2	2.0	0.0	0.0	2	2	0
fam8725	2	2	2	2.0	0.0	0.0	2	2	0
fam8726	2	2	2	2.0	0.0	0.0	2	2	0
fam8727	2	2	2	2.0	0.0	0.0	2	2	0
fam8728	2	2	2	2.0	0.0	0.0	2	2	0
fam8729	2	2	2	2.0	0.0	0.0	2	2	0
fam8730	2	2	2	2.0	0.0	0.0	2	2	0
fam8731	2	2	2	2.0	0.0	0.0	2	2	0
fam8732	2	2	2	2.0	0.0	0.0	2	2	0
fam8733	2	2	2	2.0	0.0	0.0	2	2	0
fam8734	2	2	2	2.0	0.0	0.0	2	2	0
fam8735	2	2	2	2.0	0.0	0.0	2	2	0
fam8736	2	2	2	2.0	0.0	0.0	2	2	0
fam8737	2	2	2	2.0	0.0	0.0	2	2	0
fam8738	2	2	2	2.0	0.0	0.0	2	2	0
fam8739	2	2	2	2.0	0.0	0.0	2	2	0
fam8740	2	2	2	2.0	0.0	0.0	2	2	0
fam8741	2	2	2	2.0	0.0	0.0	2	2	0
fam8742	2	2	2	2.0	0.0	0.0	2	2	0
fam8743	2	2	2	2.0	0.0	0.0	2	2	0
fam8744	2	2	2	2.0	0.0	0.0	2	2	0
fam8745	2	2	2	2.0	0.0	0.0	2	2	0
fam8746	2	2	2	2.0	0.0	0.0	2	2	0
fam8747	2	2	2	2.0	0.0	0.0	2	2	0
fam8748	2	2	2	2.0	0.0	0.0	2	2	0
fam8749	2	2	2	2.0	0.0	0.0	2	2	0
fam8750	2	2	2	2.0	0.0	0.0	2	2	0
fam8751	2	2	2	2.0	0.0	0.0	2	2	0
fam8752	2	2	2	2.0	0.0	0.0	2	2	0
fam8753	2	2	2	2.0	0.0	0.0	2	2	0
fam8754	2	2	2	2.0	0.0	0.0	2	2	0
fam8755	2	2	2	2.0	0.0	0.0	2	2	0
fam8756	2	2	2	2.0	0.0	0.0	2	2	0
fam8757	2	2	2	2.0	0.0	0.0	2	2	0
fam8758	2	2	2	2.0	0.0	0.0	2	2	0
fam8759	2	2	2	2.0	0.0	0.0	2	2	0
fam8760	2	2	2	2.0	0.0	0.0	2	2	0
fam8761	2	2	2	2.0	0.0	0.0	2	2	0
fam8762	2	2	2	2.0	0.0	0.0	2	2	0
fam8763	2	2	2	2.0	0.0	0.0	2	2	0
fam8764	2	2	2	2.0	0.0	0.0	2	2	0
fam8765	2	2	2	2.0	0.0	0.0	2	2	0
fam8766	2	2	2	2.0	0.0	0.0	2	2	0
fam8767	2	2	2	2.0	0.0	0.0	2	2	0
fam8768	2	2	2	2.0	0.0	0.0	2	2	0
fam8769	2	2	2	2.0	0.0	0.0	2	2	0
fam8770	2	2	2	2.0	0.0	0.0	2	2	0
fam8771	2	2	2	2.0	0.0	0.0	2	2	0
fam8772	2	2	2	2.0	0.0	0.0	2	2	0
fam8773	2	2	2	2.0	0.0	0.0	2	2	0
fam8774	2	2	2	2.0	0.0	0.0	2	2	0
fam8775	2	2	2	2.0	0.0	0.0	2	2	0
fam8776	2	2	2	2.0	0.0	0.0	2	2	0
fam8777	2	2	2	2.0	0.0	0.0	2	2	0
fam8778	2	2	2	2.0	0.0	0.0	2	2	0
fam8779	2	2	2	2.0	0.0	0.0	2	2	0
fam8780	2	2	2	2.0	0.0	0.0	2	2	0
fam8781	2	2	2	2.0	0.0	0.0	2	2	0
fam8782	2	2	2	2.0	0.0	0.0	2	2	0
fam8783	2	2	2	2.0	0.0	0.0	2	2	0
fam8784	2	2	2	2.0	0.0	0.0	2	2	0
fam8785	2	2	2	2.0	0.0	0.0	2	2	0
fam8786	2	2	2	2.0	0.0	0.0	2	2	0
fam8787	2	2	2	2.0	0.0	0.0	2	2	0
fam8788	2	2	2	2.0	0.0	0.0	2	2	0
fam8789	2	2	2	2.0	0.0	0.0	2	2	0
fam8790	2	2	2	2.0	0.0	0.0	2	2	0
fam8791	2	2	2	2.0	0.0	0.0	2	2	0
fam8792	2	2	2	2.0	0.0	0.0	2	2	0
fam8793	2	2	2	2.0	0.0	0.0	2	2	0
fam8794	2	2	2	2.0	0.0	0.0	2	2	0
fam8795	2	2	2	2.0	0.0	0.0	2	2	0
fam8796	2	2	2	2.0	0.0	0.0	2	2	0
fam8797	2	2	2	2.0	0.0	0.0	2	2	0
fam8798	2	2	2	2.0	0.0	0.0	2	2	0
fam8799	2	2	2	2.0	0.0	0.0	2	2	0
fam8800	2	2	2	2.0	0.0	0.0	2	2	0
fam8801	2	2	2	2.0	0.0	0.0	2	2	0
fam8802	2	2	2	2.0	0.0	0.0	2	2	0
fam8803	2	2	2	2.0	0.0	0.0	2	2	0
fam8804	2	2	2	2.0	0.0	0.0	2	2	0
fam8805	2	2	2	2.0	0.0	0.0	2	2	0
fam8806	2	2	2	2.0	0.0	0.0	2	2	0
fam8807	2	2	2	2.0	0.0	0.0	2	2	0
fam8808	2	2	2	2.0	0.0	0.0	2	2	0
fam8809	2	2	2	2.0	0.0	0.0	2	2	0
fam8810	2	2	2	2.0	0.0	0.0	2	2	0
fam8811	2	2	2	2.0	0.0	0.0	2	2	0
fam8812	2	2	2	2.0	0.0	0.0	2	2	0
fam8813	2	2	2	2.0	0.0	0.0	2	2	0
fam8814	2	2	2	2.0	0.0	0.0	2	2	0
fam8815	2	2	2	2.0	0.0	0.0	2	2	0
fam8816	2	2	2	2.0	0.0	0.0	2	2	0
fam8817	2	2	2	2.0	0.0	0.0	2	2	0
fam8818	2	2	2	2.0	0.0	0.0	2	2	0
fam8819	2	2	2	2.0	0.0	0.0	2	2	0
fam8820	2	2	2	2.0	0.0	0.0	2	2	0
fam8821	2	2	2	2.0	0.0	0.0	2	2	0
fam8822	2	2	2	2.0	0.0	0.0	2	2	0
fam8823	2	2	2	2.0	0.0	0.0	2	2	0
fam8824	2	2	2	2.0	0.0	0.0	2	2	0
fam8825	2	2	2	2.0	0.0	0.0	2	2	0
fam8826	2	2	2	2.0	0.0	0.0	2	2	0
fam8827	2	2	2	2.0	0.0	0.0	2	2	0
fam8828	2	2	2	2.0	0.0	0.0	2	2	0
fam8829	2	2	2	2.0	0.0	0.0	2	2	0
fam8830	2	2	2	2.0	0.0	0.0	2	2	0
fam8831	2	2	2	2.0	0.0	0.0	2	2	0
fam8832	2	2	2	2.0	0.0	0.0	2	2	0
fam8833	2	2	2	2.0	0.0	0.0	2	2	0
fam8834	2	2	2	2.0	0.0	0.0	2	2	0
fam8835	2	2	2	2.0	0.0	0.0	2	2	0
fam8836	2	2	2	2.0	0.0	0.0	2	2	0
fam8837	2	2	2	2.0	0.0	0.0	2	2	0
fam8838	2	2	2	2.0	0.0	0.0	2	2	0
fam8839	2	2	2	2.0	0.0	0.0	2	2	0
fam8840	2	2	2	2.0	0.0	0.0	2	2	0
fam8841	2	2	2	2.0	0.0	0.0	2	2	0
fam8842	2	2	2	2.0	0.0	0.0	2	2	0
fam8843	2	2	2	2.0	0.0	0.0	2	2	0
fam8844	2	2	2	2.0	0.0	0.0	2	2	0
fam8845	2	2	2	2.0	0.0	0.0	2	2	0
fam8846	2	2	2	2.0	0.0	0.0	2	2	0
fam8847	2	2	2	2.0	0.0	0.0	2	2	0
fam8848	2	2	2	2.0	0.0	0.0	2	2	0
fam8849	2	2	2	2.0	0.0	0.0	2	2	0
fam8850	2	2	2	2.0	0.0	0.0	2	2	0
fam8851	2	2	2	2.0	0.0	0.0	2	2	0
fam8852	2	2	2	2.0	0.0	0.0	2	2	0
fam8853	2	2	2	2.0	0.0	0.0	2	2	0
fam8854	2	2	2	2.0	0.0	0.0	2	2	0
fam8855	2	2	2	2.0	0.0	0.0	2	2	0
fam8856	2	2	2	2.0	0.0	0.0	2	2	0
fam8857	2	2	2	2.0	0.0	0.0	2	2	0
fam8858	2	2	2	2.0	0.0	0.0	2	2	0
fam8859	2	2	2	2.0	0.0	0.0	2	2	0
fam8860	2	2	2	2.0	0.0	0.0	2	2	0
fam8861	2	2	2	2.0	0.0	0.0	2	2	0
fam8862	2	2	2	2.0	0.0	0.0	2	2	0
fam8863	2	2	2	2.0	0.0	0.0	2	2	0
fam8864	2	2	2	2.0	0.0	0.0	2	2	0
fam8865	2	2	2	2.0	0.0	0.0	2	2	0
fam8866	2	2	2	2.0	0.0	0.0	2	2	0
fam8867	2	2	2	2.0	0.0	0.0	2	2	0
fam8868	2	2	2	2.0	0.0	0.0	2	2	0
fam8869	2	2	2	2.0	0.0	0.0	2	2	0
fam8870	2	2	2	2.0	0.0	0.0	2	2	0
fam8871	2	2	2	2.0	0.0	0.0	2	2	0
fam8872	2	2	2	2.0	0.0	0.0	2	2	0
fam8873	2	2	2	2.0	0.0	0.0	2	2	0
fam8874	2	2	2	2.0	0.0	0.0	2	2	0
fam8875	2	2	2	2.0	0.0	0.0	2	2	0
fam8876	2	2	2	2.0	0.0	0.0	2	2	0
fam8877	2	2	2	2.0	0.0	0.0	2	2	0
fam8878	2	2	2	2.0	0.0	0.0	2	2	0
fam8879	2	2	2	2.0	0.0	0.0	2	2	0
fam8880	2	2	2	2.0	0.0	0.0	2	2	0
fam8881	2	2	2	2.0	0.0	0.0	2	2	0
fam8882	2	2	2	2.0	0.0	0.0	2	2	0
fam8883	2	2	2	2.0	0.0	0.0	2	2	0
fam8884	2	2	2	2.0	0.0	0.0	2	2	0
fam8885	2	2	2	2.0	0.0	0.0	2	2	0
fam8886	2	2	2	2.0	0.0	0.0	2	2	0
fam8887	2	2	2	2.0	0.0	0.0	2	2	0
fam8888	2	2	2	2.0	0.0	0.0	2	2	0
fam8889	2	2	2	2.0	0.0	0.0	2	2	0
fam8890	2	2	2	2.0	0.0	0.0	2	2	0
fam8891	2	2	2	2.0	0.0	0.0	2	2	0
fam8892	2	2	2	2.0	0.0	0.0	2	2	0
fam8893	2	2	2	2.0	0.0	0.0	2	2	0
fam8894	2	2	2	2.0	0.0	0.0	2	2	0
fam8895	2	2	2	2.0	0.0	0.0	2	2	0
fam8896	2	2	2	2.0	0.0	0.0	2	2	0
fam8897	2	2	2	2.0	0.0	0.0	2	2	0
fam8898	2	2	2	2.0	0.0	0.0	2	2	0
fam8899	2	2	2	2.0	0.0	0.0	2	2	0
fam8900	2	2	2	2.0	0.0	0.0	2	2	0
fam8901	2	2	2	2.0	0.0	0.0	2	2	0
fam8902	2	2	2	2.0	0.0	0.0	2	2	0
fam8903	2	2	2	2.0	0.0	0.0	2	2	0
fam8904	2	2	2	2.0	0.0	0.0	2	2	0
fam8905	2	2	2	2.0	0.0	0.0	2	2	0
fam8906	2	2	2	2.0	0.0	0.0	2	2	0
fam8907	2	2	2	2.0	0.0	0.0	2	2	0
fam8908	2	2	2	2.0	0.0	0.0	2	2	0
fam8909	2	2	2	2.0	0.0	0.0	2	2	0
fam8910	2	2	2	2.0	0.0	0.0	2	2	0
fam8911	2	2	2	2.0	0.0	0.0	2	2	0
fam8912	2	2	2	2.0	0.0	0.0	2	2	0
fam8913	2	2	2	2.0	0.0	0.0	2	2	0
fam8914	2	2	2	2.0	0.0	0.0	2	2	0
fam8915	2	2	2	2.0	0.0	0.0	2	2	0
fam8916	2	2	2	2.0	0.0	0.0	2	2	0
fam8917	2	2	2	2.0	0.0	0.0	2	2	0
fam8918	2	2	2	2.0	0.0	0.0	2	2	0
fam8919	2	2	2	2.0	0.0	0.0	2	2	0
fam8920	2	2	2	2.0	0.0	0.0	2	2	0
fam8921	2	2	2	2.0	0.0	0.0	2	2	0
fam8922	2	2	2	2.0	0.0	0.0	2	2	0
fam8923	2	2	2	2.0	0.0	0.0	2	2	0
fam8924	2	2	2	2.0	0.0	0.0	2	2	0
fam8925	2	2	2	2.0	0.0	0.0	2	2	0
fam8926	2	2	2	2.0	0.0	0.0	2	2	0
fam8927	2	2	2	2.0	0.0	0.0	2	2	0
fam8928	2	2	2	2.0	0.0	0.0	2	2	0
fam8929	2	2	2	2.0	0.0	0.0	2	2	0
fam8930	2	2	2	2.0	0.0	0.0	2	2	0
fam8931	2	2	2	2.0	0.0	0.0	2	2	0
fam8932	2	2	2	2.0	0.0	0.0	2	2	0
fam8933	2	2	2	2.0	0.0	0.0	2	2	0
fam8934	2	2	2	2.0	0.0	0.0	2	2	0
fam8935	2	2	2	2.0	0.0	0.0	2	2	0
fam8936	2	2	2	2.0	0.0	0.0	2	2	0
fam8937	2	2	2	2.0	0.0	0.0	2	2	0
fam8938	2	2	2	2.0	0.0	0.0	2	2	0
fam8939	2	2	2	2.0	0.0	0.0	2	2	0
fam8940	2	2	2	2.0	0.0	0.0	2	2	0
fam8941	2	2	2	2.0	0.0	0.0	2	2	0
fam8942	2	2	2	2.0	0.0	0.0	2	2	0
fam8943	2	2	2	2.0	0.0	0.0	2	2	0
fam8944	2	2	2	2.0	0.0	0.0	2	2	0
fam8945	2	2	2	2.0	0.0	0.0	2	2	0
fam8946	2	2	2	2.0	0.0	0.0	2	2	0
fam8947	2	2	2	2.0	0.0	0.0	2	2	0
fam8948	2	2	2	2.0	0.0	0.0	2	2	0
fam8949	2	2	2	2.0	0.0	0.0	2	2	0
fam8950	2	2	2	2.0	0.0	0.0	2	2	0
fam8951	2	2	2	2.0	0.0	0.0	2	2	0
fam8952	2	2	2	2.0	0.0	0.0	2	2	0
fam8953	2	2	2	2.0	0.0	0.0	2	2	0
fam8954	2	2	2	2.0	0.0	0.0	2	2	0
fam8955	2	2	2	2.0	0.0	0.0	2	2	0
fam8956	2	2	2	2.0	0.0	0.0	2	2	0
fam8957	2	2	2	2.0	0.0	0.0	2	2	0
fam8958	2	2	2	2.0	0.0	0.0	2	2	0
fam8959	2	2	2	2.0	0.0	0.0	2	2	0
fam8960	2	2	2	2.0	0.0	0.0	2	2	0
fam8961	2	2	2	2.0	0.0	0.0	2	2	0
fam8962	2	2	2	2.0	0.0	0.0	2	2	0
fam8963	2	2	2	2.0	0.0	0.0	2	2	0
fam8964	2	2	2	2.0	0.0	0.0	2	2	0
fam8965	2	2	2	2.0	0.0	0.0	2	2	0
fam8966	2	2	2	2.0	0.0	0.0	2	2	0
fam8967	2	2	2	2.0	0.0	0.0	2	2	0
fam8968	2	2	2	2.0	0.0	0.0	2	2	0
fam8969	2	2	2	2.0	0.0	0.0	2	2	0
fam8970	2	2	2	2.0	0.0	0.0	2	2	0
fam8971	2	2	2	2.0	0.0	0.0	2	2	0
fam8972	2	2	2	2.0	0.0	0.0	2	2	0
fam8973	2	2	2	2.0	0.0	0.0	2	2	0
fam8974	2	2	2	2.0	0.0	0.0	2	2	0
fam8975	2	2	2	2.0	0.0	0.0	2	2	0
fam8976	2	2	2	2.0	0.0	0.0	2	2	0
fam8977	2	2	2	2.0	0.0	0.0	2	2	0
fam8978	2	2	2	2.0	0.0	0.0	2	2	0
fam8979	2	2	2	2.0	0.0	0.0	2	2	0
fam8980	2	2	2	2.0	0.0	0.0	2	2	0
fam8981	2	2	2	2.0	0.0	0.0	2	2	0
fam8982	2	2	2	2.0	0.0	0.0	2	2	0
fam8983	2	2	2	2.0	0.0	0.0	2	2	0
fam8984	2	2	2	2.0	0.0	0.0	2	2	0
fam8985	2	2	2	2.0	0.0	0.0	2	2	0
fam8986	2	2	2	2.0	0.0	0.0	2	2	0
fam8987	2	2	2	2.0	0.0	0.0	2	2	0
fam8988	2	2	2	2.0	0.0	0.0	2	2	0
fam8989	2	2	2	2.0	0.0	0.0	2	2	0
fam8990	2	2	2	2.0	0.0	0.0	2	2	0
fam8991	2	2	2	2.0	0.0	0.0	2	2	0
fam8992	2	2	2	2.0	0.0	0.0	2	2	0
fam8993	2	2	2	2.0	0.0	0.0	2	2	0
fam8994	2	2	2	2.0	0.0	0.0	2	2	0
fam8995	2	2	2	2.0	0.0	0.0	2	2	0
fam8996	2	2	2	2.0	0.0	0.0	2	2	0
fam8997	2	2	2	2.0	0.0	0.0	2	2	0
fam8998	2	2	2	2.0	0.0	0.0	2	2	0
fam8999	2	2	2	2.0	0.0	0.0	2	2	0
fam9000	2	2	2	2.0	0.0	0.0	2	2	0
fam9001	2	2	2	2.0	0.0	0.0	2	2	0
fam9002	2	2	2	2.0	0.0	0.0	2	2	0
fam9003	2	2	2	2.0	0.0	0.0	2	2	0
fam9004	2	2	2	2.0	0.0	0.0	2	2	0
fam9005	2	2	2	2.0	0.0	0.0	2	2	0
fam9006	2	2	2	2.0	0.0	0.0	2	2	0
fam9007	2	2	2	2.0	0.0	0.0	2	2	0
fam9008	2	2	2	2.0	0.0	0.0	2	2	0
fam9009	2	2	2	2.0	0.0	0.0	2	2	0
fam9010	2	2	2	2.0	0.0	0.0	2	2	0
fam9011	2	2	2	2.0	0.0	0.0	2	2	0
fam9012	2	2	2	2.0	0.0	0.0	2	2	0
fam9013	2	2	2	2.0	0.0	0.0	2	2	0
fam9014	2	2	2	2.0	0.0	0.0	2	2	0
fam9015	2	2	2	2.0	0.0	0.0	2	2	0
fam9016	2	2	2	2.0	0.0	0.0	2	2	0
fam9017	2	2	2	2.0	0.0	0.0	2	2	0
fam9018	2	2	2	2.0	0.0	0.0	2	2	0
fam9019	2	2	2	2.0	0.0	0.0	2	2	0
fam9020	2	2	2	2.0	0.0	0.0	2	2	0
fam9021	2	2	2	2.0	0.0	0.0	2	2	0
fam9022	2	2	2	2.0	0.0	0.0	2	2	0
fam9023	2	2	2	2.0	0.0	0.0	2	2	0
fam9024	2	2	2	2.0	0.0	0.0	2	2	0
fam9025	2	2	2	2.0	0.0	0.0	2	2	0
fam9026	2	2	2	2.0	0.0	0.0	2	2	0
fam9027	2	2	2	2.0	0.0	0.0	2	2	0
fam9028	2	2	2	2.0	0.0	0.0	2	2	0
fam9029	2	2	2	2.0	0.0	0.0	2	2	0
fam9030	2	2	2	2.0	0.0	0.0	2	2	0
fam9031	2	2	2	2.0	0.0	0.0	2	2	0
fam9032	2	2	2	2.0	0.0	0.0	2	2	0
fam9033	2	2	2	2.0	0.0	0.0	2	2	0
fam9034	2	2	2	2.0	0.0	0.0	2	2	0
fam9035	2	2	2	2.0	0.0	0.0	2	2	0
fam9036	2	2	2	2.0	0.0	0.0	2	2	0
fam9037	2	2	2	2.0	0.0	0.0	2	2	0
fam9038	2	2	2	2.0	0.0	0.0	2	2	0
fam9039	2	2	2	2.0	0.0	0.0	2	2	0
fam9040	2	2	2	2.0	0.0	0.0	2	2	0
fam9041	2	2	2	2.0	0.0	0.0	2	2	0
fam9042	2	2	2	2.0	0.0	0.0	2	2	0
fam9043	2	2	2	2.0	0.0	0.0	2	2	0
fam9044	2	2	2	2.0	0.0	0.0	2	2	0
fam9045	2	2	2	2.0	0.0	0.0	2	2	0
fam9046	2	2	2	2.0	0.0	0.0	2	2	0
fam9047	2	2	2	2.0	0.0	0.0	2	2	0
fam9048	2	2	2	2.0	0.0	0.0	2	2	0
fam9049	2	2	2	2.0	0.0	0.0	2	2	0
fam9050	2	2	2	2.0	0.0	0.0	2	2	0
fam9051	2	2	2	2.0	0.0	0.0	2	2	0
fam9052	2	2	2	2.0	0.0	0.0	2	2	0
fam9053	2	2	2	2.0	0.0	0.0	2	2	0
fam9054	2	2	2	2.0	0.0	0.0	2	2	0
fam9055	2	2	2	2.0	0.0	0.0	2	2	0
fam9056	2	2	2	2.0	0.0	0.0	2	2	0
fam9057	2	2	2	2.0	0.0	0.0	2	2	0
fam9058	2	2	2	2.0	0.0	0.0	2	2	0
fam9059	2	2	2	2.0	0.0	0.0	2	2	0
fam9060	2	2	2	2.0	0.0	0.0	2	2	0
fam9061	2	2	2	2.0	0.0	0.0	2	2	0
fam9062	2	2	2	2.0	0.0	0.0	2	2	0
fam9063	2	2	2	2.0	0.0	0.0	2	2	0
fam9064	2	2	2	2.0	0.0	0.0	2	2	0
fam9065	2	2	2	2.0	0.0	0.0	2	2	0
fam9066	2	2	2	2.0	0.0	0.0	2	2	0
fam9067	2	2	2	2.0	0.0	0.0	2	2	0
fam9068	2	2	2	2.0	0.0	0.0	2	2	0
fam9069	2	2	2	2.0	0.0	0.0	2	2	0
fam9070	2	2	2	2.0	0.0	0.0	2	2	0
fam9071	2	2	2	2.0	0.0	0.0	2	2	0
fam9072	2	2	2	2.0	0.0	0.0	2	2	0
fam9073	2	2	2	2.0	0.0	0.0	2	2	0
fam9074	2	2	2	2.0	0.0	0.0	2	2	0
fam9075	2	2	2	2.0	0.0	0.0	2	2	0
fam9076	2	2	2	2.0	0.0	0.0	2	2	0
fam9077	2	2	2	2.0	0.0	0.0	2	2	0
fam9078	2	2	2	2.0	0.0	0.0	2	2	0
fam9079	2	2	2	2.0	0.0	0.0	2	2	0
fam9080	2	2	2	2.0	0.0	0.0	2	2	0
fam9081	2	2	2	2.0	0.0	0.0	2	2	0
fam9082	2	2	2	2.0	0.0	0.0	2	2	0
fam9083	2	2	2	2.0	0.0	0.0	2	2	0
fam9084	2	2	2	2.0	0.0	0.0	2	2	0
fam9085	2	2	2	2.0	0.0	0.0	2	2	0
fam9086	2	2	2	2.0	0.0	0.0	2	2	0
fam9087	2	2	2	2.0	0.0	0.0	2	2	0
fam9088	2	2	2	2.0	0.0	0.0	2	2	0
fam9089	2	2	2	2.0	0.0	0.0	2	2	0
fam9090	2	2	2	2.0	0.0	0.0	2	2	0
fam9091	2	2	2	2.0	0.0	0.0	2	2	0
fam9092	2	2	2	2.0	0.0	0.0	2	2	0
fam9093	2	2	2	2.0	0.0	0.0	2	2	0
fam9094	2	2	2	2.0	0.0	0.0	2	2	0
fam9095	2	2	2	2.0	0.0	0.0	2	2	0
fam9096	2	2	2	2.0	0.0	0.0	2	2	0
fam9097	2	2	2	2.0	0.0	0.0	2	2	0
fam9098	2	2	2	2.0	0.0	0.0	2	2	0
fam9099	2	2	2	2.0	0.0	0.0	2	2	0
fam9100	2	2	2	2.0	0.0	0.0	2	2	0
fam9101	2	2	2	2.0	0.0	0.0	2	2	0
fam9102	2	2	2	2.0	0.0	0.0	2	2	0
fam9103	2	2	2	2.0	0.0	0.0	2	2	0
fam9104	2	2	2	2.0	0.0	0.0	2	2	0
fam9105	2	2	2	2.0	0.0	0.0	2	2	0
fam9106	2	2	2	2.0	0.0	0.0	2	2	0
fam9107	2	2	2	2.0	0.0	0.0	2	2	0
fam9108	2	2	2	2.0	0.0	0.0	2	2	0
fam9109	2	2	2	2.0	0.0	0.0	2	2	0
fam9110	2	2	2	2.0	0.0	0.0	2	2	0
fam9111	2	2	2	2.0	0.0	0.0	2	2	0
fam9112	2	2	2	2.0	0.0	0.0	2	2	0
fam9113	2	2	2	2.0	0.0	0.0	2	2	0
fam9114	2	2	2	2.0	0.0	0.0	2	2	0
fam9115	2	2	2	2.0	0.0	0.0	2	2	0
fam9116	2	2	2	2.0	0.0	0.0	2	2	0
fam9117	2	2	2	2.0	0.0	0.0	2	2	0
fam9118	2	2	2	2.0	0.0	0.0	2	2	0
fam9119	2	2	2	2.0	0.0	0.0	2	2	0
fam9120	2	2	2	2.0	0.0	0.0	2	2	0
fam9121	2	2	2	2.0	0.0	0.0	2	2	0
fam9122	2	2	2	2.0	0.0	0.0	2	2	0
fam9123	2	2	2	2.0	0.0	0.0	2	2	0
fam9124	2	2	2	2.0	0.0	0.0	2	2	0
fam9125	2	2	2	2.0	0.0	0.0	2	2	0
fam9126	2	2	2	2.0	0.0	0.0	2	2	0
fam9127	2	2	2	2.0	0.0	0.0	2	2	0
fam9128	2	2	2	2.0	0.0	0.0	2	2	0
fam9129	2	2	2	2.0	0.0	0.0	2	2	0
fam9130	2	2	2	2.0	0.0	0.0	2	2	0
fam9131	2	2	2	2.0	0.0	0.0	2	2	0
fam9132	2	2	2	2.0	0.0	0.0	2	2	0
fam9133	2	2	2	2.0	0.0	0.0	2	2	0
fam9134	2	2	2	2.0	0.0	0.0	2	2	0
fam9135	2	2	2	2.0	0.0	0.0	2	2	0
fam9136	2	2	2	2.0	0.0	0.0	2	2	0
fam9137	2	2	2	2.0	0.0	0.0	2	2	0
fam9138	2	2	2	2.0	0.0	0.0	2	2	0
fam9139	2	2	2	2.0	0.0	0.0	2	2	0
fam9140	2	2	2	2.0	0.0	0.0	2	2	0
fam9141	2	2	2	2.0	0.0	0.0	2	2	0
fam9142	2	2	2	2.0	0.0	0.0	2	2	0
fam9143	2	2	2	2.0	0.0	0.0	2	2	0
fam9144	2	2	2	2.0	0.0	0.0	2	2	0
fam9145	2	2	2	2.0	0.0	0.0	2	2	0
fam9146	2	2	2	2.0	0.0	0.0	2	2	0
fam9147	2	2	2	2.0	0.0	0.0	2	2	0
fam9148	2	2	2	2.0	0.0	0.0	2	2	0
fam9149	2	2	2	2.0	0.0	0.0	2	2	0
fam9150	2	2	2	2.0	0.0	0.0	2	2	0
fam9151	2	2	2	2.0	0.0	0.0	2	2	0
fam9152	2	2	2	2.0	0.0	0.0	2	2	0
fam9153	2	2	2	2.0	0.0	0.0	2	2	0
fam9154	2	2	2	2.0	0.0	0.0	2	2	0
fam9155	2	2	2	2.0	0.0	0.0	2	2	0
fam9156	2	2	2	2.0	0.0	0.0	2	2	0
fam9157	2	2	2	2.0	0.0	0.0	2	2	0
fam9158	2	2	2	2.0	0.0	0.0	2	2	0
fam9159	2	2	2	2.0	0.0	0.0	2	2	0
fam9160	2	2	2	2.0	0.0	0.0	2	2	0
fam9161	2	2	2	2.0	0.0	0.0	2	2	0
fam9162	2	2	2	2.0	0.0	0.0	2	2	0
fam9163	2	2	2	2.0	0.0	0.0	2	2	0
fam9164	2	2	2	2.0	0.0	0.0	2	2	0
fam9165	2	2	2	2.0	0.0	0.0	2	2	0
fam9166	2	2	2	2.0	0.0	0.0	2	2	0
fam9167	2	2	2	2.0	0.0	0.0	2	2	0
fam9168	2	2	2	2.0	0.0	0.0	2	2	0
fam9169	2	2	2	2.0	0.0	0.0	2	2	0
fam9170	2	2	2	2.0	0.0	0.0	2	2	0
fam9171	2	2	2	2.0	0.0	0.0	2	2	0
fam9172	2	2	2	2.0	0.0	0.0	2	2	0
fam9173	2	2	2	2.0	0.0	0.0	2	2	0
fam9174	2	2	2	2.0	0.0	0.0	2	2	0
fam9175	2	2	2	2.0	0.0	0.0	2	2	0
fam9176	2	2	2	2.0	0.0	0.0	2	2	0
fam9177	2	2	2	2.0	0.0	0.0	2	2	0
fam9178	2	2	2	2.0	0.0	0.0	2	2	0
fam9179	2	2	2	2.0	0.0	0.0	2	2	0
fam9180	2	2	2	2.0	0.0	0.0	2	2	0
fam9181	2	2	2	2.0	0.0	0.0	2	2	0
fam9182	2	2	2	2.0	0.0	0.0	2	2	0
fam9183	2	2	2	2.0	0.0	0.0	2	2	0
fam9184	2	2	2	2.0	0.0	0.0	2	2	0
fam9185	2	2	2	2.0	0.0	0.0	2	2	0
fam9186	2	2	2	2.0	0.0	0.0	2	2	0
fam9187	2	2	2	2.0	0.0	0.0	2	2	0
fam9188	2	2	2	2.0	0.0	0.0	2	2	0
fam9189	2	2	2	2.0	0.0	0.0	2	2	0
fam9190	2	2	2	2.0	0.0	0.0	2	2	0
fam9191	2	2	2	2.0	0.0	0.0	2	2	0
fam9192	2	2	2	2.0	0.0	0.0	2	2	0
fam9193	2	2	2	2.0	0.0	0.0	2	2	0
fam9194	2	2	2	2.0	0.0	0.0	2	2	0
fam9195	2	2	2	2.0	0.0	0.0	2	2	0
fam9196	2	2	2	2.0	0.0	0.0	2	2	0
fam9197	2	2	2	2.0	0.0	0.0	2	2	0
fam9198	2	2	2	2.0	0.0	0.0	2	2	0
fam9199	2	2	2	2.0	0.0	0.0	2	2	0
fam9200	2	2	2	2.0	0.0	0.0	2	2	0
fam9201	2	2	2	2.0	0.0	0.0	2	2	0
fam9202	2	2	2	2.0	0.0	0.0	2	2	0
fam9203	2	2	2	2.0	0.0	0.0	2	2	0
fam9204	2	2	2	2.0	0.0	0.0	2	2	0
fam9205	2	2	2	2.0	0.0	0.0	2	2	0
fam9206	2	2	2	2.0	0.0	0.0	2	2	0
fam9207	2	2	2	2.0	0.0	0.0	2	2	0
fam9208	2	2	2	2.0	0.0	0.0	2	2	0
fam9209	2	2	2	2.0	0.0	0.0	2	2	0
fam9210	2	2	2	2.0	0.0	0.0	2	2	0
fam9211	2	2	2	2.0	0.0	0.0	2	2	0
fam9212	2	2	2	2.0	0.0	0.0	2	2	0
fam9213	2	2	2	2.0	0.0	0.0	2	2	0
fam9214	2	2	2	2.0	0.0	0.0	2	2	0
fam9215	2	2	2	2.0	0.0	0.0	2	2	0
fam9216	2	2	2	2.0	0.0	0.0	2	2	0
fam9217	2	2	2	2.0	0.0	0.0	2	2	0
fam9218	2	2	2	2.0	0.0	0.0	2	2	0
fam9219	2	2	2	2.0	0.0	0.0	2	2	0
fam9220	2	2	2	2.0	0.0	0.0	2	2	0
fam9221	2	2	2	2.0	0.0	0.0	2	2	0
fam9222	2	2	2	2.0	0.0	0.0	2	2	0
fam9223	2	2	2	2.0	0.0	0.0	2	2	0
fam9224	2	2	2	2.0	0.0	0.0	2	2	0
fam9225	2	2	2	2.0	0.0	0.0	2	2	0
fam9226	2	2	2	2.0	0.0	0.0	2	2	0
fam9227	2	2	2	2.0	0.0	0.0	2	2	0
fam9228	2	2	2	2.0	0.0	0.0	2	2	0
fam9229	2	2	2	2.0	0.0	0.0	2	2	0
fam9230	2	2	2	2.0	0.0	0.0	2	2	0
fam9231	2	2	2	2.0	0.0	0.0	2	2	0
fam9232	2	2	2	2.0	0.0	0.0	2	2	0
fam9233	2	2	2	2.0	0.0	0.0	2	2	0
fam9234	2	2	2	2.0	0.0	0.0	2	2	0
fam9235	2	2	2	2.0	0.0	0.0	2	2	0
fam9236	2	2	2	2.0	0.0	0.0	2	2	0
fam9237	2	2	2	2.0	0.0	0.0	2	2	0
fam9238	2	2	2	2.0	0.0	0.0	2	2	0
fam9239	2	2	2	2.0	0.0	0.0	2	2	0
fam9240	2	2	2	2.0	0.0	0.0	2	2	0
fam9241	2	2	2	2.0	0.0	0.0	2	2	0
fam9242	2	2	2	2.0	0.0	0.0	2	2	0
fam9243	2	2	2	2.0	0.0	0.0	2	2	0
fam9244	2	2	2	2.0	0.0	0.0	2	2	0
fam9245	2	2	2	2.0	0.0	0.0	2	2	0
fam9246	2	2	2	2.0	0.0	0.0	2	2	0
fam9247	2	2	2	2.0	0.0	0.0	2	2	0
fam9248	2	2	2	2.0	0.0	0.0	2	2	0
fam9249	2	2	2	2.0	0.0	0.0	2	2	0
fam9250	2	2	2	2.0	0.0	0.0	2	2	0
fam9251	2	2	2	2.0	0.0	0.0	2	2	0
fam9252	2	2	2	2.0	0.0	0.0	2	2	0
fam9253	2	2	2	2.0	0.0	0.0	2	2	0
fam9254	2	2	2	2.0	0.0	0.0	2	2	0
fam9255	2	2	2	2.0	0.0	0.0	2	2	0
fam9256	2	2	2	2.0	0.0	0.0	2	2	0
fam9257	2	2	2	2.0	0.0	0.0	2	2	0
fam9258	2	2	2	2.0	0.0	0.0	2	2	0
fam9259	2	2	2	2.0	0.0	0.0	2	2	0
fam9260	2	2	2	2.0	0.0	0.0	2	2	0
fam9261	2	2	2	2.0	0.0	0.0	2	2	0
fam9262	2	2	2	2.0	0.0	0.0	2	2	0
fam9263	2	2	2	2.0	0.0	0.0	2	2	0
fam9264	2	2	2	2.0	0.0	0.0	2	2	0
fam9265	2	2	2	2.0	0.0	0.0	2	2	0
fam9266	2	2	2	2.0	0.0	0.0	2	2	0
fam9267	2	2	2	2.0	0.0	0.0	2	2	0
fam9268	2	2	2	2.0	0.0	0.0	2	2	0
fam9269	2	2	2	2.0	0.0	0.0	2	2	0
fam9270	2	2	2	2.0	0.0	0.0	2	2	0
fam9271	2	2	2	2.0	0.0	0.0	2	2	0
fam9272	2	2	2	2.0	0.0	0.0	2	2	0
fam9273	2	2	2	2.0	0.0	0.0	2	2	0
fam9274	2	2	2	2.0	0.0	0.0	2	2	0
fam9275	2	2	2	2.0	0.0	0.0	2	2	0
fam9276	2	2	2	2.0	0.0	0.0	2	2	0
fam9277	2	2	2	2.0	0.0	0.0	2	2	0
fam9278	2	2	2	2.0	0.0	0.0	2	2	0
fam9279	2	2	2	2.0	0.0	0.0	2	2	0
fam9280	2	2	2	2.0	0.0	0.0	2	2	0
fam9281	2	2	2	2.0	0.0	0.0	2	2	0
fam9282	2	2	2	2.0	0.0	0.0	2	2	0
fam9283	2	2	2	2.0	0.0	0.0	2	2	0
fam9284	2	2	2	2.0	0.0	0.0	2	2	0
fam9285	2	2	2	2.0	0.0	0.0	2	2	0
fam9286	2	2	2	2.0	0.0	0.0	2	2	0
fam9287	2	2	2	2.0	0.0	0.0	2	2	0
fam9288	2	2	2	2.0	0.0	0.0	2	2	0
fam9289	2	2	2	2.0	0.0	0.0	2	2	0
fam9290	2	2	2	2.0	0.0	0.0	2	2	0
fam9291	2	2	2	2.0	0.0	0.0	2	2	0
fam9292	2	2	2	2.0	0.0	0.0	2	2	0
fam9293	2	2	2	2.0	0.0	0.0	2	2	0
fam9294	2	2	2	2.0	0.0	0.0	2	2	0
fam9295	2	2	2	2.0	0.0	0.0	2	2	0
fam9296	2	2	2	2.0	0.0	0.0	2	2	0
fam9297	2	2	2	2.0	0.0	0.0	2	2	0
fam9298	2	2	2	2.0	0.0	0.0	2	2	0
fam9299	2	2	2	2.0	0.0	0.0	2	2	0
fam9300	2	2	2	2.0	0.0	0.0	2	2	0
fam9301	2	2	2	2.0	0.0	0.0	2	2	0
fam9302	2	2	2	2.0	0.0	0.0	2	2	0
fam9303	2	2	2	2.0	0.0	0.0	2	2	0
fam9304	2	2	2	2.0	0.0	0.0	2	2	0
fam9305	2	2	2	2.0	0.0	0.0	2	2	0
fam9306	2	2	2	2.0	0.0	0.0	2	2	0
fam9307	2	2	2	2.0	0.0	0.0	2	2	0
fam9308	2	2	2	2.0	0.0	0.0	2	2	0
fam9309	2	2	2	2.0	0.0	0.0	2	2	0
fam9310	2	2	2	2.0	0.0	0.0	2	2	0
fam9311	2	2	2	2.0	0.0	0.0	2	2	0
fam9312	2	2	2	2.0	0.0	0.0	2	2	0
fam9313	2	2	2	2.0	0.0	0.0	2	2	0
fam9314	2	2	2	2.0	0.0	0.0	2	2	0
fam9315	2	2	2	2.0	0.0	0.0	2	2	0
fam9316	2	2	2	2.0	0.0	0.0	2	2	0
fam9317	2	2	2	2.0	0.0	0.0	2	2	0
fam9318	2	2	2	2.0	0.0	0.0	2	2	0
fam9319	2	2	2	2.0	0.0	0.0	2	2	0
fam9320	2	2	2	2.0	0.0	0.0	2	2	0
fam9321	2	2	2	2.0	0.0	0.0	2	2	0
fam9322	2	2	2	2.0	0.0	0.0	2	2	0
fam9323	2	2	2	2.0	0.0	0.0	2	2	0
fam9324	2	2	2	2.0	0.0	0.0	2	2	0
fam9325	2	2	2	2.0	0.0	0.0	2	2	0
fam9326	2	2	2	2.0	0.0	0.0	2	2	0
fam9327	2	2	2	2.0	0.0	0.0	2	2	0
fam9328	2	2	2	2.0	0.0	0.0	2	2	0
fam9329	2	2	2	2.0	0.0	0.0	2	2	0
fam9330	2	2	2	2.0	0.0	0.0	2	2	0
fam9331	2	2	2	2.0	0.0	0.0	2	2	0
fam9332	2	2	2	2.0	0.0	0.0	2	2	0
fam9333	2	2	2	2.0	0.0	0.0	2	2	0
fam9334	2	2	2	2.0	0.0	0.0	2	2	0
fam9335	2	2	2	2.0	0.0	0.0	2	2	0
fam9336	2	2	2	2.0	0.0	0.0	2	2	0
fam9337	2	2	2	2.0	0.0	0.0	2	2	0
fam9338	2	2	2	2.0	0.0	0.0	2	2	0
fam9339	2	2	2	2.0	0.0	0.0	2	2	0
fam9340	2	2	2	2.0	0.0	0.0	2	2	0
fam9341	2	2	2	2.0	0.0	0.0	2	2	0
fam9342	2	2	2	2.0	0.0	0.0	2	2	0
fam9343	2	2	2	2.0	0.0	0.0	2	2	0
fam9344	2	2	2	2.0	0.0	0.0	2	2	0
fam9345	2	2	2	2.0	0.0	0.0	2	2	0
fam9346	2	2	2	2.0	0.0	0.0	2	2	0
fam9347	2	2	2	2.0	0.0	0.0	2	2	0
fam9348	2	2	2	2.0	0.0	0.0	2	2	0
fam9349	2	2	2	2.0	0.0	0.0	2	2	0
fam9350	2	2	2	2.0	0.0	0.0	2	2	0
fam9351	2	2	2	2.0	0.0	0.0	2	2	0
fam9352	2	2	2	2.0	0.0	0.0	2	2	0
fam9353	2	2	2	2.0	0.0	0.0	2	2	0
fam9354	2	2	2	2.0	0.0	0.0	2	2	0
fam9355	2	2	2	2.0	0.0	0.0	2	2	0
fam9356	2	2	2	2.0	0.0	0.0	2	2	0
fam9357	2	2	2	2.0	0.0	0.0	2	2	0
fam9358	2	2	2	2.0	0.0	0.0	2	2	0
fam9359	2	2	2	2.0	0.0	0.0	2	2	0
fam9360	2	2	2	2.0	0.0	0.0	2	2	0
fam9361	2	2	2	2.0	0.0	0.0	2	2	0
fam9362	2	2	2	2.0	0.0	0.0	2	2	0
fam9363	2	2	2	2.0	0.0	0.0	2	2	0
fam9364	2	2	2	2.0	0.0	0.0	2	2	0
fam9365	2	2	2	2.0	0.0	0.0	2	2	0
fam9366	2	2	2	2.0	0.0	0.0	2	2	0
fam9367	2	2	2	2.0	0.0	0.0	2	2	0
fam9368	2	2	2	2.0	0.0	0.0	2	2	0
fam9369	2	2	2	2.0	0.0	0.0	2	2	0
fam9370	2	2	2	2.0	0.0	0.0	2	2	0
fam9371	2	2	2	2.0	0.0	0.0	2	2	0
fam9372	2	2	2	2.0	0.0	0.0	2	2	0
fam9373	2	2	2	2.0	0.0	0.0	2	2	0
fam9374	2	2	2	2.0	0.0	0.0	2	2	0
fam9375	2	2	2	2.0	0.0	0.0	2	2	0
fam9376	2	2	2	2.0	0.0	0.0	2	2	0
fam9377	2	2	2	2.0	0.0	0.0	2	2	0
fam9378	2	2	2	2.0	0.0	0.0	2	2	0
fam9379	2	2	2	2.0	0.0	0.0	2	2	0
fam9380	2	2	2	2.0	0.0	0.0	2	2	0
fam9381	2	2	2	2.0	0.0	0.0	2	2	0
fam9382	2	2	2	2.0	0.0	0.0	2	2	0
fam9383	2	2	2	2.0	0.0	0.0	2	2	0
fam9384	2	2	2	2.0	0.0	0.0	2	2	0
fam9385	2	2	2	2.0	0.0	0.0	2	2	0
fam9386	2	2	2	2.0	0.0	0.0	2	2	0
fam9387	2	2	2	2.0	0.0	0.0	2	2	0
fam9388	2	2	2	2.0	0.0	0.0	2	2	0
fam9389	2	2	2	2.0	0.0	0.0	2	2	0
fam9390	2	2	2	2.0	0.0	0.0	2	2	0
fam9391	2	2	2	2.0	0.0	0.0	2	2	0
fam9392	2	2	2	2.0	0.0	0.0	2	2	0
fam9393	2	2	2	2.0	0.0	0.0	2	2	0
fam9394	2	2	2	2.0	0.0	0.0	2	2	0
fam9395	2	2	2	2.0	0.0	0.0	2	2	0
fam9396	2	2	2	2.0	0.0	0.0	2	2	0
fam9397	2	2	2	2.0	0.0	0.0	2	2	0
fam9398	2	2	2	2.0	0.0	0.0	2	2	0
fam9399	2	2	2	2.0	0.0	0.0	2	2	0
fam9400	2	2	2	2.0	0.0	0.0	2	2	0
fam9401	2	2	2	2.0	0.0	0.0	2	2	0
fam9402	2	2	2	2.0	0.0	0.0	2	2	0
fam9403	2	2	2	2.0	0.0	0.0	2	2	0
fam9404	2	2	2	2.0	0.0	0.0	2	2	0
fam9405	2	2	2	2.0	0.0	0.0	2	2	0
fam9406	2	2	2	2.0	0.0	0.0	2	2	0
fam9407	2	2	2	2.0	0.0	0.0	2	2	0
fam9408	2	2	2	2.0	0.0	0.0	2	2	0
fam9409	2	2	2	2.0	0.0	0.0	2	2	0
fam9410	2	2	2	2.0	0.0	0.0	2	2	0
fam9411	2	2	2	2.0	0.0	0.0	2	2	0
fam9412	2	2	2	2.0	0.0	0.0	2	2	0
fam9413	2	2	2	2.0	0.0	0.0	2	2	0
fam9414	2	2	2	2.0	0.0	0.0	2	2	0
fam9415	2	2	2	2.0	0.0	0.0	2	2	0
fam9416	2	2	2	2.0	0.0	0.0	2	2	0
fam9417	2	2	2	2.0	0.0	0.0	2	2	0
fam9418	2	2	2	2.0	0.0	0.0	2	2	0
fam9419	2	2	2	2.0	0.0	0.0	2	2	0
fam9420	2	2	2	2.0	0.0	0.0	2	2	0
fam9421	2	2	2	2.0	0.0	0.0	2	2	0
fam9422	2	2	2	2.0	0.0	0.0	2	2	0
fam9423	2	2	2	2.0	0.0	0.0	2	2	0
fam9424	2	2	2	2.0	0.0	0.0	2	2	0
fam9425	2	2	2	2.0	0.0	0.0	2	2	0
fam9426	2	2	2	2.0	0.0	0.0	2	2	0
fam9427	2	2	2	2.0	0.0	0.0	2	2	0
fam9428	2	2	2	2.0	0.0	0.0	2	2	0
fam9429	2	2	2	2.0	0.0	0.0	2	2	0
fam9430	2	2	2	2.0	0.0	0.0	2	2	0
fam9431	2	2	2	2.0	0.0	0.0	2	2	0
fam9432	2	2	2	2.0	0.0	0.0	2	2	0
fam9433	2	2	2	2.0	0.0	0.0	2	2	0
fam9434	2	2	2	2.0	0.0	0.0	2	2	0
fam9435	2	2	2	2.0	0.0	0.0	2	2	0
fam9436	2	2	2	2.0	0.0	0.0	2	2	0
fam9437	2	2	2	2.0	0.0	0.0	2	2	0
fam9438	2	2	2	2.0	0.0	0.0	2	2	0
fam9439	2	2	2	2.0	0.0	0.0	2	2	0
fam9440	2	2	2	2.0	0.0	0.0	2	2	0
fam9441	2	2	2	2.0	0.0	0.0	2	2	0
fam9442	2	2	2	2.0	0.0	0.0	2	2	0
fam9443	2	2	2	2.0	0.0	0.0	2	2	0
fam9444	2	2	2	2.0	0.0	0.0	2	2	0
fam9445	2	2	2	2.0	0.0	0.0	2	2	0
fam9446	2	2	2	2.0	0.0	0.0	2	2	0
fam9447	2	2	2	2.0	0.0	0.0	2	2	0
fam9448	2	2	2	2.0	0.0	0.0	2	2	0
fam9449	2	2	2	2.0	0.0	0.0	2	2	0
fam9450	2	2	2	2.0	0.0	0.0	2	2	0
fam9451	2	2	2	2.0	0.0	0.0	2	2	0
fam9452	2	2	2	2.0	0.0	0.0	2	2	0
fam9453	2	2	2	2.0	0.0	0.0	2	2	0
fam9454	2	2	2	2.0	0.0	0.0	2	2	0
fam9455	2	2	2	2.0	0.0	0.0	2	2	0
fam9456	2	2	2	2.0	0.0	0.0	2	2	0
fam9457	2	2	2	2.0	0.0	0.0	2	2	0
fam9458	2	2	2	2.0	0.0	0.0	2	2	0
fam9459	2	2	2	2.0	0.0	0.0	2	2	0
fam9460	2	2	2	2.0	0.0	0.0	2	2	0
fam9461	2	2	2	2.0	0.0	0.0	2	2	0
fam9462	2	2	2	2.0	0.0	0.0	2	2	0
fam9463	2	2	2	2.0	0.0	0.0	2	2	0
fam9464	2	2	2	2.0	0.0	0.0	2	2	0
fam9465	2	2	2	2.0	0.0	0.0	2	2	0
fam9466	2	2	2	2.0	0.0	0.0	2	2	0
fam9467	2	2	2	2.0	0.0	0.0	2	2	0
fam9468	2	2	2	2.0	0.0	0.0	2	2	0
fam9469	2	2	2	2.0	0.0	0.0	2	2	0
fam9470	2	2	2	2.0	0.0	0.0	2	2	0
fam9471	2	2	2	2.0	0.0	0.0	2	2	0
fam9472	2	2	2	2.0	0.0	0.0	2	2	0
fam9473	2	2	2	2.0	0.0	0.0	2	2	0
fam9474	2	2	2	2.0	0.0	0.0	2	2	0
fam9475	2	2	2	2.0	0.0	0.0	2	2	0
fam9476	2	2	2	2.0	0.0	0.0	2	2	0
fam9477	2	2	2	2.0	0.0	0.0	2	2	0
fam9478	2	2	2	2.0	0.0	0.0	2	2	0
fam9479	2	2	2	2.0	0.0	0.0	2	2	0
fam9480	2	2	2	2.0	0.0	0.0	2	2	0
fam9481	2	2	2	2.0	0.0	0.0	2	2	0
fam9482	2	2	2	2.0	0.0	0.0	2	2	0
fam9483	2	2	2	2.0	0.0	0.0	2	2	0
fam9484	2	2	2	2.0	0.0	0.0	2	2	0
fam9485	2	2	2	2.0	0.0	0.0	2	2	0
fam9486	2	2	2	2.0	0.0	0.0	2	2	0
fam9487	2	2	2	2.0	0.0	0.0	2	2	0
fam9488	2	2	2	2.0	0.0	0.0	2	2	0
fam9489	2	2	2	2.0	0.0	0.0	2	2	0
fam9490	2	2	2	2.0	0.0	0.0	2	2	0
fam9491	2	2	2	2.0	0.0	0.0	2	2	0
fam9492	2	2	2	2.0	0.0	0.0	2	2	0
fam9493	2	2	2	2.0	0.0	0.0	2	2	0
fam9494	2	2	2	2.0	0.0	0.0	2	2	0
fam9495	2	2	2	2.0	0.0	0.0	2	2	0
fam9496	2	2	2	2.0	0.0	0.0	2	2	0
fam9497	2	2	2	2.0	0.0	0.0	2	2	0
fam9498	2	2	2	2.0	0.0	0.0	2	2	0
fam9499	2	2	2	2.0	0.0	0.0	2	2	0
fam9500	2	2	2	2.0	0.0	0.0	2	2	0
fam9501	2	2	2	2.0	0.0	0.0	2	2	0
fam9502	2	2	2	2.0	0.0	0.0	2	2	0
fam9503	2	2	2	2.0	0.0	0.0	2	2	0
fam9504	2	2	2	2.0	0.0	0.0	2	2	0
fam9505	2	2	2	2.0	0.0	0.0	2	2	0
fam9506	2	2	2	2.0	0.0	0.0	2	2	0
fam9507	2	2	2	2.0	0.0	0.0	2	2	0
fam9508	2	2	2	2.0	0.0	0.0	2	2	0
fam9509	2	2	2	2.0	0.0	0.0	2	2	0
fam9510	2	2	2	2.0	0.0	0.0	2	2	0
fam9511	2	2	2	2.0	0.0	0.0	2	2	0
fam9512	2	2	2	2.0	0.0	0.0	2	2	0
fam9513	2	2	2	2.0	0.0	0.0	2	2	0
fam9514	2	2	2	2.0	0.0	0.0	2	2	0
fam9515	2	2	2	2.0	0.0	0.0	2	2	0
fam9516	2	2	2	2.0	0.0	0.0	2	2	0
fam9517	2	2	2	2.0	0.0	0.0	2	2	0
fam9518	2	2	2	2.0	0.0	0.0	2	2	0
fam9519	2	2	2	2.0	0.0	0.0	2	2	0
fam9520	2	2	2	2.0	0.0	0.0	2	2	0
fam9521	2	2	2	2.0	0.0	0.0	2	2	0
fam9522	2	2	2	2.0	0.0	0.0	2	2	0
fam9523	2	2	2	2.0	0.0	0.0	2	2	0
fam9524	2	2	2	2.0	0.0	0.0	2	2	0
fam9525	2	2	2	2.0	0.0	0.0	2	2	0
fam9526	2	2	2	2.0	0.0	0.0	2	2	0
fam9527	2	2	2	2.0	0.0	0.0	2	2	0
fam9528	2	2	2	2.0	0.0	0.0	2	2	0
fam9529	2	2	2	2.0	0.0	0.0	2	2	0
fam9530	2	2	2	2.0	0.0	0.0	2	2	0
fam9531	2	2	2	2.0	0.0	0.0	2	2	0
fam9532	2	2	2	2.0	0.0	0.0	2	2	0
fam9533	2	2	2	2.0	0.0	0.0	2	2	0
fam9534	2	2	2	2.0	0.0	0.0	2	2	0
fam9535	2	2	2	2.0	0.0	0.0	2	2	0
fam9536	2	2	2	2.0	0.0	0.0	2	2	0
fam9537	2	2	2	2.0	0.0	0.0	2	2	0
fam9538	2	2	2	2.0	0.0	0.0	2	2	0
fam9539	2	2	2	2.0	0.0	0.0	2	2	0
fam9540	2	2	2	2.0	0.0	0.0	2	2	0
fam9541	2	2	2	2.0	0.0	0.0	2	2	0
fam9542	2	2	2	2.0	0.0	0.0	2	2	0
fam9543	2	2	2	2.0	0.0	0.0	2	2	0
fam9544	2	2	2	2.0	0.0	0.0	2	2	0
fam9545	2	2	2	2.0	0.0	0.0	2	2	0
fam9546	2	2	2	2.0	0.0	0.0	2	2	0
fam9547	2	2	2	2.0	0.0	0.0	2	2	0
fam9548	2	2	2	2.0	0.0	0.0	2	2	0
fam9549	2	2	2	2.0	0.0	0.0	2	2	0
fam9550	2	2	2	2.0	0.0	0.0	2	2	0
fam9551	2	2	2	2.0	0.0	0.0	2	2	0
fam9552	2	2	2	2.0	0.0	0.0	2	2	0
fam9553	2	2	2	2.0	0.0	0.0	2	2	0
fam9554	2	2	2	2.0	0.0	0.0	2	2	0
fam9555	2	2	2	2.0	0.0	0.0	2	2	0
fam9556	2	2	2	2.0	0.0	0.0	2	2	0
fam9557	2	2	2	2.0	0.0	0.0	2	2	0
fam9558	2	2	2	2.0	0.0	0.0	2	2	0
fam9559	2	2	2	2.0	0.0	0.0	2	2	0
fam9560	2	2	2	2.0	0.0	0.0	2	2	0
fam9561	2	2	2	2.0	0.0	0.0	2	2	0
fam9562	2	2	2	2.0	0.0	0.0	2	2	0
fam9563	2	2	2	2.0	0.0	0.0	2	2	0
fam9564	2	2	2	2.0	0.0	0.0	2	2	0
fam9565	2	2	2	2.0	0.0	0.0	2	2	0
fam9566	2	2	2	2.0	0.0	0.0	2	2	0
fam9567	2	2	2	2.0	0.0	0.0	2	2	0
fam9568	2	2	2	2.0	0.0	0.0	2	2	0
fam9569	2	2	2	2.0	0.0	0.0	2	2	0
fam9570	2	2	2	2.0	0.0	0.0	2	2	0
fam9571	2	2	2	2.0	0.0	0.0	2	2	0
fam9572	2	2	2	2.0	0.0	0.0	2	2	0
fam9573	2	2	2	2.0	0.0	0.0	2	2	0
fam9574	2	2	2	2.0	0.0	0.0	2	2	0
fam9575	2	2	2	2.0	0.0	0.0	2	2	0
fam9576	2	2	2	2.0	0.0	0.0	2	2	0
fam9577	2	2	2	2.0	0.0	0.0	2	2	0
fam9578	2	2	2	2.0	0.0	0.0	2	2	0
fam9579	2	2	2	2.0	0.0	0.0	2	2	0
fam9580	2	2	2	2.0	0.0	0.0	2	2	0
fam9581	2	2	2	2.0	0.0	0.0	2	2	0
fam9582	2	2	2	2.0	0.0	0.0	2	2	0
fam9583	2	2	2	2.0	0.0	0.0	2	2	0
fam9584	2	2	2	2.0	0.0	0.0	2	2	0
fam9585	2	2	2	2.0	0.0	0.0	2	2	0
fam9586	2	2	2	2.0	0.0	0.0	2	2	0
fam9587	2	2	2	2.0	0.0	0.0	2	2	0
fam9588	2	2	2	2.0	0.0	0.0	2	2	0
fam9589	2	2	2	2.0	0.0	0.0	2	2	0
fam9590	2	2	2	2.0	0.0	0.0	2	2	0
fam9591	2	2	2	2.0	0.0	0.0	2	2	0
fam9592	2	2	2	2.0	0.0	0.0	2	2	0
fam9593	2	2	2	2.0	0.0	0.0	2	2	0
fam9594	2	2	2	2.0	0.0	0.0	2	2	0
fam9595	2	2	2	2.0	0.0	0.0	2	2	0
fam9596	2	2	2	2.0	0.0	0.0	2	2	0
fam9597	2	2	2	2.0	0.0	0.0	2	2	0
fam9598	2	2	2	2.0	0.0	0.0	2	2	0
fam9599	2	2	2	2.0	0.0	0.0	2	2	0
fam9600	2	2	2	2.0	0.0	0.0	2	2	0
fam9601	2	2	2	2.0	0.0	0.0	2	2	0
fam9602	2	2	2	2.0	0.0	0.0	2	2	0
fam9603	2	2	2	2.0	0.0	0.0	2	2	0
fam9604	2	2	2	2.0	0.0	0.0	2	2	0
fam9605	2	2	2	2.0	0.0	0.0	2	2	0
fam9606	2	2	2	2.0	0.0	0.0	2	2	0
fam9607	2	2	2	2.0	0.0	0.0	2	2	0
fam9608	2	2	2	2.0	0.0	0.0	2	2	0
fam9609	2	2	2	2.0	0.0	0.0	2	2	0
fam9610	2	2	2	2.0	0.0	0.0	2	2	0
fam9611	2	2	2	2.0	0.0	0.0	2	2	0
fam9612	2	2	2	2.0	0.0	0.0	2	2	0
fam9613	2	2	2	2.0	0.0	0.0	2	2	0
fam9614	2	2	2	2.0	0.0	0.0	2	2	0
fam9615	2	2	2	2.0	0.0	0.0	2	2	0
fam9616	2	2	2	2.0	0.0	0.0	2	2	0
fam9617	2	2	2	2.0	0.0	0.0	2	2	0
fam9618	2	2	2	2.0	0.0	0.0	2	2	0
fam9619	2	2	2	2.0	0.0	0.0	2	2	0
fam9620	2	2	2	2.0	0.0	0.0	2	2	0
fam9621	2	2	2	2.0	0.0	0.0	2	2	0
fam9622	2	2	2	2.0	0.0	0.0	2	2	0
fam9623	2	2	2	2.0	0.0	0.0	2	2	0
fam9624	2	2	2	2.0	0.0	0.0	2	2	0
fam9625	2	2	2	2.0	0.0	0.0	2	2	0
fam9626	2	2	2	2.0	0.0	0.0	2	2	0
fam9627	2	2	2	2.0	0.0	0.0	2	2	0
fam9628	2	2	2	2.0	0.0	0.0	2	2	0
fam9629	2	2	2	2.0	0.0	0.0	2	2	0
fam9630	2	2	2	2.0	0.0	0.0	2	2	0
fam9631	2	2	2	2.0	0.0	0.0	2	2	0
fam9632	2	2	2	2.0	0.0	0.0	2	2	0
fam9633	2	2	2	2.0	0.0	0.0	2	2	0
fam9634	2	2	2	2.0	0.0	0.0	2	2	0
fam9635	2	2	2	2.0	0.0	0.0	2	2	0
fam9636	2	2	2	2.0	0.0	0.0	2	2	0
fam9637	2	2	2	2.0	0.0	0.0	2	2	0
fam9638	2	2	2	2.0	0.0	0.0	2	2	0
fam9639	2	2	2	2.0	0.0	0.0	2	2	0
fam9640	2	2	2	2.0	0.0	0.0	2	2	0
fam9641	2	2	2	2.0	0.0	0.0	2	2	0
fam9642	2	2	2	2.0	0.0	0.0	2	2	0
fam9643	2	2	2	2.0	0.0	0.0	2	2	0
fam9644	2	2	2	2.0	0.0	0.0	2	2	0
fam9645	2	2	2	2.0	0.0	0.0	2	2	0
fam9646	2	2	2	2.0	0.0	0.0	2	2	0
fam9647	2	2	2	2.0	0.0	0.0	2	2	0
fam9648	2	2	2	2.0	0.0	0.0	2	2	0
fam9649	2	2	2	2.0	0.0	0.0	2	2	0
fam9650	2	2	2	2.0	0.0	0.0	2	2	0
fam9651	2	2	2	2.0	0.0	0.0	2	2	0
fam9652	2	2	2	2.0	0.0	0.0	2	2	0
fam9653	2	2	2	2.0	0.0	0.0	2	2	0
fam9654	2	2	2	2.0	0.0	0.0	2	2	0
fam9655	2	2	2	2.0	0.0	0.0	2	2	0
fam9656	2	2	2	2.0	0.0	0.0	2	2	0
fam9657	2	2	2	2.0	0.0	0.0	2	2	0
fam9658	2	2	2	2.0	0.0	0.0	2	2	0
fam9659	2	2	2	2.0	0.0	0.0	2	2	0
fam9660	2	2	2	2.0	0.0	0.0	2	2	0
fam9661	2	2	2	2.0	0.0	0.0	2	2	0
fam9662	2	2	2	2.0	0.0	0.0	2	2	0
fam9663	2	2	2	2.0	0.0	0.0	2	2	0
fam9664	2	2	2	2.0	0.0	0.0	2	2	0
fam9665	2	2	2	2.0	0.0	0.0	2	2	0
fam9666	2	2	2	2.0	0.0	0.0	2	2	0
fam9667	2	2	2	2.0	0.0	0.0	2	2	0
fam9668	2	2	2	2.0	0.0	0.0	2	2	0
fam9669	2	2	2	2.0	0.0	0.0	2	2	0
fam9670	2	2	2	2.0	0.0	0.0	2	2	0
fam9671	2	2	2	2.0	0.0	0.0	2	2	0
fam9672	2	2	2	2.0	0.0	0.0	2	2	0
fam9673	2	2	2	2.0	0.0	0.0	2	2	0
fam9674	2	2	2	2.0	0.0	0.0	2	2	0
fam9675	2	2	2	2.0	0.0	0.0	2	2	0
fam9676	2	2	2	2.0	0.0	0.0	2	2	0
fam9677	2	2	2	2.0	0.0	0.0	2	2	0
fam9678	2	2	2	2.0	0.0	0.0	2	2	0
fam9679	2	2	2	2.0	0.0	0.0	2	2	0
fam9680	2	2	2	2.0	0.0	0.0	2	2	0
fam9681	2	2	2	2.0	0.0	0.0	2	2	0
fam9682	2	2	2	2.0	0.0	0.0	2	2	0
fam9683	2	2	2	2.0	0.0	0.0	2	2	0
fam9684	2	2	2	2.0	0.0	0.0	2	2	0
fam9685	2	2	2	2.0	0.0	0.0	2	2	0
fam9686	2	2	2	2.0	0.0	0.0	2	2	0
fam9687	2	2	2	2.0	0.0	0.0	2	2	0
fam9688	2	2	2	2.0	0.0	0.0	2	2	0
fam9689	2	2	2	2.0	0.0	0.0	2	2	0
fam9690	2	2	2	2.0	0.0	0.0	2	2	0
fam9691	2	2	2	2.0	0.0	0.0	2	2	0
fam9692	2	2	2	2.0	0.0	0.0	2	2	0
fam9693	2	2	2	2.0	0.0	0.0	2	2	0
fam9694	2	2	2	2.0	0.0	0.0	2	2	0
fam9695	2	2	2	2.0	0.0	0.0	2	2	0
fam9696	2	2	2	2.0	0.0	0.0	2	2	0
fam9697	2	2	2	2.0	0.0	0.0	2	2	0
fam9698	2	2	2	2.0	0.0	0.0	2	2	0
fam9699	2	2	2	2.0	0.0	0.0	2	2	0
fam9700	2	2	2	2.0	0.0	0.0	2	2	0
fam9701	2	2	2	2.0	0.0	0.0	2	2	0
fam9702	2	2	2	2.0	0.0	0.0	2	2	0
fam9703	2	2	2	2.0	0.0	0.0	2	2	0
fam9704	2	2	2	2.0	0.0	0.0	2	2	0
fam9705	2	2	2	2.0	0.0	0.0	2	2	0
fam9706	2	2	2	2.0	0.0	0.0	2	2	0
fam9707	2	2	2	2.0	0.0	0.0	2	2	0
fam9708	2	2	2	2.0	0.0	0.0	2	2	0
fam9709	2	2	2	2.0	0.0	0.0	2	2	0
fam9710	2	2	2	2.0	0.0	0.0	2	2	0
fam9711	2	2	2	2.0	0.0	0.0	2	2	0
fam9712	2	2	2	2.0	0.0	0.0	2	2	0
fam9713	2	2	2	2.0	0.0	0.0	2	2	0
fam9714	2	2	2	2.0	0.0	0.0	2	2	0
fam9715	2	2	2	2.0	0.0	0.0	2	2	0
fam9716	2	2	2	2.0	0.0	0.0	2	2	0
fam9717	2	2	2	2.0	0.0	0.0	2	2	0
fam9718	2	2	2	2.0	0.0	0.0	2	2	0
fam9719	2	2	2	2.0	0.0	0.0	2	2	0
fam9720	2	2	2	2.0	0.0	0.0	2	2	0
fam9721	2	2	2	2.0	0.0	0.0	2	2	0
fam9722	2	2	2	2.0	0.0	0.0	2	2	0
fam9723	2	2	2	2.0	0.0	0.0	2	2	0
fam9724	2	2	2	2.0	0.0	0.0	2	2	0
fam9725	2	2	2	2.0	0.0	0.0	2	2	0
fam9726	2	2	2	2.0	0.0	0.0	2	2	0
fam9727	2	2	2	2.0	0.0	0.0	2	2	0
fam9728	2	2	2	2.0	0.0	0.0	2	2	0
fam9729	2	2	2	2.0	0.0	0.0	2	2	0
fam9730	2	2	2	2.0	0.0	0.0	2	2	0
fam9731	2	2	2	2.0	0.0	0.0	2	2	0
fam9732	2	2	2	2.0	0.0	0.0	2	2	0
fam9733	2	2	2	2.0	0.0	0.0	2	2	0
fam9734	2	2	2	2.0	0.0	0.0	2	2	0
fam9735	2	2	2	2.0	0.0	0.0	2	2	0
fam9736	2	2	2	2.0	0.0	0.0	2	2	0
fam9737	2	2	2	2.0	0.0	0.0	2	2	0
fam9738	2	2	2	2.0	0.0	0.0	2	2	0
fam9739	2	2	2	2.0	0.0	0.0	2	2	0
fam9740	2	2	2	2.0	0.0	0.0	2	2	0
fam9741	2	2	2	2.0	0.0	0.0	2	2	0
fam9742	2	2	2	2.0	0.0	0.0	2	2	0
fam9743	2	2	2	2.0	0.0	0.0	2	2	0
fam9744	2	2	2	2.0	0.0	0.0	2	2	0
fam9745	2	2	2	2.0	0.0	0.0	2	2	0
fam9746	2	2	2	2.0	0.0	0.0	2	2	0
fam9747	2	2	2	2.0	0.0	0.0	2	2	0
fam9748	2	2	2	2.0	0.0	0.0	2	2	0
fam9749	2	2	2	2.0	0.0	0.0	2	2	0
fam9750	2	2	2	2.0	0.0	0.0	2	2	0
fam9751	2	2	2	2.0	0.0	0.0	2	2	0
fam9752	2	2	2	2.0	0.0	0.0	2	2	0
fam9753	2	2	2	2.0	0.0	0.0	2	2	0
fam9754	2	2	2	2.0	0.0	0.0	2	2	0
fam9755	2	2	2	2.0	0.0	0.0	2	2	0
fam9756	2	2	2	2.0	0.0	0.0	2	2	0
fam9757	2	2	2	2.0	0.0	0.0	2	2	0
fam9758	2	2	2	2.0	0.0	0.0	2	2	0
fam9759	2	2	2	2.0	0.0	0.0	2	2	0
fam9760	2	2	2	2.0	0.0	0.0	2	2	0
fam9761	2	2	2	2.0	0.0	0.0	2	2	0
fam9762	2	2	2	2.0	0.0	0.0	2	2	0
fam9763	2	2	2	2.0	0.0	0.0	2	2	0
fam9764	2	2	2	2.0	0.0	0.0	2	2	0
fam9765	2	2	2	2.0	0.0	0.0	2	2	0
fam9766	2	2	2	2.0	0.0	0.0	2	2	0
fam9767	2	2	2	2.0	0.0	0.0	2	2	0
fam9768	2	2	2	2.0	0.0	0.0	2	2	0
fam9769	2	2	2	2.0	0.0	0.0	2	2	0
fam9770	2	2	2	2.0	0.0	0.0	2	2	0
fam9771	2	2	2	2.0	0.0	0.0	2	2	0
fam9772	2	2	2	2.0	0.0	0.0	2	2	0
fam9773	2	2	2	2.0	0.0	0.0	2	2	0
fam9774	2	2	2	2.0	0.0	0.0	2	2	0
fam9775	2	2	2	2.0	0.0	0.0	2	2	0
fam9776	2	2	2	2.0	0.0	0.0	2	2	0
fam9777	2	2	2	2.0	0.0	0.0	2	2	0
fam9778	2	2	2	2.0	0.0	0.0	2	2	0
fam9779	2	2	2	2.0	0.0	0.0	2	2	0
fam9780	2	2	2	2.0	0.0	0.0	2	2	0
fam9781	2	2	2	2.0	0.0	0.0	2	2	0
fam9782	2	2	2	2.0	0.0	0.0	2	2	0
fam9783	2	2	2	2.0	0.0	0.0	2	2	0
fam9784	2	2	2	2.0	0.0	0.0	2	2	0
fam9785	2	2	2	2.0	0.0	0.0	2	2	0
fam9786	2	2	2	2.0	0.0	0.0	2	2	0
fam9787	2	2	2	2.0	0.0	0.0	2	2	0
fam9788	2	2	2	2.0	0.0	0.0	2	2	0
fam9789	2	2	2	2.0	0.0	0.0	2	2	0
fam9790	2	2	2	2.0	0.0	0.0	2	2	0
fam9791	2	2	2	2.0	0.0	0.0	2	2	0
fam9792	2	2	2	2.0	0.0	0.0	2	2	0
fam9793	2	2	2	2.0	0.0	0.0	2	2	0
fam9794	2	2	2	2.0	0.0	0.0	2	2	0
fam9795	2	2	2	2.0	0.0	0.0	2	2	0
fam9796	2	2	2	2.0	0.0	0.0	2	2	0
fam9797	2	2	2	2.0	0.0	0.0	2	2	0
fam9798	2	2	2	2.0	0.0	0.0	2	2	0
fam9799	2	2	2	2.0	0.0	0.0	2	2	0
fam9800	2	2	2	2.0	0.0	0.0	2	2	0
fam9801	2	2	2	2.0	0.0	0.0	2	2	0
fam9802	2	2	2	2.0	0.0	0.0	2	2	0
fam9803	2	2	2	2.0	0.0	0.0	2	2	0
fam9804	2	2	2	2.0	0.0	0.0	2	2	0
fam9805	2	2	2	2.0	0.0	0.0	2	2	0
fam9806	2	2	2	2.0	0.0	0.0	2	2	0
fam9807	2	2	2	2.0	0.0	0.0	2	2	0
fam9808	2	2	2	2.0	0.0	0.0	2	2	0
fam9809	2	2	2	2.0	0.0	0.0	2	2	0
fam9810	2	2	2	2.0	0.0	0.0	2	2	0
fam9811	2	2	2	2.0	0.0	0.0	2	2	0
fam9812	2	2	2	2.0	0.0	0.0	2	2	0
fam9813	2	2	2	2.0	0.0	0.0	2	2	0
fam9814	2	2	2	2.0	0.0	0.0	2	2	0
fam9815	2	2	2	2.0	0.0	0.0	2	2	0
fam9816	2	2	2	2.0	0.0	0.0	2	2	0
fam9817	2	2	2	2.0	0.0	0.0	2	2	0
fam9818	2	2	2	2.0	0.0	0.0	2	2	0
fam9819	2	2	2	2.0	0.0	0.0	2	2	0
fam9820	2	2	2	2.0	0.0	0.0	2	2	0
fam9821	2	2	2	2.0	0.0	0.0	2	2	0
fam9822	2	2	2	2.0	0.0	0.0	2	2	0
fam9823	2	2	2	2.0	0.0	0.0	2	2	0
fam9824	2	2	2	2.0	0.0	0.0	2	2	0
fam9825	2	2	2	2.0	0.0	0.0	2	2	0
fam9826	2	2	2	2.0	0.0	0.0	2	2	0
fam9827	2	2	2	2.0	0.0	0.0	2	2	0
fam9828	2	2	2	2.0	0.0	0.0	2	2	0
fam9829	2	2	2	2.0	0.0	0.0	2	2	0
fam9830	2	2	2	2.0	0.0	0.0	2	2	0
fam9831	2	2	2	2.0	0.0	0.0	2	2	0
fam9832	2	2	2	2.0	0.0	0.0	2	2	0
fam9833	2	2	2	2.0	0.0	0.0	2	2	0
fam9834	2	2	2	2.0	0.0	0.0	2	2	0
fam9835	2	2	2	2.0	0.0	0.0	2	2	0
fam9836	2	2	2	2.0	0.0	0.0	2	2	0
fam9837	2	2	2	2.0	0.0	0.0	2	2	0
fam9838	2	2	2	2.0	0.0	0.0	2	2	0
fam9839	2	2	2	2.0	0.0	0.0	2	2	0
fam9840	2	2	2	2.0	0.0	0.0	2	2	0
fam9841	2	2	2	2.0	0.0	0.0	2	2	0
fam9842	2	2	2	2.0	0.0	0.0	2	2	0
fam9843	2	2	2	2.0	0.0	0.0	2	2	0
fam9844	2	2	2	2.0	0.0	0.0	2	2	0
fam9845	2	2	2	2.0	0.0	0.0	2	2	0
fam9846	2	2	2	2.0	0.0	0.0	2	2	0
fam9847	2	2	2	2.0	0.0	0.0	2	2	0
fam9848	2	2	2	2.0	0.0	0.0	2	2	0
fam9849	2	2	2	2.0	0.0	0.0	2	2	0
fam9850	2	2	2	2.0	0.0	0.0	2	2	0
fam9851	2	2	2	2.0	0.0	0.0	2	2	0
fam9852	2	2	2	2.0	0.0	0.0	2	2	0
fam9853	2	2	2	2.0	0.0	0.0	2	2	0
fam9854	2	2	2	2.0	0.0	0.0	2	2	0
fam9855	2	2	2	2.0	0.0	0.0	2	2	0
fam9856	2	2	2	2.0	0.0	0.0	2	2	0
fam9857	2	2	2	2.0	0.0	0.0	2	2	0
fam9858	2	2	2	2.0	0.0	0.0	2	2	0
fam9859	2	2	2	2.0	0.0	0.0	2	2	0
fam9860	2	2	2	2.0	0.0	0.0	2	2	0
fam9861	2	2	2	2.0	0.0	0.0	2	2	0
fam9862	2	2	2	2.0	0.0	0.0	2	2	0
fam9863	2	2	2	2.0	0.0	0.0	2	2	0
fam9864	2	2	2	2.0	0.0	0.0	2	2	0
fam9865	2	2	2	2.0	0.0	0.0	2	2	0
fam9866	2	2	2	2.0	0.0	0.0	2	2	0
fam9867	2	2	2	2.0	0.0	0.0	2	2	0
fam9868	2	2	2	2.0	0.0	0.0	2	2	0
fam9869	2	2	2	2.0	0.0	0.0	2	2	0
fam9870	2	2	2	2.0	0.0	0.0	2	2	0
fam9871	2	2	2	2.0	0.0	0.0	2	2	0
fam9872	2	2	2	2.0	0.0	0.0	2	2	0
fam9873	2	2	2	2.0	0.0	0.0	2	2	0
fam9874	2	2	2	2.0	0.0	0.0	2	2	0
fam9875	2	2	2	2.0	0.0	0.0	2	2	0
fam9876	2	2	2	2.0	0.0	0.0	2	2	0
fam9877	2	2	2	2.0	0.0	0.0	2	2	0
fam9878	2	2	2	2.0	0.0	0.0	2	2	0
fam9879	2	2	2	2.0	0.0	0.0	2	2	0
fam9880	2	2	2	2.0	0.0	0.0	2	2	0
fam9881	2	2	2	2.0	0.0	0.0	2	2	0
fam9882	2	2	2	2.0	0.0	0.0	2	2	0
fam9883	2	2	2	2.0	0.0	0.0	2	2	0
fam9884	2	2	2	2.0	0.0	0.0	2	2	0
fam9885	2	2	2	2.0	0.0	0.0	2	2	0
fam9886	2	2	2	2.0	0.0	0.0	2	2	0
fam9887	2	2	2	2.0	0.0	0.0	2	2	0
fam9888	2	2	2	2.0	0.0	0.0	2	2	0
fam9889	2	2	2	2.0	0.0	0.0	2	2	0
fam9890	2	2	2	2.0	0.0	0.0	2	2	0
fam9891	2	2	2	2.0	0.0	0.0	2	2	0
fam9892	2	2	2	2.0	0.0	0.0	2	2	0
fam9893	2	2	2	2.0	0.0	0.0	2	2	0
fam9894	2	2	2	2.0	0.0	0.0	2	2	0
fam9895	2	2	2	2.0	0.0	0.0	2	2	0
fam9896	2	2	2	2.0	0.0	0.0	2	2	0
fam9897	2	2	2	2.0	0.0	0.0	2	2	0
fam9898	2	2	2	2.0	0.0	0.0	2	2	0
fam9899	2	2	2	2.0	0.0	0.0	2	2	0
fam9900	2	2	2	2.0	0.0	0.0	2	2	0
fam9901	2	2	2	2.0	0.0	0.0	2	2	0
fam9902	2	2	2	2.0	0.0	0.0	2	2	0
fam9903	2	2	2	2.0	0.0	0.0	2	2	0
fam9904	2	2	2	2.0	0.0	0.0	2	2	0
fam9905	2	2	2	2.0	0.0	0.0	2	2	0
fam9906	2	2	2	2.0	0.0	0.0	2	2	0
fam9907	2	2	2	2.0	0.0	0.0	2	2	0
fam9908	2	2	2	2.0	0.0	0.0	2	2	0
fam9909	2	2	2	2.0	0.0	0.0	2	2	0
fam9910	2	2	2	2.0	0.0	0.0	2	2	0
fam9911	2	2	2	2.0	0.0	0.0	2	2	0
fam9912	2	2	2	2.0	0.0	0.0	2	2	0
fam9913	2	2	2	2.0	0.0	0.0	2	2	0
fam9914	2	2	2	2.0	0.0	0.0	2	2	0
fam9915	2	2	2	2.0	0.0	0.0	2	2	0
fam9916	2	2	2	2.0	0.0	0.0	2	2	0
fam9917	2	2	2	2.0	0.0	0.0	2	2	0
fam9918	2	2	2	2.0	0.0	0.0	2	2	0
fam9919	2	2	2	2.0	0.0	0.0	2	2	0
fam9920	2	2	2	2.0	0.0	0.0	2	2	0
fam9921	2	2	2	2.0	0.0	0.0	2	2	0
fam9922	2	2	2	2.0	0.0	0.0	2	2	0
fam9923	2	2	2	2.0	0.0	0.0	2	2	0
fam9924	2	2	2	2.0	0.0	0.0	2	2	0
fam9925	2	2	2	2.0	0.0	0.0	2	2	0
fam9926	2	2	2	2.0	0.0	0.0	2	2	0
fam9927	2	2	2	2.0	0.0	0.0	2	2	0
fam9928	2	2	2	2.0	0.0	0.0	2	2	0
fam9929	2	2	2	2.0	0.0	0.0	2	2	0
fam9930	2	2	2	2.0	0.0	0.0	2	2	0
fam9931	2	2	2	2.0	0.0	0.0	2	2	0
fam9932	2	2	2	2.0	0.0	0.0	2	2	0
fam9933	2	2	2	2.0	0.0	0.0	2	2	0
fam9934	2	2	2	2.0	0.0	0.0	2	2	0
fam9935	2	2	2	2.0	0.0	0.0	2	2	0
fam9936	2	2	2	2.0	0.0	0.0	2	2	0
fam9937	2	2	2	2.0	0.0	0.0	2	2	0
fam9938	2	2	2	2.0	0.0	0.0	2	2	0
fam9939	2	2	2	2.0	0.0	0.0	2	2	0
fam9940	2	2	2	2.0	0.0	0.0	2	2	0
fam9941	2	2	2	2.0	0.0	0.0	2	2	0
fam9942	2	2	2	2.0	0.0	0.0	2	2	0
fam9943	2	2	2	2.0	0.0	0.0	2	2	0
fam9944	2	2	2	2.0	0.0	0.0	2	2	0
fam9945	2	2	2	2.0	0.0	0.0	2	2	0
fam9946	2	2	2	2.0	0.0	0.0	2	2	0
fam9947	2	2	2	2.0	0.0	0.0	2	2	0
fam9948	2	2	2	2.0	0.0	0.0	2	2	0
fam9949	2	2	2	2.0	0.0	0.0	2	2	0
fam9950	2	2	2	2.0	0.0	0.0	2	2	0
fam9951	2	2	2	2.0	0.0	0.0	2	2	0
fam9952	2	2	2	2.0	0.0	0.0	2	2	0
fam9953	2	2	2	2.0	0.0	0.0	2	2	0
fam9954	2	2	2	2.0	0.0	0.0	2	2	0
fam9955	2	2	2	2.0	0.0	0.0	2	2	0
fam9956	2	2	2	2.0	0.0	0.0	2	2	0
fam9957	2	2	2	2.0	0.0	0.0	2	2	0
fam9958	2	2	2	2.0	0.0	0.0	2	2	0
fam9959	2	2	2	2.0	0.0	0.0	2	2	0
fam9960	2	2	2	2.0	0.0	0.0	2	2	0
fam9961	2	2	2	2.0	0.0	0.0	2	2	0
fam9962	2	2	2	2.0	0.0	0.0	2	2	0
fam9963	2	2	2	2.0	0.0	0.0	2	2	0
fam9964	2	2	2	2.0	0.0	0.0	2	2	0
fam9965	2	2	2	2.0	0.0	0.0	2	2	0
fam9966	2	2	2	2.0	0.0	0.0	2	2	0
fam9967	2	2	2	2.0	0.0	0.0	2	2	0
fam9968	2	2	2	2.0	0.0	0.0	2	2	0
fam9969	2	2	2	2.0	0.0	0.0	2	2	0
fam9970	2	2	2	2.0	0.0	0.0	2	2	0
fam9971	2	2	2	2.0	0.0	0.0	2	2	0
fam9972	2	2	2	2.0	0.0	0.0	2	2	0
fam9973	2	2	2	2.0	0.0	0.0	2	2	0
fam9974	2	2	2	2.0	0.0	0.0	2	2	0
fam9975	2	2	2	2.0	0.0	0.0	2	2	0
fam9976	2	2	2	2.0	0.0	0.0	2	2	0
fam9977	2	2	2	2.0	0.0	0.0	2	2	0
fam9978	2	2	2	2.0	0.0	0.0	2	2	0
fam9979	2	2	2	2.0	0.0	0.0	2	2	0
fam9980	2	2	2	2.0	0.0	0.0	2	2	0
fam9981	2	2	2	2.0	0.0	0.0	2	2	0
fam9982	2	2	2	2.0	0.0	0.0	2	2	0
fam9983	2	2	2	2.0	0.0	0.0	2	2	0
fam9984	2	2	2	2.0	0.0	0.0	2	2	0
fam9985	2	2	2	2.0	0.0	0.0	2	2	0
fam9986	2	2	2	2.0	0.0	0.0	2	2	0
fam9987	2	2	2	2.0	0.0	0.0	2	2	0
fam9988	2	2	2	2.0	0.0	0.0	2	2	0
fam9989	2	2	2	2.0	0.0	0.0	2	2	0
fam9990	2	2	2	2.0	0.0	0.0	2	2	0
fam9991	2	2	2	2.0	0.0	0.0	2	2	0
fam9992	2	2	2	2.0	0.0	0.0	2	2	0
fam9993	2	2	2	2.0	0.0	0.0	2	2	0
fam9994	2	2	2	2.0	0.0	0.0	2	2	0
fam9995	2	2	2	2.0	0.0	0.0	2	2	0
fam9996	2	2	2	2.0	0.0	0.0	2	2	0
fam9997	2	2	2	2.0	0.0	0.0	2	2	0
fam9998	2	2	2	2.0	0.0	0.0	2	2	0
fam9999	2	2	2	2.0	0.0	0.0	2	2	0
fam10000	2	2	2	2.0	0.0	0.0	2	2	0
fam10001	2	2	2	2.0	0.0	0.0	2	2	0
fam10002	2	2	2	2.0	0.0	0.0	2	2	0
fam10003	2	2	2	2.0	0.0	0.0	2	2	0
fam10004	2	2	2	2.0	0.0	0.0	2	2	0
fam10005	2	2	2	2.0	0.0	0.0	2	2	0
fam10006	2	2	2	2.0	0.0	0.0	2	2	0
fam10007	2	2	2	2.0	0.0	0.0	2	2	0
fam10008	2	2	2	2.0	0.0	0.0	2	2	0
fam10009	2	2	2	2.0	0.0	0.0	2	2	0
fam10010	2	2	2	2.0	0.0	0.0	2	2	0
fam10011	2	2	2	2.0	0.0	0.0	2	2	0
fam10012	2	2	2	2.0	0.0	0.0	2	2	0
fam10013	2	2	2	2.0	0.0	0.0	2	2	0
fam10014	2	2	2	2.0	0.0	0.0	2	2	0
fam10015	2	2	2	2.0	0.0	0.0	2	2	0
fam10016	2	2	2	2.0	0.0	0.0	2	2	0
fam10017	2	2	2	2.0	0.0	0.0	2	2	0
fam10018	2	2	2	2.0	0.0	0.0	2	2	0
fam10019	2	2	2	2.0	0.0	0.0	2	2	0
fam10020	2	2	2	2.0	0.0	0.0	2	2	0
fam10021	2	2	2	2.0	0.0	0.0	2	2	0
fam10022	2	2	2	2.0	0.0	0.0	2	2	0
fam10023	2	2	2	2.0	0.0	0.0	2	2	0
fam10024	2	2	2	2.0	0.0	0.0	2	2	0
fam10025	2	2	2	2.0	0.0	0.0	2	2	0
fam10026	2	2	2	2.0	0.0	0.0	2	2	0
fam10027	2	2	2	2.0	0.0	0.0	2	2	0
fam10028	2	2	2	2.0	0.0	0.0	2	2	0
fam10029	2	2	2	2.0	0.0	0.0	2	2	0
fam10030	2	2	2	2.0	0.0	0.0	2	2	0
fam10031	2	2	2	2.0	0.0	0.0	2	2	0
fam10032	2	2	2	2.0	0.0	0.0	2	2	0
fam10033	2	2	2	2.0	0.0	0.0	2	2	0
fam10034	2	2	2	2.0	0.0	0.0	2	2	0
fam10035	2	2	2	2.0	0.0	0.0	2	2	0
fam10036	2	2	2	2.0	0.0	0.0	2	2	0
fam10037	2	2	2	2.0	0.0	0.0	2	2	0
fam10038	2	2	2	2.0	0.0	0.0	2	2	0
fam10039	2	2	2	2.0	0.0	0.0	2	2	0
fam10040	2	2	2	2.0	0.0	0.0	2	2	0
fam10041	2	2	2	2.0	0.0	0.0	2	2	0
fam10042	2	2	2	2.0	0.0	0.0	2	2	0
fam10043	2	2	2	2.0	0.0	0.0	2	2	0
fam10044	2	2	2	2.0	0.0	0.0	2	2	0
fam10045	2	2	2	2.0	0.0	0.0	2	2	0
fam10046	2	2	2	2.0	0.0	0.0	2	2	0
fam10047	2	2	2	2.0	0.0	0.0	2	2	0
fam10048	2	2	2	2.0	0.0	0.0	2	2	0
fam10049	2	2	2	2.0	0.0	0.0	2	2	0
fam10050	2	2	2	2.0	0.0	0.0	2	2	0
fam10051	2	2	2	2.0	0.0	0.0	2	2	0
fam10052	2	2	2	2.0	0.0	0.0	2	2	0
fam10053	2	2	2	2.0	0.0	0.0	2	2	0
fam10054	2	2	2	2.0	0.0	0.0	2	2	0
fam10055	2	2	2	2.0	0.0	0.0	2	2	0
fam10056	2	2	2	2.0	0.0	0.0	2	2	0
fam10057	2	2	2	2.0	0.0	0.0	2	2	0
fam10058	2	2	2	2.0	0.0	0.0	2	2	0
fam10059	2	2	2	2.0	0.0	0.0	2	2	0
fam10060	2	2	2	2.0	0.0	0.0	2	2	0
fam10061	2	2	2	2.0	0.0	0.0	2	2	0
fam10062	2	2	2	2.0	0.0	0.0	2	2	0
fam10063	2	2	2	2.0	0.0	0.0	2	2	0
fam10064	2	2	2	2.0	0.0	0.0	2	2	0
fam10065	2	2	2	2.0	0.0	0.0	2	2	0
fam10066	2	2	2	2.0	0.0	0.0	2	2	0
fam10067	2	2	2	2.0	0.0	0.0	2	2	0
fam10068	2	2	2	2.0	0.0	0.0	2	2	0
fam10069	2	2	2	2.0	0.0	0.0	2	2	0
fam10070	2	2	2	2.0	0.0	0.0	2	2	0
fam10071	2	2	2	2.0	0.0	0.0	2	2	0
fam10072	2	2	2	2.0	0.0	0.0	2	2	0
fam10073	2	2	2	2.0	0.0	0.0	2	2	0
fam10074	2	2	2	2.0	0.0	0.0	2	2	0
fam10075	2	2	2	2.0	0.0	0.0	2	2	0
fam10076	2	2	2	2.0	0.0	0.0	2	2	0
fam10077	2	2	2	2.0	0.0	0.0	2	2	0
fam10078	2	2	2	2.0	0.0	0.0	2	2	0
fam10079	2	2	2	2.0	0.0	0.0	2	2	0
fam10080	2	2	2	2.0	0.0	0.0	2	2	0
fam10081	2	2	2	2.0	0.0	0.0	2	2	0
fam10082	2	2	2	2.0	0.0	0.0	2	2	0
fam10083	2	2	2	2.0	0.0	0.0	2	2	0
fam10084	2	2	2	2.0	0.0	0.0	2	2	0
fam10085	2	2	2	2.0	0.0	0.0	2	2	0
fam10086	2	2	2	2.0	0.0	0.0	2	2	0
fam10087	2	2	2	2.0	0.0	0.0	2	2	0
fam10088	2	2	2	2.0	0.0	0.0	2	2	0
fam10089	2	2	2	2.0	0.0	0.0	2	2	0
fam10090	2	2	2	2.0	0.0	0.0	2	2	0
fam10091	2	2	2	2.0	0.0	0.0	2	2	0
fam10092	2	2	2	2.0	0.0	0.0	2	2	0
fam10093	2	2	2	2.0	0.0	0.0	2	2	0
fam10094	2	2	2	2.0	0.0	0.0	2	2	0
fam10095	2	2	2	2.0	0.0	0.0	2	2	0
fam10096	2	2	2	2.0	0.0	0.0	2	2	0
fam10097	2	2	2	2.0	0.0	0.0	2	2	0
fam10098	2	2	2	2.0	0.0	0.0	2	2	0
fam10099	2	2	2	2.0	0.0	0.0	2	2	0
fam10100	2	2	2	2.0	0.0	0.0	2	2	0
fam10101	2	2	2	2.0	0.0	0.0	2	2	0
fam10102	2	2	2	2.0	0.0	0.0	2	2	0
fam10103	2	2	2	2.0	0.0	0.0	2	2	0
fam10104	2	2	2	2.0	0.0	0.0	2	2	0
fam10105	2	2	2	2.0	0.0	0.0	2	2	0
fam10106	2	2	2	2.0	0.0	0.0	2	2	0
fam10107	2	2	2	2.0	0.0	0.0	2	2	0
fam10108	2	2	2	2.0	0.0	0.0	2	2	0
fam10109	2	2	2	2.0	0.0	0.0	2	2	0
fam10110	2	2	2	2.0	0.0	0.0	2	2	0
fam10111	2	2	2	2.0	0.0	0.0	2	2	0
fam10112	2	2	2	2.0	0.0	0.0	2	2	0
fam10113	2	2	2	2.0	0.0	0.0	2	2	0
fam10114	2	2	2	2.0	0.0	0.0	2	2	0
fam10115	2	2	2	2.0	0.0	0.0	2	2	0
fam10116	2	2	2	2.0	0.0	0.0	2	2	0
fam10117	2	2	2	2.0	0.0	0.0	2	2	0
fam10118	2	2	2	2.0	0.0	0.0	2	2	0
fam10119	2	2	2	2.0	0.0	0.0	2	2	0
fam10120	2	2	2	2.0	0.0	0.0	2	2	0
fam10121	2	2	2	2.0	0.0	0.0	2	2	0
fam10122	2	2	2	2.0	0.0	0.0	2	2	0
fam10123	2	2	2	2.0	0.0	0.0	2	2	0
fam10124	2	2	2	2.0	0.0	0.0	2	2	0
fam10125	2	2	2	2.0	0.0	0.0	2	2	0
fam10126	2	2	2	2.0	0.0	0.0	2	2	0
fam10127	2	2	2	2.0	0.0	0.0	2	2	0
fam10128	2	2	2	2.0	0.0	0.0	2	2	0
fam10129	2	2	2	2.0	0.0	0.0	2	2	0
fam10130	2	2	2	2.0	0.0	0.0	2	2	0
fam10131	2	2	2	2.0	0.0	0.0	2	2	0
fam10132	2	2	2	2.0	0.0	0.0	2	2	0
fam10133	2	2	2	2.0	0.0	0.0	2	2	0
fam10134	2	2	2	2.0	0.0	0.0	2	2	0
fam10135	2	2	2	2.0	0.0	0.0	2	2	0
fam10136	2	2	2	2.0	0.0	0.0	2	2	0
fam10137	2	2	2	2.0	0.0	0.0	2	2	0
fam10138	2	2	2	2.0	0.0	0.0	2	2	0
fam10139	2	2	2	2.0	0.0	0.0	2	2	0
fam10140	2	2	2	2.0	0.0	0.0	2	2	0
fam10141	2	2	2	2.0	0.0	0.0	2	2	0
fam10142	2	2	2	2.0	0.0	0.0	2	2	0
fam10143	2	2	2	2.0	0.0	0.0	2	2	0
fam10144	2	2	2	2.0	0.0	0.0	2	2	0
fam10145	2	2	2	2.0	0.0	0.0	2	2	0
fam10146	2	2	2	2.0	0.0	0.0	2	2	0
fam10147	2	2	2	2.0	0.0	0.0	2	2	0
fam10148	2	2	2	2.0	0.0	0.0	2	2	0
fam10149	2	2	2	2.0	0.0	0.0	2	2	0
fam10150	2	2	2	2.0	0.0	0.0	2	2	0
fam10151	2	2	2	2.0	0.0	0.0	2	2	0
fam10152	2	2	2	2.0	0.0	0.0	2	2	0
fam10153	2	2	2	2.0	0.0	0.0	2	2	0
fam10154	2	2	2	2.0	0.0	0.0	2	2	0
fam10155	2	2	2	2.0	0.0	0.0	2	2	0
fam10156	2	2	2	2.0	0.0	0.0	2	2	0
fam10157	2	2	2	2.0	0.0	0.0	2	2	0
fam10158	2	2	2	2.0	0.0	0.0	2	2	0
fam10159	2	2	2	2.0	0.0	0.0	2	2	0
fam10160	2	2	2	2.0	0.0	0.0	2	2	0
fam10161	2	2	2	2.0	0.0	0.0	2	2	0
fam10162	2	2	2	2.0	0.0	0.0	2	2	0
fam10163	2	2	2	2.0	0.0	0.0	2	2	0
fam10164	2	2	2	2.0	0.0	0.0	2	2	0
fam10165	2	2	2	2.0	0.0	0.0	2	2	0
fam10166	2	2	2	2.0	0.0	0.0	2	2	0
fam10167	2	2	2	2.0	0.0	0.0	2	2	0
fam10168	2	2	2	2.0	0.0	0.0	2	2	0
fam10169	2	2	2	2.0	0.0	0.0	2	2	0
fam10170	2	2	2	2.0	0.0	0.0	2	2	0
fam10171	2	2	2	2.0	0.0	0.0	2	2	0
fam10172	2	2	2	2.0	0.0	0.0	2	2	0
fam10173	2	2	2	2.0	0.0	0.0	2	2	0
fam10174	2	2	2	2.0	0.0	0.0	2	2	0
fam10175	2	2	2	2.0	0.0	0.0	2	2	0
fam10176	2	2	2	2.0	0.0	0.0	2	2	0
fam10177	2	2	2	2.0	0.0	0.0	2	2	0
fam10178	2	2	2	2.0	0.0	0.0	2	2	0
fam10179	2	2	2	2.0	0.0	0.0	2	2	0
fam10180	2	2	2	2.0	0.0	0.0	2	2	0
fam10181	2	2	2	2.0	0.0	0.0	2	2	0
fam10182	2	2	2	2.0	0.0	0.0	2	2	0
fam10183	2	2	2	2.0	0.0	0.0	2	2	0
fam10184	2	2	2	2.0	0.0	0.0	2	2	0
fam10185	2	2	2	2.0	0.0	0.0	2	2	0
fam10186	2	2	2	2.0	0.0	0.0	2	2	0
fam10187	2	2	2	2.0	0.0	0.0	2	2	0
fam10188	2	2	2	2.0	0.0	0.0	2	2	0
fam10189	2	2	2	2.0	0.0	0.0	2	2	0
fam10190	2	2	2	2.0	0.0	0.0	2	2	0
fam10191	2	2	2	2.0	0.0	0.0	2	2	0
fam10192	2	2	2	2.0	0.0	0.0	2	2	0
fam10193	2	2	2	2.0	0.0	0.0	2	2	0
fam10194	2	2	2	2.0	0.0	0.0	2	2	0
fam10195	2	2	2	2.0	0.0	0.0	2	2	0
fam10196	2	2	2	2.0	0.0	0.0	2	2	0
fam10197	2	2	2	2.0	0.0	0.0	2	2	0
fam10198	2	2	2	2.0	0.0	0.0	2	2	0
fam10199	2	2	2	2.0	0.0	0.0	2	2	0
fam10200	2	2	2	2.0	0.0	0.0	2	2	0
fam10201	2	2	2	2.0	0.0	0.0	2	2	0
fam10202	2	2	2	2.0	0.0	0.0	2	2	0
fam10203	2	2	2	2.0	0.0	0.0	2	2	0
fam10204	2	2	2	2.0	0.0	0.0	2	2	0
fam10205	2	2	2	2.0	0.0	0.0	2	2	0
fam10206	2	2	2	2.0	0.0	0.0	2	2	0
fam10207	2	2	2	2.0	0.0	0.0	2	2	0
fam10208	2	2	2	2.0	0.0	0.0	2	2	0
fam10209	2	2	2	2.0	0.0	0.0	2	2	0
fam10210	2	2	2	2.0	0.0	0.0	2	2	0
fam10211	2	2	2	2.0	0.0	0.0	2	2	0
fam10212	2	2	2	2.0	0.0	0.0	2	2	0
fam10213	2	2	2	2.0	0.0	0.0	2	2	0
fam10214	2	2	2	2.0	0.0	0.0	2	2	0
fam10215	2	2	2	2.0	0.0	0.0	2	2	0
fam10216	2	2	2	2.0	0.0	0.0	2	2	0
fam10217	2	2	2	2.0	0.0	0.0	2	2	0
fam10218	2	2	2	2.0	0.0	0.0	2	2	0
fam10219	2	2	2	2.0	0.0	0.0	2	2	0
fam10220	2	2	2	2.0	0.0	0.0	2	2	0
fam10221	2	2	2	2.0	0.0	0.0	2	2	0
fam10222	2	2	2	2.0	0.0	0.0	2	2	0
fam10223	2	2	2	2.0	0.0	0.0	2	2	0
fam10224	2	2	2	2.0	0.0	0.0	2	2	0
fam10225	2	2	2	2.0	0.0	0.0	2	2	0
fam10226	2	2	2	2.0	0.0	0.0	2	2	0
fam10227	2	2	2	2.0	0.0	0.0	2	2	0
fam10228	2	2	2	2.0	0.0	0.0	2	2	0
fam10229	2	2	2	2.0	0.0	0.0	2	2	0
fam10230	2	2	2	2.0	0.0	0.0	2	2	0
fam10231	2	2	2	2.0	0.0	0.0	2	2	0
fam10232	2	2	2	2.0	0.0	0.0	2	2	0
fam10233	2	2	2	2.0	0.0	0.0	2	2	0
fam10234	2	2	2	2.0	0.0	0.0	2	2	0
fam10235	2	2	2	2.0	0.0	0.0	2	2	0
fam10236	2	2	2	2.0	0.0	0.0	2	2	0
fam10237	2	2	2	2.0	0.0	0.0	2	2	0
fam10238	2	2	2	2.0	0.0	0.0	2	2	0
fam10239	2	2	2	2.0	0.0	0.0	2	2	0
fam10240	2	2	2	2.0	0.0	0.0	2	2	0
fam10241	2	2	2	2.0	0.0	0.0	2	2	0
fam10242	2	2	2	2.0	0.0	0.0	2	2	0
fam10243	2	2	2	2.0	0.0	0.0	2	2	0
fam10244	2	2	2	2.0	0.0	0.0	2	2	0
fam10245	2	2	2	2.0	0.0	0.0	2	2	0
fam10246	2	2	2	2.0	0.0	0.0	2	2	0
fam10247	2	2	2	2.0	0.0	0.0	2	2	0
fam10248	2	2	2	2.0	0.0	0.0	2	2	0
fam10249	2	2	2	2.0	0.0	0.0	2	2	0
fam10250	2	2	2	2.0	0.0	0.0	2	2	0
fam10251	2	2	2	2.0	0.0	0.0	2	2	0
fam10252	2	2	2	2.0	0.0	0.0	2	2	0
fam10253	2	2	2	2.0	0.0	0.0	2	2	0
fam10254	2	2	2	2.0	0.0	0.0	2	2	0
fam10255	2	2	2	2.0	0.0	0.0	2	2	0
fam10256	2	2	2	2.0	0.0	0.0	2	2	0
fam10257	2	2	2	2.0	0.0	0.0	2	2	0
fam10258	2	2	2	2.0	0.0	0.0	2	2	0
fam10259	2	2	2	2.0	0.0	0.0	2	2	0
fam10260	2	2	2	2.0	0.0	0.0	2	2	0
fam10261	2	2	2	2.0	0.0	0.0	2	2	0
fam10262	2	2	2	2.0	0.0	0.0	2	2	0
fam10263	2	2	2	2.0	0.0	0.0	2	2	0
fam10264	2	2	2	2.0	0.0	0.0	2	2	0
fam10265	2	2	2	2.0	0.0	0.0	2	2	0
fam10266	2	2	2	2.0	0.0	0.0	2	2	0
fam10267	2	2	2	2.0	0.0	0.0	2	2	0
fam10268	2	2	2	2.0	0.0	0.0	2	2	0
fam10269	2	2	2	2.0	0.0	0.0	2	2	0
fam10270	2	2	2	2.0	0.0	0.0	2	2	0
fam10271	2	2	2	2.0	0.0	0.0	2	2	0
fam10272	2	2	2	2.0	0.0	0.0	2	2	0
fam10273	2	2	2	2.0	0.0	0.0	2	2	0
fam10274	2	2	2	2.0	0.0	0.0	2	2	0
fam10275	2	2	2	2.0	0.0	0.0	2	2	0
fam10276	2	2	2	2.0	0.0	0.0	2	2	0
fam10277	2	2	2	2.0	0.0	0.0	2	2	0
fam10278	2	2	2	2.0	0.0	0.0	2	2	0
fam10279	2	2	2	2.0	0.0	0.0	2	2	0
fam10280	2	2	2	2.0	0.0	0.0	2	2	0
fam10281	2	2	2	2.0	0.0	0.0	2	2	0
fam10282	2	2	2	2.0	0.0	0.0	2	2	0
fam10283	2	2	2	2.0	0.0	0.0	2	2	0
fam10284	2	2	2	2.0	0.0	0.0	2	2	0
fam10285	2	2	2	2.0	0.0	0.0	2	2	0
fam10286	2	2	2	2.0	0.0	0.0	2	2	0
fam10287	2	2	2	2.0	0.0	0.0	2	2	0
fam10288	2	2	2	2.0	0.0	0.0	2	2	0
fam10289	2	2	2	2.0	0.0	0.0	2	2	0
fam10290	2	2	2	2.0	0.0	0.0	2	2	0
fam10291	2	2	2	2.0	0.0	0.0	2	2	0
fam10292	2	2	2	2.0	0.0	0.0	2	2	0
fam10293	2	2	2	2.0	0.0	0.0	2	2	0
fam10294	2	2	2	2.0	0.0	0.0	2	2	0
fam10295	2	2	2	2.0	0.0	0.0	2	2	0
fam10296	2	2	2	2.0	0.0	0.0	2	2	0
fam10297	2	2	2	2.0	0.0	0.0	2	2	0
fam10298	2	2	2	2.0	0.0	0.0	2	2	0
fam10299	2	2	2	2.0	0.0	0.0	2	2	0
fam10300	2	2	2	2.0	0.0	0.0	2	2	0
fam10301	2	2	2	2.0	0.0	0.0	2	2	0
fam10302	2	2	2	2.0	0.0	0.0	2	2	0
fam10303	2	2	2	2.0	0.0	0.0	2	2	0
fam10304	2	2	2	2.0	0.0	0.0	2	2	0
fam10305	2	2	2	2.0	0.0	0.0	2	2	0
fam10306	2	2	2	2.0	0.0	0.0	2	2	0
fam10307	2	2	2	2.0	0.0	0.0	2	2	0
fam10308	2	2	2	2.0	0.0	0.0	2	2	0
fam10309	2	2	2	2.0	0.0	0.0	2	2	0
fam10310	2	2	2	2.0	0.0	0.0	2	2	0
fam10311	2	2	2	2.0	0.0	0.0	2	2	0
fam10312	2	2	2	2.0	0.0	0.0	2	2	0
fam10313	2	2	2	2.0	0.0	0.0	2	2	0
fam10314	2	2	2	2.0	0.0	0.0	2	2	0
fam10315	2	2	2	2.0	0.0	0.0	2	2	0
fam10316	2	2	2	2.0	0.0	0.0	2	2	0
fam10317	2	2	2	2.0	0.0	0.0	2	2	0
fam10318	2	2	2	2.0	0.0	0.0	2	2	0
fam10319	2	2	2	2.0	0.0	0.0	2	2	0
fam10320	2	2	2	2.0	0.0	0.0	2	2	0
fam10321	2	2	2	2.0	0.0	0.0	2	2	0
fam10322	2	2	2	2.0	0.0	0.0	2	2	0
fam10323	2	2	2	2.0	0.0	0.0	2	2	0
fam10324	2	2	2	2.0	0.0	0.0	2	2	0
fam10325	2	2	2	2.0	0.0	0.0	2	2	0
fam10326	2	2	2	2.0	0.0	0.0	2	2	0
fam10327	2	2	2	2.0	0.0	0.0	2	2	0
fam10328	2	2	2	2.0	0.0	0.0	2	2	0
fam10329	2	2	2	2.0	0.0	0.0	2	2	0
fam10330	2	2	2	2.0	0.0	0.0	2	2	0
fam10331	2	2	2	2.0	0.0	0.0	2	2	0
fam10332	2	2	2	2.0	0.0	0.0	2	2	0
fam10333	2	2	2	2.0	0.0	0.0	2	2	0
fam10334	2	2	2	2.0	0.0	0.0	2	2	0
fam10335	2	2	2	2.0	0.0	0.0	2	2	0
fam10336	2	2	2	2.0	0.0	0.0	2	2	0
fam10337	2	2	2	2.0	0.0	0.0	2	2	0
fam10338	2	2	2	2.0	0.0	0.0	2	2	0
fam10339	2	2	2	2.0	0.0	0.0	2	2	0
fam10340	2	2	2	2.0	0.0	0.0	2	2	0
fam10341	2	2	2	2.0	0.0	0.0	2	2	0
fam10342	2	2	2	2.0	0.0	0.0	2	2	0
fam10343	2	2	2	2.0	0.0	0.0	2	2	0
fam10344	2	2	2	2.0	0.0	0.0	2	2	0
fam10345	2	2	2	2.0	0.0	0.0	2	2	0
fam10346	2	2	2	2.0	0.0	0.0	2	2	0
fam10347	2	2	2	2.0	0.0	0.0	2	2	0
fam10348	2	2	2	2.0	0.0	0.0	2	2	0
fam10349	2	2	2	2.0	0.0	0.0	2	2	0
fam10350	2	2	2	2.0	0.0	0.0	2	2	0
fam10351	2	2	2	2.0	0.0	0.0	2	2	0
fam10352	2	2	2	2.0	0.0	0.0	2	2	0
fam10353	2	2	2	2.0	0.0	0.0	2	2	0
fam10354	2	2	2	2.0	0.0	0.0	2	2	0
fam10355	2	2	2	2.0	0.0	0.0	2	2	0
fam10356	2	2	2	2.0	0.0	0.0	2	2	0
fam10357	2	2	2	2.0	0.0	0.0	2	2	0
fam10358	2	2	2	2.0	0.0	0.0	2	2	0
fam10359	2	2	2	2.0	0.0	0.0	2	2	0
fam10360	2	2	2	2.0	0.0	0.0	2	2	0
fam10361	2	2	2	2.0	0.0	0.0	2	2	0
fam10362	2	2	2	2.0	0.0	0.0	2	2	0
fam10363	2	2	2	2.0	0.0	0.0	2	2	0
fam10364	2	2	2	2.0	0.0	0.0	2	2	0
fam10365	2	2	2	2.0	0.0	0.0	2	2	0
fam10366	2	2	2	2.0	0.0	0.0	2	2	0
fam10367	2	2	2	2.0	0.0	0.0	2	2	0
fam10368	2	2	2	2.0	0.0	0.0	2	2	0
fam10369	2	2	2	2.0	0.0	0.0	2	2	0
fam10370	2	2	2	2.0	0.0	0.0	2	2	0
fam10371	2	2	2	2.0	0.0	0.0	2	2	0
fam10372	2	2	2	2.0	0.0	0.0	2	2	0
fam10373	2	2	2	2.0	0.0	0.0	2	2	0
fam10374	2	2	2	2.0	0.0	0.0	2	2	0
fam10375	2	2	2	2.0	0.0	0.0	2	2	0
fam10376	2	2	2	2.0	0.0	0.0	2	2	0
fam10377	2	2	2	2.0	0.0	0.0	2	2	0
fam10378	2	2	2	2.0	0.0	0.0	2	2	0
fam10379	2	2	2	2.0	0.0	0.0	2	2	0
fam10380	2	2	2	2.0	0.0	0.0	2	2	0
fam10381	2	2	2	2.0	0.0	0.0	2	2	0
fam10382	2	2	2	2.0	0.0	0.0	2	2	0
fam10383	2	2	2	2.0	0.0	0.0	2	2	0
fam10384	2	2	2	2.0	0.0	0.0	2	2	0
fam10385	2	2	2	2.0	0.0	0.0	2	2	0
fam10386	2	2	2	2.0	0.0	0.0	2	2	0
fam10387	2	2	2	2.0	0.0	0.0	2	2	0
fam10388	2	2	2	2.0	0.0	0.0	2	2	0
fam10389	2	2	2	2.0	0.0	0.0	2	2	0
fam10390	2	2	2	2.0	0.0	0.0	2	2	0
fam10391	2	2	2	2.0	0.0	0.0	2	2	0
fam10392	2	2	2	2.0	0.0	0.0	2	2	0
fam10393	2	2	2	2.0	0.0	0.0	2	2	0
fam10394	2	2	2	2.0	0.0	0.0	2	2	0
fam10395	2	2	2	2.0	0.0	0.0	2	2	0
fam10396	2	2	2	2.0	0.0	0.0	2	2	0
fam10397	2	2	2	2.0	0.0	0.0	2	2	0
fam10398	2	2	2	2.0	0.0	0.0	2	2	0
fam10399	2	2	2	2.0	0.0	0.0	2	2	0
fam10400	2	2	2	2.0	0.0	0.0	2	2	0
fam10401	2	2	2	2.0	0.0	0.0	2	2	0
fam10402	2	2	2	2.0	0.0	0.0	2	2	0
fam10403	2	2	2	2.0	0.0	0.0	2	2	0
fam10404	2	2	2	2.0	0.0	0.0	2	2	0
fam10405	2	2	2	2.0	0.0	0.0	2	2	0
fam10406	2	2	2	2.0	0.0	0.0	2	2	0
fam10407	2	2	2	2.0	0.0	0.0	2	2	0
fam10408	2	2	2	2.0	0.0	0.0	2	2	0
fam10409	2	2	2	2.0	0.0	0.0	2	2	0
fam10410	2	2	2	2.0	0.0	0.0	2	2	0
fam10411	2	2	2	2.0	0.0	0.0	2	2	0
fam10412	2	2	2	2.0	0.0	0.0	2	2	0
fam10413	2	2	2	2.0	0.0	0.0	2	2	0
fam10414	2	2	2	2.0	0.0	0.0	2	2	0
fam10415	2	2	2	2.0	0.0	0.0	2	2	0
fam10416	2	2	2	2.0	0.0	0.0	2	2	0
fam10417	2	2	2	2.0	0.0	0.0	2	2	0
fam10418	2	2	2	2.0	0.0	0.0	2	2	0
fam10419	2	2	2	2.0	0.0	0.0	2	2	0
fam10420	2	2	2	2.0	0.0	0.0	2	2	0
fam10421	2	2	2	2.0	0.0	0.0	2	2	0
fam10422	2	2	2	2.0	0.0	0.0	2	2	0
fam10423	2	2	2	2.0	0.0	0.0	2	2	0
fam10424	2	2	2	2.0	0.0	0.0	2	2	0
fam10425	2	2	2	2.0	0.0	0.0	2	2	0
fam10426	2	2	2	2.0	0.0	0.0	2	2	0
fam10427	2	2	2	2.0	0.0	0.0	2	2	0
fam10428	2	2	2	2.0	0.0	0.0	2	2	0
fam10429	2	2	2	2.0	0.0	0.0	2	2	0
fam10430	2	2	2	2.0	0.0	0.0	2	2	0
fam10431	2	2	2	2.0	0.0	0.0	2	2	0
fam10432	2	2	2	2.0	0.0	0.0	2	2	0
fam10433	2	2	2	2.0	0.0	0.0	2	2	0
fam10434	2	2	2	2.0	0.0	0.0	2	2	0
fam10435	2	2	2	2.0	0.0	0.0	2	2	0
fam10436	2	2	2	2.0	0.0	0.0	2	2	0
fam10437	2	2	2	2.0	0.0	0.0	2	2	0
fam10438	2	2	2	2.0	0.0	0.0	2	2	0
fam10439	2	2	2	2.0	0.0	0.0	2	2	0
fam10440	2	2	2	2.0	0.0	0.0	2	2	0
fam10441	2	2	2	2.0	0.0	0.0	2	2	0
fam10442	2	2	2	2.0	0.0	0.0	2	2	0
fam10443	2	2	2	2.0	0.0	0.0	2	2	0
fam10444	2	2	2	2.0	0.0	0.0	2	2	0
fam10445	2	2	2	2.0	0.0	0.0	2	2	0
fam10446	2	2	2	2.0	0.0	0.0	2	2	0
fam10447	2	2	2	2.0	0.0	0.0	2	2	0
fam10448	2	2	2	2.0	0.0	0.0	2	2	0
fam10449	2	2	2	2.0	0.0	0.0	2	2	0
fam10450	2	2	2	2.0	0.0	0.0	2	2	0
fam10451	2	2	2	2.0	0.0	0.0	2	2	0
fam10452	2	2	2	2.0	0.0	0.0	2	2	0
fam10453	2	2	2	2.0	0.0	0.0	2	2	0
fam10454	2	2	2	2.0	0.0	0.0	2	2	0
fam10455	2	2	2	2.0	0.0	0.0	2	2	0
fam10456	2	2	2	2.0	0.0	0.0	2	2	0
fam10457	2	2	2	2.0	0.0	0.0	2	2	0
fam10458	2	2	2	2.0	0.0	0.0	2	2	0
fam10459	2	2	2	2.0	0.0	0.0	2	2	0
fam10460	2	2	2	2.0	0.0	0.0	2	2	0
fam10461	2	2	2	2.0	0.0	0.0	2	2	0
fam10462	2	2	2	2.0	0.0	0.0	2	2	0
fam10463	2	2	2	2.0	0.0	0.0	2	2	0
fam10464	2	2	2	2.0	0.0	0.0	2	2	0
fam10465	2	2	2	2.0	0.0	0.0	2	2	0
fam10466	2	2	2	2.0	0.0	0.0	2	2	0
fam10467	2	2	2	2.0	0.0	0.0	2	2	0
fam10468	2	2	2	2.0	0.0	0.0	2	2	0
fam10469	2	2	2	2.0	0.0	0.0	2	2	0
fam10470	2	2	2	2.0	0.0	0.0	2	2	0
fam10471	2	2	2	2.0	0.0	0.0	2	2	0
fam10472	2	2	2	2.0	0.0	0.0	2	2	0
fam10473	2	2	2	2.0	0.0	0.0	2	2	0
fam10474	2	2	2	2.0	0.0	0.0	2	2	0
fam10475	2	2	2	2.0	0.0	0.0	2	2	0
fam10476	2	2	2	2.0	0.0	0.0	2	2	0
fam10477	2	2	2	2.0	0.0	0.0	2	2	0
fam10478	2	2	2	2.0	0.0	0.0	2	2	0
fam10479	2	2	2	2.0	0.0	0.0	2	2	0
fam10480	2	2	2	2.0	0.0	0.0	2	2	0
fam10481	2	2	2	2.0	0.0	0.0	2	2	0
fam10482	2	2	2	2.0	0.0	0.0	2	2	0
fam10483	2	2	2	2.0	0.0	0.0	2	2	0
fam10484	2	2	2	2.0	0.0	0.0	2	2	0
fam10485	2	2	2	2.0	0.0	0.0	2	2	0
fam10486	2	2	2	2.0	0.0	0.0	2	2	0
fam10487	2	2	2	2.0	0.0	0.0	2	2	0
fam10488	2	2	2	2.0	0.0	0.0	2	2	0
fam10489	2	2	2	2.0	0.0	0.0	2	2	0
fam10490	2	2	2	2.0	0.0	0.0	2	2	0
fam10491	2	2	2	2.0	0.0	0.0	2	2	0
fam10492	2	2	2	2.0	0.0	0.0	2	2	0
fam10493	2	2	2	2.0	0.0	0.0	2	2	0
fam10494	2	2	2	2.0	0.0	0.0	2	2	0
fam10495	2	2	2	2.0	0.0	0.0	2	2	0
fam10496	2	2	2	2.0	0.0	0.0	2	2	0
fam10497	2	2	2	2.0	0.0	0.0	2	2	0
fam10498	2	2	2	2.0	0.0	0.0	2	2	0
fam10499	2	2	2	2.0	0.0	0.0	2	2	0
fam10500	2	2	2	2.0	0.0	0.0	2	2	0
fam10501	2	2	2	2.0	0.0	0.0	2	2	0
fam10502	2	2	2	2.0	0.0	0.0	2	2	0
fam10503	2	2	2	2.0	0.0	0.0	2	2	0
fam10504	2	2	2	2.0	0.0	0.0	2	2	0
fam10505	2	2	2	2.0	0.0	0.0	2	2	0
fam10506	2	2	2	2.0	0.0	0.0	2	2	0
fam10507	2	2	2	2.0	0.0	0.0	2	2	0
fam10508	2	2	2	2.0	0.0	0.0	2	2	0
fam10509	2	2	2	2.0	0.0	0.0	2	2	0
fam10510	2	2	2	2.0	0.0	0.0	2	2	0
fam10511	2	2	2	2.0	0.0	0.0	2	2	0
fam10512	2	2	2	2.0	0.0	0.0	2	2	0
fam10513	2	2	2	2.0	0.0	0.0	2	2	0
fam10514	2	2	2	2.0	0.0	0.0	2	2	0
fam10515	2	2	2	2.0	0.0	0.0	2	2	0
fam10516	2	2	2	2.0	0.0	0.0	2	2	0
fam10517	2	2	2	2.0	0.0	0.0	2	2	0
fam10518	2	2	2	2.0	0.0	0.0	2	2	0
fam10519	2	2	2	2.0	0.0	0.0	2	2	0
fam10520	2	2	2	2.0	0.0	0.0	2	2	0
fam10521	2	2	2	2.0	0.0	0.0	2	2	0
fam10522	2	2	2	2.0	0.0	0.0	2	2	0
fam10523	2	2	2	2.0	0.0	0.0	2	2	0
fam10524	2	2	2	2.0	0.0	0.0	2	2	0
fam10525	2	2	2	2.0	0.0	0.0	2	2	0
fam10526	2	2	2	2.0	0.0	0.0	2	2	0
fam10527	2	2	2	2.0	0.0	0.0	2	2	0
fam10528	2	2	2	2.0	0.0	0.0	2	2	0
fam10529	2	2	2	2.0	0.0	0.0	2	2	0
fam10530	2	2	2	2.0	0.0	0.0	2	2	0
fam10531	2	2	2	2.0	0.0	0.0	2	2	0
fam10532	2	2	2	2.0	0.0	0.0	2	2	0
fam10533	2	2	2	2.0	0.0	0.0	2	2	0
fam10534	2	2	2	2.0	0.0	0.0	2	2	0
fam10535	2	2	2	2.0	0.0	0.0	2	2	0
fam10536	2	2	2	2.0	0.0	0.0	2	2	0
fam10537	2	2	2	2.0	0.0	0.0	2	2	0
fam10538	2	2	2	2.0	0.0	0.0	2	2	0
fam10539	2	2	2	2.0	0.0	0.0	2	2	0
fam10540	2	2	2	2.0	0.0	0.0	2	2	0
fam10541	2	2	2	2.0	0.0	0.0	2	2	0
fam10542	2	2	2	2.0	0.0	0.0	2	2	0
fam10543	2	2	2	2.0	0.0	0.0	2	2	0
fam10544	2	2	2	2.0	0.0	0.0	2	2	0
fam10545	2	2	2	2.0	0.0	0.0	2	2	0
fam10546	2	2	2	2.0	0.0	0.0	2	2	0
fam10547	2	2	2	2.0	0.0	0.0	2	2	0
fam10548	2	2	2	2.0	0.0	0.0	2	2	0
fam10549	2	2	2	2.0	0.0	0.0	2	2	0
fam10550	2	2	2	2.0	0.0	0.0	2	2	0
fam10551	2	2	2	2.0	0.0	0.0	2	2	0
fam10552	2	2	2	2.0	0.0	0.0	2	2	0
fam10553	2	2	2	2.0	0.0	0.0	2	2	0
fam10554	2	2	2	2.0	0.0	0.0	2	2	0
fam10555	2	2	2	2.0	0.0	0.0	2	2	0
fam10556	2	2	2	2.0	0.0	0.0	2	2	0
fam10557	2	2	2	2.0	0.0	0.0	2	2	0
fam10558	2	2	2	2.0	0.0	0.0	2	2	0
fam10559	2	2	2	2.0	0.0	0.0	2	2	0
fam10560	2	2	2	2.0	0.0	0.0	2	2	0
fam10561	2	2	2	2.0	0.0	0.0	2	2	0
fam10562	2	2	2	2.0	0.0	0.0	2	2	0
fam10563	2	2	2	2.0	0.0	0.0	2	2	0
fam10564	2	2	2	2.0	0.0	0.0	2	2	0
fam10565	2	2	2	2.0	0.0	0.0	2	2	0
fam10566	2	2	2	2.0	0.0	0.0	2	2	0
fam10567	2	2	2	2.0	0.0	0.0	2	2	0
fam10568	2	2	2	2.0	0.0	0.0	2	2	0
fam10569	2	2	2	2.0	0.0	0.0	2	2	0
fam10570	2	2	2	2.0	0.0	0.0	2	2	0
fam10571	2	2	2	2.0	0.0	0.0	2	2	0
fam10572	2	2	2	2.0	0.0	0.0	2	2	0
fam10573	2	2	2	2.0	0.0	0.0	2	2	0
fam10574	2	2	2	2.0	0.0	0.0	2	2	0
fam10575	2	2	2	2.0	0.0	0.0	2	2	0
fam10576	2	2	2	2.0	0.0	0.0	2	2	0
fam10577	2	2	2	2.0	0.0	0.0	2	2	0
fam10578	2	2	2	2.0	0.0	0.0	2	2	0
fam10579	2	2	2	2.0	0.0	0.0	2	2	0
fam10580	2	2	2	2.0	0.0	0.0	2	2	0
fam10581	2	2	2	2.0	0.0	0.0	2	2	0
fam10582	2	2	2	2.0	0.0	0.0	2	2	0
fam10583	2	2	2	2.0	0.0	0.0	2	2	0
fam10584	2	2	2	2.0	0.0	0.0	2	2	0
fam10585	2	2	2	2.0	0.0	0.0	2	2	0
fam10586	2	2	2	2.0	0.0	0.0	2	2	0
fam10587	2	2	2	2.0	0.0	0.0	2	2	0
fam10588	2	2	2	2.0	0.0	0.0	2	2	0
fam10589	2	2	2	2.0	0.0	0.0	2	2	0
fam10590	2	2	2	2.0	0.0	0.0	2	2	0
fam10591	2	2	2	2.0	0.0	0.0	2	2	0
fam10592	2	2	2	2.0	0.0	0.0	2	2	0
fam10593	2	2	2	2.0	0.0	0.0	2	2	0
fam10594	2	2	2	2.0	0.0	0.0	2	2	0
fam10595	2	2	2	2.0	0.0	0.0	2	2	0
fam10596	2	2	2	2.0	0.0	0.0	2	2	0
fam10597	2	2	2	2.0	0.0	0.0	2	2	0
fam10598	2	2	2	2.0	0.0	0.0	2	2	0
fam10599	2	2	2	2.0	0.0	0.0	2	2	0
fam10600	2	2	2	2.0	0.0	0.0	2	2	0
fam10601	2	2	2	2.0	0.0	0.0	2	2	0
fam10602	2	2	2	2.0	0.0	0.0	2	2	0
fam10603	2	2	2	2.0	0.0	0.0	2	2	0
fam10604	2	2	2	2.0	0.0	0.0	2	2	0
fam10605	2	2	2	2.0	0.0	0.0	2	2	0
fam10606	2	2	2	2.0	0.0	0.0	2	2	0
fam10607	2	2	2	2.0	0.0	0.0	2	2	0
fam10608	2	2	2	2.0	0.0	0.0	2	2	0
fam10609	2	2	2	2.0	0.0	0.0	2	2	0
fam10610	2	2	2	2.0	0.0	0.0	2	2	0
fam10611	2	2	2	2.0	0.0	0.0	2	2	0
fam10612	2	2	2	2.0	0.0	0.0	2	2	0
fam10613	2	2	2	2.0	0.0	0.0	2	2	0
fam10614	2	2	2	2.0	0.0	0.0	2	2	0
fam10615	2	2	2	2.0	0.0	0.0	2	2	0
fam10616	2	2	2	2.0	0.0	0.0	2	2	0
fam10617	2	2	2	2.0	0.0	0.0	2	2	0
fam10618	2	2	2	2.0	0.0	0.0	2	2	0
fam10619	2	2	2	2.0	0.0	0.0	2	2	0
fam10620	2	2	2	2.0	0.0	0.0	2	2	0
fam10621	2	2	2	2.0	0.0	0.0	2	2	0
fam10622	2	2	2	2.0	0.0	0.0	2	2	0
fam10623	2	2	2	2.0	0.0	0.0	2	2	0
fam10624	2	2	2	2.0	0.0	0.0	2	2	0
fam10625	2	2	2	2.0	0.0	0.0	2	2	0
fam10626	2	2	2	2.0	0.0	0.0	2	2	0
fam10627	2	2	2	2.0	0.0	0.0	2	2	0
fam10628	2	2	2	2.0	0.0	0.0	2	2	0
fam10629	2	2	2	2.0	0.0	0.0	2	2	0
fam10630	2	2	2	2.0	0.0	0.0	2	2	0
fam10631	2	2	2	2.0	0.0	0.0	2	2	0
fam10632	2	2	2	2.0	0.0	0.0	2	2	0
fam10633	2	2	2	2.0	0.0	0.0	2	2	0
fam10634	2	2	2	2.0	0.0	0.0	2	2	0
fam10635	2	2	2	2.0	0.0	0.0	2	2	0
fam10636	2	2	2	2.0	0.0	0.0	2	2	0
fam10637	2	2	2	2.0	0.0	0.0	2	2	0
fam10638	2	2	2	2.0	0.0	0.0	2	2	0
fam10639	2	2	2	2.0	0.0	0.0	2	2	0
fam10640	2	2	2	2.0	0.0	0.0	2	2	0
fam10641	2	2	2	2.0	0.0	0.0	2	2	0
fam10642	2	2	2	2.0	0.0	0.0	2	2	0
fam10643	2	2	2	2.0	0.0	0.0	2	2	0
fam10644	2	2	2	2.0	0.0	0.0	2	2	0
fam10645	2	2	2	2.0	0.0	0.0	2	2	0
fam10646	2	2	2	2.0	0.0	0.0	2	2	0
fam10647	2	2	2	2.0	0.0	0.0	2	2	0
fam10648	2	2	2	2.0	0.0	0.0	2	2	0
fam10649	2	2	2	2.0	0.0	0.0	2	2	0
fam10650	2	2	2	2.0	0.0	0.0	2	2	0
fam10651	2	2	2	2.0	0.0	0.0	2	2	0
fam10652	2	2	2	2.0	0.0	0.0	2	2	0
fam10653	2	2	2	2.0	0.0	0.0	2	2	0
fam10654	2	2	2	2.0	0.0	0.0	2	2	0
fam10655	2	2	2	2.0	0.0	0.0	2	2	0
fam10656	2	2	2	2.0	0.0	0.0	2	2	0
fam10657	2	2	2	2.0	0.0	0.0	2	2	0
fam10658	2	2	2	2.0	0.0	0.0	2	2	0
fam10659	2	2	2	2.0	0.0	0.0	2	2	0
fam10660	2	2	2	2.0	0.0	0.0	2	2	0
fam10661	2	2	2	2.0	0.0	0.0	2	2	0
fam10662	2	2	2	2.0	0.0	0.0	2	2	0
fam10663	2	2	2	2.0	0.0	0.0	2	2	0
fam10664	2	2	2	2.0	0.0	0.0	2	2	0
fam10665	2	2	2	2.0	0.0	0.0	2	2	0
fam10666	2	2	2	2.0	0.0	0.0	2	2	0
fam10667	2	2	2	2.0	0.0	0.0	2	2	0
fam10668	2	2	2	2.0	0.0	0.0	2	2	0
fam10669	2	2	2	2.0	0.0	0.0	2	2	0
fam10670	2	2	2	2.0	0.0	0.0	2	2	0
fam10671	2	2	2	2.0	0.0	0.0	2	2	0
fam10672	2	2	2	2.0	0.0	0.0	2	2	0
fam10673	2	2	2	2.0	0.0	0.0	2	2	0
fam10674	2	2	2	2.0	0.0	0.0	2	2	0
fam10675	2	2	2	2.0	0.0	0.0	2	2	0
fam10676	2	2	2	2.0	0.0	0.0	2	2	0
fam10677	2	2	2	2.0	0.0	0.0	2	2	0
fam10678	2	2	2	2.0	0.0	0.0	2	2	0
fam10679	2	2	2	2.0	0.0	0.0	2	2	0
fam10680	2	2	2	2.0	0.0	0.0	2	2	0
fam10681	2	2	2	2.0	0.0	0.0	2	2	0
fam10682	2	2	2	2.0	0.0	0.0	2	2	0
fam10683	2	2	2	2.0	0.0	0.0	2	2	0
fam10684	2	2	2	2.0	0.0	0.0	2	2	0
fam10685	2	2	2	2.0	0.0	0.0	2	2	0
fam10686	2	2	2	2.0	0.0	0.0	2	2	0
fam10687	2	2	2	2.0	0.0	0.0	2	2	0
fam10688	2	2	2	2.0	0.0	0.0	2	2	0
fam10689	2	2	2	2.0	0.0	0.0	2	2	0
fam10690	2	2	2	2.0	0.0	0.0	2	2	0
fam10691	2	2	2	2.0	0.0	0.0	2	2	0
fam10692	2	2	2	2.0	0.0	0.0	2	2	0
fam10693	2	2	2	2.0	0.0	0.0	2	2	0
fam10694	2	2	2	2.0	0.0	0.0	2	2	0
fam10695	2	2	2	2.0	0.0	0.0	2	2	0
fam10696	2	2	2	2.0	0.0	0.0	2	2	0
fam10697	2	2	2	2.0	0.0	0.0	2	2	0
fam10698	2	2	2	2.0	0.0	0.0	2	2	0
fam10699	2	2	2	2.0	0.0	0.0	2	2	0
fam10700	2	2	2	2.0	0.0	0.0	2	2	0
fam10701	2	2	2	2.0	0.0	0.0	2	2	0
fam10702	2	2	2	2.0	0.0	0.0	2	2	0
fam10703	2	2	2	2.0	0.0	0.0	2	2	0
fam10704	2	2	2	2.0	0.0	0.0	2	2	0
fam10705	2	2	2	2.0	0.0	0.0	2	2	0
fam10706	2	2	2	2.0	0.0	0.0	2	2	0
fam10707	2	2	2	2.0	0.0	0.0	2	2	0
fam10708	2	2	2	2.0	0.0	0.0	2	2	0
fam10709	2	2	2	2.0	0.0	0.0	2	2	0
fam10710	2	2	2	2.0	0.0	0.0	2	2	0
fam10711	2	2	2	2.0	0.0	0.0	2	2	0
fam10712	2	2	2	2.0	0.0	0.0	2	2	0
fam10713	2	2	2	2.0	0.0	0.0	2	2	0
fam10714	2	2	2	2.0	0.0	0.0	2	2	0
fam10715	2	2	2	2.0	0.0	0.0	2	2	0
fam10716	2	2	2	2.0	0.0	0.0	2	2	0
fam10717	2	2	2	2.0	0.0	0.0	2	2	0
fam10718	2	2	2	2.0	0.0	0.0	2	2	0
fam10719	2	2	2	2.0	0.0	0.0	2	2	0
fam10720	2	2	2	2.0	0.0	0.0	2	2	0
fam10721	2	2	2	2.0	0.0	0.0	2	2	0
fam10722	2	2	2	2.0	0.0	0.0	2	2	0
fam10723	2	2	2	2.0	0.0	0.0	2	2	0
fam10724	2	2	2	2.0	0.0	0.0	2	2	0
fam10725	2	2	2	2.0	0.0	0.0	2	2	0
fam10726	2	2	2	2.0	0.0	0.0	2	2	0
fam10727	2	2	2	2.0	0.0	0.0	2	2	0
fam10728	2	2	2	2.0	0.0	0.0	2	2	0
fam10729	2	2	2	2.0	0.0	0.0	2	2	0
fam10730	2	2	2	2.0	0.0	0.0	2	2	0
fam10731	2	2	2	2.0	0.0	0.0	2	2	0
fam10732	2	2	2	2.0	0.0	0.0	2	2	0
fam10733	2	2	2	2.0	0.0	0.0	2	2	0
fam10734	2	2	2	2.0	0.0	0.0	2	2	0
fam10735	2	2	2	2.0	0.0	0.0	2	2	0
fam10736	2	2	2	2.0	0.0	0.0	2	2	0
fam10737	2	2	2	2.0	0.0	0.0	2	2	0
fam10738	2	2	2	2.0	0.0	0.0	2	2	0
fam10739	2	2	2	2.0	0.0	0.0	2	2	0
fam10740	2	2	2	2.0	0.0	0.0	2	2	0
fam10741	2	2	2	2.0	0.0	0.0	2	2	0
fam10742	2	2	2	2.0	0.0	0.0	2	2	0
fam10743	2	2	2	2.0	0.0	0.0	2	2	0
fam10744	2	2	2	2.0	0.0	0.0	2	2	0
fam10745	2	2	2	2.0	0.0	0.0	2	2	0
fam10746	2	2	2	2.0	0.0	0.0	2	2	0
fam10747	2	2	2	2.0	0.0	0.0	2	2	0
fam10748	2	2	2	2.0	0.0	0.0	2	2	0
fam10749	2	2	2	2.0	0.0	0.0	2	2	0
fam10750	2	2	2	2.0	0.0	0.0	2	2	0
fam10751	2	2	2	2.0	0.0	0.0	2	2	0
fam10752	2	2	2	2.0	0.0	0.0	2	2	0
fam10753	2	2	2	2.0	0.0	0.0	2	2	0
fam10754	2	2	2	2.0	0.0	0.0	2	2	0
fam10755	2	2	2	2.0	0.0	0.0	2	2	0
fam10756	2	2	2	2.0	0.0	0.0	2	2	0
fam10757	2	2	2	2.0	0.0	0.0	2	2	0
fam10758	2	2	2	2.0	0.0	0.0	2	2	0
fam10759	2	2	2	2.0	0.0	0.0	2	2	0
fam10760	2	2	2	2.0	0.0	0.0	2	2	0
fam10761	2	2	2	2.0	0.0	0.0	2	2	0
fam10762	2	2	2	2.0	0.0	0.0	2	2	0
fam10763	2	2	2	2.0	0.0	0.0	2	2	0
fam10764	2	2	2	2.0	0.0	0.0	2	2	0
fam10765	2	2	2	2.0	0.0	0.0	2	2	0
fam10766	2	2	2	2.0	0.0	0.0	2	2	0
fam10767	2	2	2	2.0	0.0	0.0	2	2	0
fam10768	2	2	2	2.0	0.0	0.0	2	2	0
fam10769	2	2	2	2.0	0.0	0.0	2	2	0
fam10770	2	2	2	2.0	0.0	0.0	2	2	0
fam10771	2	2	2	2.0	0.0	0.0	2	2	0
fam10772	2	2	2	2.0	0.0	0.0	2	2	0
fam10773	2	2	2	2.0	0.0	0.0	2	2	0
fam10774	2	2	2	2.0	0.0	0.0	2	2	0
fam10775	2	2	2	2.0	0.0	0.0	2	2	0
fam10776	2	2	2	2.0	0.0	0.0	2	2	0
fam10777	2	2	2	2.0	0.0	0.0	2	2	0
fam10778	2	2	2	2.0	0.0	0.0	2	2	0
fam10779	2	2	2	2.0	0.0	0.0	2	2	0
fam10780	2	2	2	2.0	0.0	0.0	2	2	0
fam10781	2	2	2	2.0	0.0	0.0	2	2	0
fam10782	2	2	2	2.0	0.0	0.0	2	2	0
fam10783	2	2	2	2.0	0.0	0.0	2	2	0
fam10784	2	2	2	2.0	0.0	0.0	2	2	0
fam10785	2	2	2	2.0	0.0	0.0	2	2	0
fam10786	2	2	2	2.0	0.0	0.0	2	2	0
fam10787	2	2	2	2.0	0.0	0.0	2	2	0
fam10788	2	2	2	2.0	0.0	0.0	2	2	0
fam10789	2	2	2	2.0	0.0	0.0	2	2	0
fam10790	2	2	2	2.0	0.0	0.0	2	2	0
fam10791	2	2	2	2.0	0.0	0.0	2	2	0
fam10792	2	2	2	2.0	0.0	0.0	2	2	0
fam10793	2	2	2	2.0	0.0	0.0	2	2	0
fam10794	2	2	2	2.0	0.0	0.0	2	2	0
fam10795	2	2	2	2.0	0.0	0.0	2	2	0
fam10796	2	2	2	2.0	0.0	0.0	2	2	0
fam10797	2	2	2	2.0	0.0	0.0	2	2	0
fam10798	2	2	2	2.0	0.0	0.0	2	2	0
fam10799	2	2	2	2.0	0.0	0.0	2	2	0
fam10800	2	2	2	2.0	0.0	0.0	2	2	0
fam10801	2	2	2	2.0	0.0	0.0	2	2	0
fam10802	2	2	2	2.0	0.0	0.0	2	2	0
fam10803	2	2	2	2.0	0.0	0.0	2	2	0
fam10804	2	2	2	2.0	0.0	0.0	2	2	0
fam10805	2	2	2	2.0	0.0	0.0	2	2	0
fam10806	2	2	2	2.0	0.0	0.0	2	2	0
fam10807	2	2	2	2.0	0.0	0.0	2	2	0
fam10808	2	2	2	2.0	0.0	0.0	2	2	0
fam10809	2	2	2	2.0	0.0	0.0	2	2	0
fam10810	2	2	2	2.0	0.0	0.0	2	2	0
fam10811	2	2	2	2.0	0.0	0.0	2	2	0
fam10812	2	2	2	2.0	0.0	0.0	2	2	0
fam10813	2	2	2	2.0	0.0	0.0	2	2	0
fam10814	2	2	2	2.0	0.0	0.0	2	2	0
fam10815	2	2	2	2.0	0.0	0.0	2	2	0
fam10816	2	2	2	2.0	0.0	0.0	2	2	0
fam10817	2	2	2	2.0	0.0	0.0	2	2	0
fam10818	2	2	2	2.0	0.0	0.0	2	2	0
fam10819	2	2	2	2.0	0.0	0.0	2	2	0
fam10820	2	2	2	2.0	0.0	0.0	2	2	0
fam10821	2	2	2	2.0	0.0	0.0	2	2	0
fam10822	2	2	2	2.0	0.0	0.0	2	2	0
fam10823	2	2	2	2.0	0.0	0.0	2	2	0
fam10824	2	2	2	2.0	0.0	0.0	2	2	0
fam10825	2	2	2	2.0	0.0	0.0	2	2	0
fam10826	2	2	2	2.0	0.0	0.0	2	2	0
fam10827	2	2	2	2.0	0.0	0.0	2	2	0
fam10828	2	2	2	2.0	0.0	0.0	2	2	0
fam10829	2	2	2	2.0	0.0	0.0	2	2	0
fam10830	2	2	2	2.0	0.0	0.0	2	2	0
fam10831	2	2	2	2.0	0.0	0.0	2	2	0
fam10832	2	2	2	2.0	0.0	0.0	2	2	0
fam10833	2	2	2	2.0	0.0	0.0	2	2	0
fam10834	2	2	2	2.0	0.0	0.0	2	2	0
fam10835	2	2	2	2.0	0.0	0.0	2	2	0
fam10836	2	2	2	2.0	0.0	0.0	2	2	0
fam10837	2	2	2	2.0	0.0	0.0	2	2	0
fam10838	2	2	2	2.0	0.0	0.0	2	2	0
fam10839	2	2	2	2.0	0.0	0.0	2	2	0
fam10840	2	2	2	2.0	0.0	0.0	2	2	0
fam10841	2	2	2	2.0	0.0	0.0	2	2	0
fam10842	2	2	2	2.0	0.0	0.0	2	2	0
fam10843	2	2	2	2.0	0.0	0.0	2	2	0
fam10844	2	2	2	2.0	0.0	0.0	2	2	0
fam10845	2	2	2	2.0	0.0	0.0	2	2	0
fam10846	2	2	2	2.0	0.0	0.0	2	2	0
fam10847	2	2	2	2.0	0.0	0.0	2	2	0
fam10848	2	2	2	2.0	0.0	0.0	2	2	0
fam10849	2	2	2	2.0	0.0	0.0	2	2	0
fam10850	2	2	2	2.0	0.0	0.0	2	2	0
fam10851	2	2	2	2.0	0.0	0.0	2	2	0
fam10852	2	2	2	2.0	0.0	0.0	2	2	0
fam10853	2	2	2	2.0	0.0	0.0	2	2	0
fam10854	2	2	2	2.0	0.0	0.0	2	2	0
fam10855	2	2	2	2.0	0.0	0.0	2	2	0
fam10856	2	2	2	2.0	0.0	0.0	2	2	0
fam10857	2	2	2	2.0	0.0	0.0	2	2	0
fam10858	2	2	2	2.0	0.0	0.0	2	2	0
fam10859	2	2	2	2.0	0.0	0.0	2	2	0
fam10860	2	2	2	2.0	0.0	0.0	2	2	0
fam10861	2	2	2	2.0	0.0	0.0	2	2	0
fam10862	2	2	2	2.0	0.0	0.0	2	2	0
fam10863	2	2	2	2.0	0.0	0.0	2	2	0
fam10864	2	2	2	2.0	0.0	0.0	2	2	0
fam10865	2	2	2	2.0	0.0	0.0	2	2	0
fam10866	2	2	2	2.0	0.0	0.0	2	2	0
fam10867	2	2	2	2.0	0.0	0.0	2	2	0
fam10868	2	2	2	2.0	0.0	0.0	2	2	0
fam10869	2	2	2	2.0	0.0	0.0	2	2	0
fam10870	2	2	2	2.0	0.0	0.0	2	2	0
fam10871	2	2	2	2.0	0.0	0.0	2	2	0
fam10872	2	2	2	2.0	0.0	0.0	2	2	0
fam10873	2	2	2	2.0	0.0	0.0	2	2	0
fam10874	2	2	2	2.0	0.0	0.0	2	2	0
fam10875	2	2	2	2.0	0.0	0.0	2	2	0
fam10876	2	2	2	2.0	0.0	0.0	2	2	0
fam10877	2	2	2	2.0	0.0	0.0	2	2	0
fam10878	2	2	2	2.0	0.0	0.0	2	2	0
fam10879	2	2	2	2.0	0.0	0.0	2	2	0
fam10880	2	2	2	2.0	0.0	0.0	2	2	0
fam10881	2	2	2	2.0	0.0	0.0	2	2	0
fam10882	2	2	2	2.0	0.0	0.0	2	2	0
fam10883	2	2	2	2.0	0.0	0.0	2	2	0
fam10884	2	2	2	2.0	0.0	0.0	2	2	0
fam10885	2	2	2	2.0	0.0	0.0	2	2	0
fam10886	2	2	2	2.0	0.0	0.0	2	2	0
fam10887	2	2	2	2.0	0.0	0.0	2	2	0
fam10888	2	2	2	2.0	0.0	0.0	2	2	0
fam10889	2	2	2	2.0	0.0	0.0	2	2	0
fam10890	2	2	2	2.0	0.0	0.0	2	2	0
fam10891	2	2	2	2.0	0.0	0.0	2	2	0
fam10892	2	2	2	2.0	0.0	0.0	2	2	0
fam10893	2	2	2	2.0	0.0	0.0	2	2	0
fam10894	2	2	2	2.0	0.0	0.0	2	2	0
fam10895	2	2	2	2.0	0.0	0.0	2	2	0
fam10896	2	2	2	2.0	0.0	0.0	2	2	0
fam10897	2	2	2	2.0	0.0	0.0	2	2	0
fam10898	2	2	2	2.0	0.0	0.0	2	2	0
fam10899	2	2	2	2.0	0.0	0.0	2	2	0
fam10900	2	2	2	2.0	0.0	0.0	2	2	0
fam10901	2	2	2	2.0	0.0	0.0	2	2	0
fam10902	2	2	2	2.0	0.0	0.0	2	2	0
fam10903	2	2	2	2.0	0.0	0.0	2	2	0
fam10904	2	2	2	2.0	0.0	0.0	2	2	0
fam10905	2	2	2	2.0	0.0	0.0	2	2	0
fam10906	2	2	2	2.0	0.0	0.0	2	2	0
fam10907	2	2	2	2.0	0.0	0.0	2	2	0
fam10908	2	2	2	2.0	0.0	0.0	2	2	0
fam10909	2	2	2	2.0	0.0	0.0	2	2	0
fam10910	2	2	2	2.0	0.0	0.0	2	2	0
fam10911	2	2	2	2.0	0.0	0.0	2	2	0
fam10912	2	2	2	2.0	0.0	0.0	2	2	0
fam10913	2	2	2	2.0	0.0	0.0	2	2	0
fam10914	2	2	2	2.0	0.0	0.0	2	2	0
fam10915	2	2	2	2.0	0.0	0.0	2	2	0
fam10916	2	2	2	2.0	0.0	0.0	2	2	0
fam10917	2	2	2	2.0	0.0	0.0	2	2	0
fam10918	2	2	2	2.0	0.0	0.0	2	2	0
fam10919	2	2	2	2.0	0.0	0.0	2	2	0
fam10920	2	2	2	2.0	0.0	0.0	2	2	0
fam10921	2	2	2	2.0	0.0	0.0	2	2	0
fam10922	2	2	2	2.0	0.0	0.0	2	2	0
fam10923	2	2	2	2.0	0.0	0.0	2	2	0
fam10924	2	2	2	2.0	0.0	0.0	2	2	0
fam10925	2	2	2	2.0	0.0	0.0	2	2	0
fam10926	2	2	2	2.0	0.0	0.0	2	2	0
fam10927	2	2	2	2.0	0.0	0.0	2	2	0
fam10928	2	2	2	2.0	0.0	0.0	2	2	0
fam10929	2	2	2	2.0	0.0	0.0	2	2	0
fam10930	2	2	2	2.0	0.0	0.0	2	2	0
fam10931	2	2	2	2.0	0.0	0.0	2	2	0
fam10932	2	2	2	2.0	0.0	0.0	2	2	0
fam10933	2	2	2	2.0	0.0	0.0	2	2	0
fam10934	2	2	2	2.0	0.0	0.0	2	2	0
fam10935	2	2	2	2.0	0.0	0.0	2	2	0
fam10936	2	2	2	2.0	0.0	0.0	2	2	0
fam10937	2	2	2	2.0	0.0	0.0	2	2	0
fam10938	2	2	2	2.0	0.0	0.0	2	2	0
fam10939	2	2	2	2.0	0.0	0.0	2	2	0
fam10940	2	2	2	2.0	0.0	0.0	2	2	0
fam10941	2	2	2	2.0	0.0	0.0	2	2	0
fam10942	2	2	2	2.0	0.0	0.0	2	2	0
fam10943	2	2	2	2.0	0.0	0.0	2	2	0
fam10944	2	2	2	2.0	0.0	0.0	2	2	0
fam10945	2	2	2	2.0	0.0	0.0	2	2	0
fam10946	2	2	2	2.0	0.0	0.0	2	2	0
fam10947	2	2	2	2.0	0.0	0.0	2	2	0
fam10948	2	2	2	2.0	0.0	0.0	2	2	0
fam10949	2	2	2	2.0	0.0	0.0	2	2	0
fam10950	2	2	2	2.0	0.0	0.0	2	2	0
fam10951	2	2	2	2.0	0.0	0.0	2	2	0
fam10952	2	2	2	2.0	0.0	0.0	2	2	0
fam10953	2	2	2	2.0	0.0	0.0	2	2	0
fam10954	2	2	2	2.0	0.0	0.0	2	2	0
fam10955	2	2	2	2.0	0.0	0.0	2	2	0
fam10956	2	2	2	2.0	0.0	0.0	2	2	0
fam10957	2	2	2	2.0	0.0	0.0	2	2	0
fam10958	2	2	2	2.0	0.0	0.0	2	2	0
fam10959	2	2	2	2.0	0.0	0.0	2	2	0
fam10960	2	2	2	2.0	0.0	0.0	2	2	0
fam10961	2	2	2	2.0	0.0	0.0	2	2	0
fam10962	2	2	2	2.0	0.0	0.0	2	2	0
fam10963	2	2	2	2.0	0.0	0.0	2	2	0
fam10964	2	2	2	2.0	0.0	0.0	2	2	0
fam10965	2	2	2	2.0	0.0	0.0	2	2	0
fam10966	2	2	2	2.0	0.0	0.0	2	2	0
fam10967	2	2	2	2.0	0.0	0.0	2	2	0
fam10968	2	2	2	2.0	0.0	0.0	2	2	0
fam10969	2	2	2	2.0	0.0	0.0	2	2	0
fam10970	2	2	2	2.0	0.0	0.0	2	2	0
fam10971	2	2	2	2.0	0.0	0.0	2	2	0
fam10972	2	2	2	2.0	0.0	0.0	2	2	0
fam10973	2	2	2	2.0	0.0	0.0	2	2	0
fam10974	2	2	2	2.0	0.0	0.0	2	2	0
fam10975	2	2	2	2.0	0.0	0.0	2	2	0
fam10976	2	2	2	2.0	0.0	0.0	2	2	0
fam10977	2	2	2	2.0	0.0	0.0	2	2	0
fam10978	2	2	2	2.0	0.0	0.0	2	2	0
fam10979	2	2	2	2.0	0.0	0.0	2	2	0
fam10980	2	2	2	2.0	0.0	0.0	2	2	0
fam10981	2	2	2	2.0	0.0	0.0	2	2	0
fam10982	2	2	2	2.0	0.0	0.0	2	2	0
fam10983	2	2	2	2.0	0.0	0.0	2	2	0
fam10984	2	2	2	2.0	0.0	0.0	2	2	0
fam10985	2	2	2	2.0	0.0	0.0	2	2	0
fam10986	2	2	2	2.0	0.0	0.0	2	2	0
fam10987	2	2	2	2.0	0.0	0.0	2	2	0
fam10988	2	2	2	2.0	0.0	0.0	2	2	0
fam10989	2	2	2	2.0	0.0	0.0	2	2	0
fam10990	2	2	2	2.0	0.0	0.0	2	2	0
fam10991	2	2	2	2.0	0.0	0.0	2	2	0
fam10992	2	2	2	2.0	0.0	0.0	2	2	0
fam10993	2	2	2	2.0	0.0	0.0	2	2	0
fam10994	2	2	2	2.0	0.0	0.0	2	2	0
fam10995	2	2	2	2.0	0.0	0.0	2	2	0
fam10996	2	2	2	2.0	0.0	0.0	2	2	0
fam10997	2	2	2	2.0	0.0	0.0	2	2	0
fam10998	2	2	2	2.0	0.0	0.0	2	2	0
fam10999	2	2	2	2.0	0.0	0.0	2	2	0
fam11000	2	2	2	2.0	0.0	0.0	2	2	0
fam11001	2	2	2	2.0	0.0	0.0	2	2	0
fam11002	2	2	2	2.0	0.0	0.0	2	2	0
fam11003	2	2	2	2.0	0.0	0.0	2	2	0
fam11004	2	2	2	2.0	0.0	0.0	2	2	0
fam11005	2	2	2	2.0	0.0	0.0	2	2	0
fam11006	2	2	2	2.0	0.0	0.0	2	2	0
fam11007	2	2	2	2.0	0.0	0.0	2	2	0
fam11008	2	2	2	2.0	0.0	0.0	2	2	0
fam11009	2	2	2	2.0	0.0	0.0	2	2	0
fam11010	2	2	2	2.0	0.0	0.0	2	2	0
fam11011	2	2	2	2.0	0.0	0.0	2	2	0
fam11012	2	2	2	2.0	0.0	0.0	2	2	0
fam11013	2	2	2	2.0	0.0	0.0	2	2	0
fam11014	2	2	2	2.0	0.0	0.0	2	2	0
fam11015	2	2	2	2.0	0.0	0.0	2	2	0
fam11016	2	2	2	2.0	0.0	0.0	2	2	0
fam11017	2	2	2	2.0	0.0	0.0	2	2	0
fam11018	2	2	2	2.0	0.0	0.0	2	2	0
fam11019	2	2	2	2.0	0.0	0.0	2	2	0
fam11020	2	2	2	2.0	0.0	0.0	2	2	0
fam11021	2	2	2	2.0	0.0	0.0	2	2	0
fam11022	2	2	2	2.0	0.0	0.0	2	2	0
fam11023	2	2	2	2.0	0.0	0.0	2	2	0
fam11024	2	2	2	2.0	0.0	0.0	2	2	0
fam11025	2	2	2	2.0	0.0	0.0	2	2	0
fam11026	2	2	2	2.0	0.0	0.0	2	2	0
fam11027	2	2	2	2.0	0.0	0.0	2	2	0
fam11028	2	2	2	2.0	0.0	0.0	2	2	0
fam11029	2	2	2	2.0	0.0	0.0	2	2	0
fam11030	2	2	2	2.0	0.0	0.0	2	2	0
fam11031	2	2	2	2.0	0.0	0.0	2	2	0
fam11032	2	2	2	2.0	0.0	0.0	2	2	0
fam11033	2	2	2	2.0	0.0	0.0	2	2	0
fam11034	2	2	2	2.0	0.0	0.0	2	2	0
fam11035	2	2	2	2.0	0.0	0.0	2	2	0
fam11036	2	2	2	2.0	0.0	0.0	2	2	0
fam11037	2	2	2	2.0	0.0	0.0	2	2	0
fam11038	2	2	2	2.0	0.0	0.0	2	2	0
fam11039	2	2	2	2.0	0.0	0.0	2	2	0
fam11040	2	2	2	2.0	0.0	0.0	2	2	0
fam11041	2	2	2	2.0	0.0	0.0	2	2	0
fam11042	2	2	2	2.0	0.0	0.0	2	2	0
fam11043	2	2	2	2.0	0.0	0.0	2	2	0
fam11044	2	2	2	2.0	0.0	0.0	2	2	0
fam11045	2	2	2	2.0	0.0	0.0	2	2	0
fam11046	2	2	2	2.0	0.0	0.0	2	2	0
fam11047	2	2	2	2.0	0.0	0.0	2	2	0
fam11048	2	2	2	2.0	0.0	0.0	2	2	0
fam11049	2	2	2	2.0	0.0	0.0	2	2	0
fam11050	2	2	2	2.0	0.0	0.0	2	2	0
fam11051	2	2	2	2.0	0.0	0.0	2	2	0
fam11052	2	2	2	2.0	0.0	0.0	2	2	0
fam11053	2	2	2	2.0	0.0	0.0	2	2	0
fam11054	2	2	2	2.0	0.0	0.0	2	2	0
fam11055	2	2	2	2.0	0.0	0.0	2	2	0
fam11056	2	2	2	2.0	0.0	0.0	2	2	0
fam11057	2	2	2	2.0	0.0	0.0	2	2	0
fam11058	2	2	2	2.0	0.0	0.0	2	2	0
fam11059	2	2	2	2.0	0.0	0.0	2	2	0
fam11060	2	2	2	2.0	0.0	0.0	2	2	0
fam11061	2	2	2	2.0	0.0	0.0	2	2	0
fam11062	2	2	2	2.0	0.0	0.0	2	2	0
fam11063	2	2	2	2.0	0.0	0.0	2	2	0
fam11064	2	2	2	2.0	0.0	0.0	2	2	0
fam11065	2	2	2	2.0	0.0	0.0	2	2	0
fam11066	2	2	2	2.0	0.0	0.0	2	2	0
fam11067	2	2	2	2.0	0.0	0.0	2	2	0
fam11068	2	2	2	2.0	0.0	0.0	2	2	0
fam11069	2	2	2	2.0	0.0	0.0	2	2	0
fam11070	2	2	2	2.0	0.0	0.0	2	2	0
fam11071	2	2	2	2.0	0.0	0.0	2	2	0
fam11072	2	2	2	2.0	0.0	0.0	2	2	0
fam11073	2	2	2	2.0	0.0	0.0	2	2	0
fam11074	2	2	2	2.0	0.0	0.0	2	2	0
fam11075	2	2	2	2.0	0.0	0.0	2	2	0
fam11076	2	2	2	2.0	0.0	0.0	2	2	0
fam11077	2	2	2	2.0	0.0	0.0	2	2	0
fam11078	2	2	2	2.0	0.0	0.0	2	2	0
fam11079	2	2	2	2.0	0.0	0.0	2	2	0
fam11080	2	2	2	2.0	0.0	0.0	2	2	0
fam11081	2	2	2	2.0	0.0	0.0	2	2	0
fam11082	2	2	2	2.0	0.0	0.0	2	2	0
fam11083	2	2	2	2.0	0.0	0.0	2	2	0
fam11084	2	2	2	2.0	0.0	0.0	2	2	0
fam11085	2	2	2	2.0	0.0	0.0	2	2	0
fam11086	2	2	2	2.0	0.0	0.0	2	2	0
fam11087	2	2	2	2.0	0.0	0.0	2	2	0
fam11088	2	2	2	2.0	0.0	0.0	2	2	0
fam11089	2	2	2	2.0	0.0	0.0	2	2	0
fam11090	2	2	2	2.0	0.0	0.0	2	2	0
fam11091	2	2	2	2.0	0.0	0.0	2	2	0
fam11092	2	2	2	2.0	0.0	0.0	2	2	0
fam11093	2	2	2	2.0	0.0	0.0	2	2	0
fam11094	2	2	2	2.0	0.0	0.0	2	2	0
fam11095	2	2	2	2.0	0.0	0.0	2	2	0
fam11096	2	2	2	2.0	0.0	0.0	2	2	0
fam11097	2	2	2	2.0	0.0	0.0	2	2	0
fam11098	2	2	2	2.0	0.0	0.0	2	2	0
fam11099	2	2	2	2.0	0.0	0.0	2	2	0
fam11100	2	2	2	2.0	0.0	0.0	2	2	0
fam11101	2	2	2	2.0	0.0	0.0	2	2	0
fam11102	2	2	2	2.0	0.0	0.0	2	2	0
fam11103	2	2	2	2.0	0.0	0.0	2	2	0
fam11104	2	2	2	2.0	0.0	0.0	2	2	0
fam11105	2	2	2	2.0	0.0	0.0	2	2	0
fam11106	2	2	2	2.0	0.0	0.0	2	2	0
fam11107	2	2	2	2.0	0.0	0.0	2	2	0
fam11108	2	2	2	2.0	0.0	0.0	2	2	0
fam11109	2	2	2	2.0	0.0	0.0	2	2	0
fam11110	2	2	2	2.0	0.0	0.0	2	2	0
fam11111	2	2	2	2.0	0.0	0.0	2	2	0
fam11112	2	2	2	2.0	0.0	0.0	2	2	0
fam11113	2	2	2	2.0	0.0	0.0	2	2	0
fam11114	2	2	2	2.0	0.0	0.0	2	2	0
fam11115	2	2	2	2.0	0.0	0.0	2	2	0
fam11116	2	2	2	2.0	0.0	0.0	2	2	0
fam11117	2	2	2	2.0	0.0	0.0	2	2	0
fam11118	2	2	2	2.0	0.0	0.0	2	2	0
fam11119	2	2	2	2.0	0.0	0.0	2	2	0
fam11120	2	2	2	2.0	0.0	0.0	2	2	0
fam11121	2	2	2	2.0	0.0	0.0	2	2	0
fam11122	2	2	2	2.0	0.0	0.0	2	2	0
fam11123	2	2	2	2.0	0.0	0.0	2	2	0
fam11124	2	2	2	2.0	0.0	0.0	2	2	0
fam11125	2	2	2	2.0	0.0	0.0	2	2	0
fam11126	2	2	2	2.0	0.0	0.0	2	2	0
fam11127	2	2	2	2.0	0.0	0.0	2	2	0
fam11128	2	2	2	2.0	0.0	0.0	2	2	0
fam11129	2	2	2	2.0	0.0	0.0	2	2	0
fam11130	2	2	2	2.0	0.0	0.0	2	2	0
fam11131	2	2	2	2.0	0.0	0.0	2	2	0
fam11132	2	2	2	2.0	0.0	0.0	2	2	0
fam11133	2	2	2	2.0	0.0	0.0	2	2	0
fam11134	2	2	2	2.0	0.0	0.0	2	2	0
fam11135	2	2	2	2.0	0.0	0.0	2	2	0
fam11136	2	2	2	2.0	0.0	0.0	2	2	0
fam11137	2	2	2	2.0	0.0	0.0	2	2	0
fam11138	2	2	2	2.0	0.0	0.0	2	2	0
fam11139	2	2	2	2.0	0.0	0.0	2	2	0
fam11140	2	2	2	2.0	0.0	0.0	2	2	0
fam11141	2	2	2	2.0	0.0	0.0	2	2	0
fam11142	2	2	2	2.0	0.0	0.0	2	2	0
fam11143	2	2	2	2.0	0.0	0.0	2	2	0
fam11144	2	2	2	2.0	0.0	0.0	2	2	0
fam11145	2	2	2	2.0	0.0	0.0	2	2	0
fam11146	2	2	2	2.0	0.0	0.0	2	2	0
fam11147	2	2	2	2.0	0.0	0.0	2	2	0
fam11148	2	2	2	2.0	0.0	0.0	2	2	0
fam11149	2	2	2	2.0	0.0	0.0	2	2	0
fam11150	2	2	2	2.0	0.0	0.0	2	2	0
fam11151	2	2	2	2.0	0.0	0.0	2	2	0
fam11152	2	2	2	2.0	0.0	0.0	2	2	0
fam11153	2	2	2	2.0	0.0	0.0	2	2	0
fam11154	2	2	2	2.0	0.0	0.0	2	2	0
fam11155	2	2	2	2.0	0.0	0.0	2	2	0
fam11156	2	2	2	2.0	0.0	0.0	2	2	0
fam11157	2	2	2	2.0	0.0	0.0	2	2	0
fam11158	2	2	2	2.0	0.0	0.0	2	2	0
fam11159	2	2	2	2.0	0.0	0.0	2	2	0
fam11160	2	2	2	2.0	0.0	0.0	2	2	0
fam11161	2	2	2	2.0	0.0	0.0	2	2	0
fam11162	2	2	2	2.0	0.0	0.0	2	2	0
fam11163	2	2	2	2.0	0.0	0.0	2	2	0
fam11164	2	2	2	2.0	0.0	0.0	2	2	0
fam11165	2	2	2	2.0	0.0	0.0	2	2	0
fam11166	2	2	2	2.0	0.0	0.0	2	2	0
fam11167	2	2	2	2.0	0.0	0.0	2	2	0
fam11168	2	2	2	2.0	0.0	0.0	2	2	0
fam11169	2	2	2	2.0	0.0	0.0	2	2	0
fam11170	2	2	2	2.0	0.0	0.0	2	2	0
fam11171	2	2	2	2.0	0.0	0.0	2	2	0
fam11172	2	2	2	2.0	0.0	0.0	2	2	0
fam11173	2	2	2	2.0	0.0	0.0	2	2	0
fam11174	2	2	2	2.0	0.0	0.0	2	2	0
fam11175	2	2	2	2.0	0.0	0.0	2	2	0
fam11176	2	2	2	2.0	0.0	0.0	2	2	0
fam11177	2	2	2	2.0	0.0	0.0	2	2	0
fam11178	2	2	2	2.0	0.0	0.0	2	2	0
fam11179	2	2	2	2.0	0.0	0.0	2	2	0
fam11180	2	2	2	2.0	0.0	0.0	2	2	0
fam11181	2	2	2	2.0	0.0	0.0	2	2	0
fam11182	2	2	2	2.0	0.0	0.0	2	2	0
fam11183	2	2	2	2.0	0.0	0.0	2	2	0
fam11184	2	2	2	2.0	0.0	0.0	2	2	0
fam11185	2	2	2	2.0	0.0	0.0	2	2	0
fam11186	2	2	2	2.0	0.0	0.0	2	2	0
fam11187	2	2	2	2.0	0.0	0.0	2	2	0
fam11188	2	2	2	2.0	0.0	0.0	2	2	0
fam11189	2	2	2	2.0	0.0	0.0	2	2	0
fam11190	2	2	2	2.0	0.0	0.0	2	2	0
fam11191	2	2	2	2.0	0.0	0.0	2	2	0
fam11192	2	2	2	2.0	0.0	0.0	2	2	0
fam11193	2	2	2	2.0	0.0	0.0	2	2	0
fam11194	2	2	2	2.0	0.0	0.0	2	2	0
fam11195	2	2	2	2.0	0.0	0.0	2	2	0
fam11196	2	2	2	2.0	0.0	0.0	2	2	0
fam11197	2	2	2	2.0	0.0	0.0	2	2	0
fam11198	2	2	2	2.0	0.0	0.0	2	2	0
fam11199	2	2	2	2.0	0.0	0.0	2	2	0
fam11200	2	2	2	2.0	0.0	0.0	2	2	0
fam11201	2	2	2	2.0	0.0	0.0	2	2	0
fam11202	2	2	2	2.0	0.0	0.0	2	2	0
fam11203	2	2	2	2.0	0.0	0.0	2	2	0
fam11204	2	2	2	2.0	0.0	0.0	2	2	0
fam11205	2	2	2	2.0	0.0	0.0	2	2	0
fam11206	2	2	2	2.0	0.0	0.0	2	2	0
fam11207	2	2	2	2.0	0.0	0.0	2	2	0
fam11208	2	2	2	2.0	0.0	0.0	2	2	0
fam11209	2	2	2	2.0	0.0	0.0	2	2	0
fam11210	2	2	2	2.0	0.0	0.0	2	2	0
fam11211	2	2	2	2.0	0.0	0.0	2	2	0
fam11212	2	2	2	2.0	0.0	0.0	2	2	0
fam11213	2	2	2	2.0	0.0	0.0	2	2	0
fam11214	2	2	2	2.0	0.0	0.0	2	2	0
fam11215	2	2	2	2.0	0.0	0.0	2	2	0
fam11216	2	2	2	2.0	0.0	0.0	2	2	0
fam11217	2	2	2	2.0	0.0	0.0	2	2	0
fam11218	2	2	2	2.0	0.0	0.0	2	2	0
fam11219	2	2	2	2.0	0.0	0.0	2	2	0
fam11220	2	2	2	2.0	0.0	0.0	2	2	0
fam11221	2	2	2	2.0	0.0	0.0	2	2	0
fam11222	2	2	2	2.0	0.0	0.0	2	2	0
fam11223	2	2	2	2.0	0.0	0.0	2	2	0
fam11224	2	2	2	2.0	0.0	0.0	2	2	0
fam11225	2	2	2	2.0	0.0	0.0	2	2	0
fam11226	2	2	2	2.0	0.0	0.0	2	2	0
fam11227	2	2	2	2.0	0.0	0.0	2	2	0
fam11228	2	2	2	2.0	0.0	0.0	2	2	0
fam11229	2	2	2	2.0	0.0	0.0	2	2	0
fam11230	2	2	2	2.0	0.0	0.0	2	2	0
fam11231	2	2	2	2.0	0.0	0.0	2	2	0
fam11232	2	2	2	2.0	0.0	0.0	2	2	0
fam11233	2	2	2	2.0	0.0	0.0	2	2	0
fam11234	2	2	2	2.0	0.0	0.0	2	2	0
fam11235	2	2	2	2.0	0.0	0.0	2	2	0
fam11236	2	2	2	2.0	0.0	0.0	2	2	0
fam11237	2	2	2	2.0	0.0	0.0	2	2	0
fam11238	2	2	2	2.0	0.0	0.0	2	2	0
fam11239	2	2	2	2.0	0.0	0.0	2	2	0
fam11240	2	2	2	2.0	0.0	0.0	2	2	0
fam11241	2	2	2	2.0	0.0	0.0	2	2	0
fam11242	2	2	2	2.0	0.0	0.0	2	2	0
fam11243	2	2	2	2.0	0.0	0.0	2	2	0
fam11244	2	2	2	2.0	0.0	0.0	2	2	0
fam11245	2	2	2	2.0	0.0	0.0	2	2	0
fam11246	2	2	2	2.0	0.0	0.0	2	2	0
fam11247	2	2	2	2.0	0.0	0.0	2	2	0
fam11248	2	2	2	2.0	0.0	0.0	2	2	0
fam11249	2	2	2	2.0	0.0	0.0	2	2	0
fam11250	2	2	2	2.0	0.0	0.0	2	2	0
fam11251	2	2	2	2.0	0.0	0.0	2	2	0
fam11252	2	2	2	2.0	0.0	0.0	2	2	0
fam11253	2	2	2	2.0	0.0	0.0	2	2	0
fam11254	2	2	2	2.0	0.0	0.0	2	2	0
fam11255	2	2	2	2.0	0.0	0.0	2	2	0
fam11256	2	2	2	2.0	0.0	0.0	2	2	0
fam11257	2	2	2	2.0	0.0	0.0	2	2	0
fam11258	2	2	2	2.0	0.0	0.0	2	2	0
fam11259	2	2	2	2.0	0.0	0.0	2	2	0
fam11260	2	2	2	2.0	0.0	0.0	2	2	0
fam11261	2	2	2	2.0	0.0	0.0	2	2	0
fam11262	2	2	2	2.0	0.0	0.0	2	2	0
fam11263	2	2	2	2.0	0.0	0.0	2	2	0
fam11264	2	2	2	2.0	0.0	0.0	2	2	0
fam11265	2	2	2	2.0	0.0	0.0	2	2	0
fam11266	2	2	2	2.0	0.0	0.0	2	2	0
fam11267	2	2	2	2.0	0.0	0.0	2	2	0
fam11268	2	2	2	2.0	0.0	0.0	2	2	0
fam11269	2	2	2	2.0	0.0	0.0	2	2	0
fam11270	2	2	2	2.0	0.0	0.0	2	2	0
fam11271	2	2	2	2.0	0.0	0.0	2	2	0
fam11272	2	2	2	2.0	0.0	0.0	2	2	0
fam11273	2	2	2	2.0	0.0	0.0	2	2	0
fam11274	2	2	2	2.0	0.0	0.0	2	2	0
fam11275	2	2	2	2.0	0.0	0.0	2	2	0
fam11276	2	2	2	2.0	0.0	0.0	2	2	0
fam11277	2	2	2	2.0	0.0	0.0	2	2	0
fam11278	2	2	2	2.0	0.0	0.0	2	2	0
fam11279	2	2	2	2.0	0.0	0.0	2	2	0
fam11280	2	2	2	2.0	0.0	0.0	2	2	0
fam11281	2	2	2	2.0	0.0	0.0	2	2	0
fam11282	2	2	2	2.0	0.0	0.0	2	2	0
fam11283	2	2	2	2.0	0.0	0.0	2	2	0
fam11284	2	2	2	2.0	0.0	0.0	2	2	0
fam11285	2	2	2	2.0	0.0	0.0	2	2	0
fam11286	2	2	2	2.0	0.0	0.0	2	2	0
fam11287	2	2	2	2.0	0.0	0.0	2	2	0
fam11288	2	2	2	2.0	0.0	0.0	2	2	0
fam11289	2	2	2	2.0	0.0	0.0	2	2	0
fam11290	2	2	2	2.0	0.0	0.0	2	2	0
fam11291	2	2	2	2.0	0.0	0.0	2	2	0
fam11292	2	2	2	2.0	0.0	0.0	2	2	0
fam11293	2	2	2	2.0	0.0	0.0	2	2	0
fam11294	2	2	2	2.0	0.0	0.0	2	2	0
fam11295	2	2	2	2.0	0.0	0.0	2	2	0
fam11296	2	2	2	2.0	0.0	0.0	2	2	0
fam11297	2	2	2	2.0	0.0	0.0	2	2	0
fam11298	2	2	2	2.0	0.0	0.0	2	2	0
fam11299	2	2	2	2.0	0.0	0.0	2	2	0
fam11300	2	2	2	2.0	0.0	0.0	2	2	0
fam11301	2	2	2	2.0	0.0	0.0	2	2	0
fam11302	2	2	2	2.0	0.0	0.0	2	2	0
fam11303	2	2	2	2.0	0.0	0.0	2	2	0
fam11304	2	2	2	2.0	0.0	0.0	2	2	0
fam11305	2	2	2	2.0	0.0	0.0	2	2	0
fam11306	2	2	2	2.0	0.0	0.0	2	2	0
fam11307	2	2	2	2.0	0.0	0.0	2	2	0
fam11308	2	2	2	2.0	0.0	0.0	2	2	0
fam11309	2	2	2	2.0	0.0	0.0	2	2	0
fam11310	2	2	2	2.0	0.0	0.0	2	2	0
fam11311	2	2	2	2.0	0.0	0.0	2	2	0
fam11312	2	2	2	2.0	0.0	0.0	2	2	0
fam11313	2	2	2	2.0	0.0	0.0	2	2	0
fam11314	2	2	2	2.0	0.0	0.0	2	2	0
fam11315	2	2	2	2.0	0.0	0.0	2	2	0
fam11316	2	2	2	2.0	0.0	0.0	2	2	0
fam11317	2	2	2	2.0	0.0	0.0	2	2	0
fam11318	2	2	2	2.0	0.0	0.0	2	2	0
fam11319	2	2	2	2.0	0.0	0.0	2	2	0
fam11320	2	2	2	2.0	0.0	0.0	2	2	0
fam11321	2	2	2	2.0	0.0	0.0	2	2	0
fam11322	2	2	2	2.0	0.0	0.0	2	2	0
fam11323	2	2	2	2.0	0.0	0.0	2	2	0
fam11324	2	2	2	2.0	0.0	0.0	2	2	0
fam11325	2	2	2	2.0	0.0	0.0	2	2	0
fam11326	2	2	2	2.0	0.0	0.0	2	2	0
fam11327	2	2	2	2.0	0.0	0.0	2	2	0
fam11328	2	2	2	2.0	0.0	0.0	2	2	0
fam11329	2	2	2	2.0	0.0	0.0	2	2	0
fam11330	2	2	2	2.0	0.0	0.0	2	2	0
fam11331	2	2	2	2.0	0.0	0.0	2	2	0
fam11332	2	2	2	2.0	0.0	0.0	2	2	0
fam11333	2	2	2	2.0	0.0	0.0	2	2	0
fam11334	2	2	2	2.0	0.0	0.0	2	2	0
fam11335	2	2	2	2.0	0.0	0.0	2	2	0
fam11336	2	2	2	2.0	0.0	0.0	2	2	0
fam11337	2	2	2	2.0	0.0	0.0	2	2	0
fam11338	2	2	2	2.0	0.0	0.0	2	2	0
fam11339	2	2	2	2.0	0.0	0.0	2	2	0
fam11340	2	2	2	2.0	0.0	0.0	2	2	0
fam11341	2	2	2	2.0	0.0	0.0	2	2	0
fam11342	2	2	2	2.0	0.0	0.0	2	2	0
fam11343	2	2	2	2.0	0.0	0.0	2	2	0
fam11344	2	2	2	2.0	0.0	0.0	2	2	0
fam11345	2	2	2	2.0	0.0	0.0	2	2	0
fam11346	2	2	2	2.0	0.0	0.0	2	2	0
fam11347	2	2	2	2.0	0.0	0.0	2	2	0
fam11348	2	2	2	2.0	0.0	0.0	2	2	0
fam11349	2	2	2	2.0	0.0	0.0	2	2	0
fam11350	2	2	2	2.0	0.0	0.0	2	2	0
fam11351	2	2	2	2.0	0.0	0.0	2	2	0
fam11352	2	2	2	2.0	0.0	0.0	2	2	0
fam11353	2	2	2	2.0	0.0	0.0	2	2	0
fam11354	2	2	2	2.0	0.0	0.0	2	2	0
fam11355	2	2	2	2.0	0.0	0.0	2	2	0
fam11356	2	2	2	2.0	0.0	0.0	2	2	0
fam11357	2	2	2	2.0	0.0	0.0	2	2	0
fam11358	2	2	2	2.0	0.0	0.0	2	2	0
fam11359	2	2	2	2.0	0.0	0.0	2	2	0
fam11360	2	2	2	2.0	0.0	0.0	2	2	0
fam11361	2	2	2	2.0	0.0	0.0	2	2	0
fam11362	2	2	2	2.0	0.0	0.0	2	2	0
fam11363	2	2	2	2.0	0.0	0.0	2	2	0
fam11364	2	2	2	2.0	0.0	0.0	2	2	0
fam11365	2	2	2	2.0	0.0	0.0	2	2	0
fam11366	2	2	2	2.0	0.0	0.0	2	2	0
fam11367	2	2	2	2.0	0.0	0.0	2	2	0
fam11368	2	2	2	2.0	0.0	0.0	2	2	0
fam11369	2	2	2	2.0	0.0	0.0	2	2	0
fam11370	2	2	2	2.0	0.0	0.0	2	2	0
fam11371	2	2	2	2.0	0.0	0.0	2	2	0
fam11372	2	2	2	2.0	0.0	0.0	2	2	0
fam11373	2	2	2	2.0	0.0	0.0	2	2	0
fam11374	2	2	2	2.0	0.0	0.0	2	2	0
fam11375	2	2	2	2.0	0.0	0.0	2	2	0
fam11376	2	2	2	2.0	0.0	0.0	2	2	0
fam11377	2	2	2	2.0	0.0	0.0	2	2	0
fam11378	2	2	2	2.0	0.0	0.0	2	2	0
fam11379	2	2	2	2.0	0.0	0.0	2	2	0
fam11380	2	2	2	2.0	0.0	0.0	2	2	0
fam11381	2	2	2	2.0	0.0	0.0	2	2	0
fam11382	2	2	2	2.0	0.0	0.0	2	2	0
fam11383	2	2	2	2.0	0.0	0.0	2	2	0
fam11384	2	2	2	2.0	0.0	0.0	2	2	0
fam11385	2	2	2	2.0	0.0	0.0	2	2	0
fam11386	2	2	2	2.0	0.0	0.0	2	2	0
fam11387	2	2	2	2.0	0.0	0.0	2	2	0
fam11388	2	2	2	2.0	0.0	0.0	2	2	0
fam11389	2	2	2	2.0	0.0	0.0	2	2	0
fam11390	2	2	2	2.0	0.0	0.0	2	2	0
fam11391	2	2	2	2.0	0.0	0.0	2	2	0
fam11392	2	2	2	2.0	0.0	0.0	2	2	0
fam11393	2	2	2	2.0	0.0	0.0	2	2	0
fam11394	2	2	2	2.0	0.0	0.0	2	2	0
fam11395	2	2	2	2.0	0.0	0.0	2	2	0
fam11396	2	2	2	2.0	0.0	0.0	2	2	0
fam11397	2	2	2	2.0	0.0	0.0	2	2	0
fam11398	2	2	2	2.0	0.0	0.0	2	2	0
fam11399	2	2	2	2.0	0.0	0.0	2	2	0
fam11400	2	2	2	2.0	0.0	0.0	2	2	0
fam11401	2	2	2	2.0	0.0	0.0	2	2	0
fam11402	2	2	2	2.0	0.0	0.0	2	2	0
fam11403	2	2	2	2.0	0.0	0.0	2	2	0
fam11404	2	2	2	2.0	0.0	0.0	2	2	0
fam11405	2	2	2	2.0	0.0	0.0	2	2	0
fam11406	2	2	2	2.0	0.0	0.0	2	2	0
fam11407	2	2	2	2.0	0.0	0.0	2	2	0
fam11408	2	2	2	2.0	0.0	0.0	2	2	0
fam11409	2	2	2	2.0	0.0	0.0	2	2	0
fam11410	2	2	2	2.0	0.0	0.0	2	2	0
fam11411	2	2	2	2.0	0.0	0.0	2	2	0
fam11412	2	2	2	2.0	0.0	0.0	2	2	0
fam11413	2	2	2	2.0	0.0	0.0	2	2	0
fam11414	2	2	2	2.0	0.0	0.0	2	2	0
fam11415	2	2	2	2.0	0.0	0.0	2	2	0
fam11416	2	2	2	2.0	0.0	0.0	2	2	0
fam11417	2	2	2	2.0	0.0	0.0	2	2	0
fam11418	2	2	2	2.0	0.0	0.0	2	2	0
fam11419	2	2	2	2.0	0.0	0.0	2	2	0
fam11420	2	2	2	2.0	0.0	0.0	2	2	0
fam11421	2	2	2	2.0	0.0	0.0	2	2	0
fam11422	2	2	2	2.0	0.0	0.0	2	2	0
fam11423	2	2	2	2.0	0.0	0.0	2	2	0
fam11424	2	2	2	2.0	0.0	0.0	2	2	0
fam11425	2	2	2	2.0	0.0	0.0	2	2	0
fam11426	2	2	2	2.0	0.0	0.0	2	2	0
fam11427	2	2	2	2.0	0.0	0.0	2	2	0
fam11428	2	2	2	2.0	0.0	0.0	2	2	0
fam11429	2	2	2	2.0	0.0	0.0	2	2	0
fam11430	2	2	2	2.0	0.0	0.0	2	2	0
fam11431	2	2	2	2.0	0.0	0.0	2	2	0
fam11432	2	2	2	2.0	0.0	0.0	2	2	0
fam11433	2	2	2	2.0	0.0	0.0	2	2	0
fam11434	2	2	2	2.0	0.0	0.0	2	2	0
fam11435	2	2	2	2.0	0.0	0.0	2	2	0
fam11436	2	2	2	2.0	0.0	0.0	2	2	0
fam11437	2	2	2	2.0	0.0	0.0	2	2	0
fam11438	2	2	2	2.0	0.0	0.0	2	2	0
fam11439	2	2	2	2.0	0.0	0.0	2	2	0
fam11440	2	2	2	2.0	0.0	0.0	2	2	0
fam11441	2	2	2	2.0	0.0	0.0	2	2	0
fam11442	2	2	2	2.0	0.0	0.0	2	2	0
fam11443	2	2	2	2.0	0.0	0.0	2	2	0
fam11444	2	2	2	2.0	0.0	0.0	2	2	0
fam11445	2	2	2	2.0	0.0	0.0	2	2	0
fam11446	2	2	2	2.0	0.0	0.0	2	2	0
fam11447	2	2	2	2.0	0.0	0.0	2	2	0
fam11448	2	2	2	2.0	0.0	0.0	2	2	0
fam11449	2	2	2	2.0	0.0	0.0	2	2	0
fam11450	2	2	2	2.0	0.0	0.0	2	2	0
fam11451	2	2	2	2.0	0.0	0.0	2	2	0
fam11452	2	2	2	2.0	0.0	0.0	2	2	0
fam11453	2	2	2	2.0	0.0	0.0	2	2	0
fam11454	2	2	2	2.0	0.0	0.0	2	2	0
fam11455	2	2	2	2.0	0.0	0.0	2	2	0
fam11456	2	2	2	2.0	0.0	0.0	2	2	0
fam11457	2	2	2	2.0	0.0	0.0	2	2	0
fam11458	2	2	2	2.0	0.0	0.0	2	2	0
fam11459	2	2	2	2.0	0.0	0.0	2	2	0
fam11460	2	2	2	2.0	0.0	0.0	2	2	0
fam11461	2	2	2	2.0	0.0	0.0	2	2	0
fam11462	2	2	2	2.0	0.0	0.0	2	2	0
fam11463	2	2	2	2.0	0.0	0.0	2	2	0
fam11464	2	2	2	2.0	0.0	0.0	2	2	0
fam11465	2	2	2	2.0	0.0	0.0	2	2	0
fam11466	2	2	2	2.0	0.0	0.0	2	2	0
fam11467	2	2	2	2.0	0.0	0.0	2	2	0
fam11468	2	2	2	2.0	0.0	0.0	2	2	0
fam11469	2	2	2	2.0	0.0	0.0	2	2	0
fam11470	2	2	2	2.0	0.0	0.0	2	2	0
fam11471	2	2	2	2.0	0.0	0.0	2	2	0
fam11472	2	2	2	2.0	0.0	0.0	2	2	0
fam11473	2	2	2	2.0	0.0	0.0	2	2	0
fam11474	2	2	2	2.0	0.0	0.0	2	2	0
fam11475	2	2	2	2.0	0.0	0.0	2	2	0
fam11476	2	2	2	2.0	0.0	0.0	2	2	0
fam11477	2	2	2	2.0	0.0	0.0	2	2	0
fam11478	2	2	2	2.0	0.0	0.0	2	2	0
fam11479	2	2	2	2.0	0.0	0.0	2	2	0
fam11480	2	2	2	2.0	0.0	0.0	2	2	0
fam11481	2	2	2	2.0	0.0	0.0	2	2	0
fam11482	2	2	2	2.0	0.0	0.0	2	2	0
fam11483	2	2	2	2.0	0.0	0.0	2	2	0
fam11484	2	2	2	2.0	0.0	0.0	2	2	0
fam11485	2	2	2	2.0	0.0	0.0	2	2	0
fam11486	2	2	2	2.0	0.0	0.0	2	2	0
fam11487	2	2	2	2.0	0.0	0.0	2	2	0
fam11488	2	2	2	2.0	0.0	0.0	2	2	0
fam11489	2	2	2	2.0	0.0	0.0	2	2	0
fam11490	2	2	2	2.0	0.0	0.0	2	2	0
fam11491	2	2	2	2.0	0.0	0.0	2	2	0
fam11492	2	2	2	2.0	0.0	0.0	2	2	0
fam11493	2	2	2	2.0	0.0	0.0	2	2	0
fam11494	2	2	2	2.0	0.0	0.0	2	2	0
fam11495	2	2	2	2.0	0.0	0.0	2	2	0
fam11496	2	2	2	2.0	0.0	0.0	2	2	0
fam11497	2	2	2	2.0	0.0	0.0	2	2	0
fam11498	2	2	2	2.0	0.0	0.0	2	2	0
fam11499	2	2	2	2.0	0.0	0.0	2	2	0
fam11500	2	2	2	2.0	0.0	0.0	2	2	0
fam11501	2	2	2	2.0	0.0	0.0	2	2	0
fam11502	2	2	2	2.0	0.0	0.0	2	2	0
fam11503	2	2	2	2.0	0.0	0.0	2	2	0
fam11504	2	2	2	2.0	0.0	0.0	2	2	0
fam11505	2	2	2	2.0	0.0	0.0	2	2	0
fam11506	2	2	2	2.0	0.0	0.0	2	2	0
fam11507	2	2	2	2.0	0.0	0.0	2	2	0
fam11508	2	2	2	2.0	0.0	0.0	2	2	0
fam11509	2	2	2	2.0	0.0	0.0	2	2	0
fam11510	2	2	2	2.0	0.0	0.0	2	2	0
fam11511	2	2	2	2.0	0.0	0.0	2	2	0
fam11512	2	2	2	2.0	0.0	0.0	2	2	0
fam11513	2	2	2	2.0	0.0	0.0	2	2	0
fam11514	2	2	2	2.0	0.0	0.0	2	2	0
fam11515	2	2	2	2.0	0.0	0.0	2	2	0
fam11516	2	2	2	2.0	0.0	0.0	2	2	0
fam11517	2	2	2	2.0	0.0	0.0	2	2	0
fam11518	2	2	2	2.0	0.0	0.0	2	2	0
fam11519	2	2	2	2.0	0.0	0.0	2	2	0
fam11520	2	2	2	2.0	0.0	0.0	2	2	0
fam11521	2	2	2	2.0	0.0	0.0	2	2	0
fam11522	2	2	2	2.0	0.0	0.0	2	2	0
fam11523	2	2	2	2.0	0.0	0.0	2	2	0
fam11524	2	2	2	2.0	0.0	0.0	2	2	0
fam11525	2	2	2	2.0	0.0	0.0	2	2	0
fam11526	2	2	2	2.0	0.0	0.0	2	2	0
fam11527	2	2	2	2.0	0.0	0.0	2	2	0
fam11528	2	2	2	2.0	0.0	0.0	2	2	0
fam11529	2	2	2	2.0	0.0	0.0	2	2	0
fam11530	2	2	2	2.0	0.0	0.0	2	2	0
fam11531	2	2	2	2.0	0.0	0.0	2	2	0
fam11532	2	2	2	2.0	0.0	0.0	2	2	0
fam11533	2	2	2	2.0	0.0	0.0	2	2	0
fam11534	2	2	2	2.0	0.0	0.0	2	2	0
fam11535	2	2	2	2.0	0.0	0.0	2	2	0
fam11536	2	2	2	2.0	0.0	0.0	2	2	0
fam11537	2	2	2	2.0	0.0	0.0	2	2	0
fam11538	2	2	2	2.0	0.0	0.0	2	2	0
fam11539	2	2	2	2.0	0.0	0.0	2	2	0
fam11540	2	2	2	2.0	0.0	0.0	2	2	0
fam11541	2	2	2	2.0	0.0	0.0	2	2	0
fam11542	2	2	2	2.0	0.0	0.0	2	2	0
fam11543	2	2	2	2.0	0.0	0.0	2	2	0
fam11544	2	2	2	2.0	0.0	0.0	2	2	0
fam11545	2	2	2	2.0	0.0	0.0	2	2	0
fam11546	2	2	2	2.0	0.0	0.0	2	2	0
fam11547	2	2	2	2.0	0.0	0.0	2	2	0
fam11548	2	2	2	2.0	0.0	0.0	2	2	0
fam11549	2	2	2	2.0	0.0	0.0	2	2	0
fam11550	2	2	2	2.0	0.0	0.0	2	2	0
fam11551	2	2	2	2.0	0.0	0.0	2	2	0
fam11552	2	2	2	2.0	0.0	0.0	2	2	0
fam11553	2	2	2	2.0	0.0	0.0	2	2	0
fam11554	2	2	2	2.0	0.0	0.0	2	2	0
fam11555	2	2	2	2.0	0.0	0.0	2	2	0
fam11556	2	2	2	2.0	0.0	0.0	2	2	0
fam11557	2	2	2	2.0	0.0	0.0	2	2	0
fam11558	2	2	2	2.0	0.0	0.0	2	2	0
fam11559	2	2	2	2.0	0.0	0.0	2	2	0
fam11560	2	2	2	2.0	0.0	0.0	2	2	0
fam11561	2	2	2	2.0	0.0	0.0	2	2	0
fam11562	2	2	2	2.0	0.0	0.0	2	2	0
fam11563	2	2	2	2.0	0.0	0.0	2	2	0
fam11564	2	2	2	2.0	0.0	0.0	2	2	0
fam11565	2	2	2	2.0	0.0	0.0	2	2	0
fam11566	2	2	2	2.0	0.0	0.0	2	2	0
fam11567	2	2	2	2.0	0.0	0.0	2	2	0
fam11568	2	2	2	2.0	0.0	0.0	2	2	0
fam11569	2	2	2	2.0	0.0	0.0	2	2	0
fam11570	2	2	2	2.0	0.0	0.0	2	2	0
fam11571	2	2	2	2.0	0.0	0.0	2	2	0
fam11572	2	2	2	2.0	0.0	0.0	2	2	0
fam11573	2	2	2	2.0	0.0	0.0	2	2	0
fam11574	2	2	2	2.0	0.0	0.0	2	2	0
fam11575	2	2	2	2.0	0.0	0.0	2	2	0
fam11576	2	2	2	2.0	0.0	0.0	2	2	0
fam11577	2	2	2	2.0	0.0	0.0	2	2	0
fam11578	2	2	2	2.0	0.0	0.0	2	2	0
fam11579	2	2	2	2.0	0.0	0.0	2	2	0
fam11580	2	2	2	2.0	0.0	0.0	2	2	0
fam11581	2	2	2	2.0	0.0	0.0	2	2	0
fam11582	2	2	2	2.0	0.0	0.0	2	2	0
fam11583	2	2	2	2.0	0.0	0.0	2	2	0
fam11584	2	2	2	2.0	0.0	0.0	2	2	0
fam11585	2	2	2	2.0	0.0	0.0	2	2	0
fam11586	2	2	2	2.0	0.0	0.0	2	2	0
fam11587	2	2	2	2.0	0.0	0.0	2	2	0
fam11588	2	2	2	2.0	0.0	0.0	2	2	0
fam11589	2	2	2	2.0	0.0	0.0	2	2	0
fam11590	2	2	2	2.0	0.0	0.0	2	2	0
fam11591	2	2	2	2.0	0.0	0.0	2	2	0
fam11592	2	2	2	2.0	0.0	0.0	2	2	0
fam11593	2	2	2	2.0	0.0	0.0	2	2	0
fam11594	2	2	2	2.0	0.0	0.0	2	2	0
fam11595	2	2	2	2.0	0.0	0.0	2	2	0
fam11596	2	2	2	2.0	0.0	0.0	2	2	0
fam11597	2	2	2	2.0	0.0	0.0	2	2	0
fam11598	2	2	2	2.0	0.0	0.0	2	2	0
fam11599	2	2	2	2.0	0.0	0.0	2	2	0
fam11600	2	2	2	2.0	0.0	0.0	2	2	0
fam11601	2	2	2	2.0	0.0	0.0	2	2	0
fam11602	2	2	2	2.0	0.0	0.0	2	2	0
fam11603	2	2	2	2.0	0.0	0.0	2	2	0
fam11604	2	2	2	2.0	0.0	0.0	2	2	0
fam11605	2	2	2	2.0	0.0	0.0	2	2	0
fam11606	2	2	2	2.0	0.0	0.0	2	2	0
fam11607	2	2	2	2.0	0.0	0.0	2	2	0
fam11608	2	2	2	2.0	0.0	0.0	2	2	0
fam11609	2	2	2	2.0	0.0	0.0	2	2	0
fam11610	2	2	2	2.0	0.0	0.0	2	2	0
fam11611	2	2	2	2.0	0.0	0.0	2	2	0
fam11612	2	2	2	2.0	0.0	0.0	2	2	0
fam11613	2	2	2	2.0	0.0	0.0	2	2	0
fam11614	2	2	2	2.0	0.0	0.0	2	2	0
fam11615	2	2	2	2.0	0.0	0.0	2	2	0
fam11616	2	2	2	2.0	0.0	0.0	2	2	0
fam11617	2	2	2	2.0	0.0	0.0	2	2	0
fam11618	2	2	2	2.0	0.0	0.0	2	2	0
fam11619	2	2	2	2.0	0.0	0.0	2	2	0
fam11620	2	2	2	2.0	0.0	0.0	2	2	0
fam11621	2	2	2	2.0	0.0	0.0	2	2	0
fam11622	2	2	2	2.0	0.0	0.0	2	2	0
fam11623	2	2	2	2.0	0.0	0.0	2	2	0
fam11624	2	2	2	2.0	0.0	0.0	2	2	0
fam11625	2	2	2	2.0	0.0	0.0	2	2	0
fam11626	2	2	2	2.0	0.0	0.0	2	2	0
fam11627	2	2	2	2.0	0.0	0.0	2	2	0
fam11628	2	2	2	2.0	0.0	0.0	2	2	0
fam11629	2	2	2	2.0	0.0	0.0	2	2	0
fam11630	2	2	2	2.0	0.0	0.0	2	2	0
fam11631	2	2	2	2.0	0.0	0.0	2	2	0
fam11632	2	2	2	2.0	0.0	0.0	2	2	0
fam11633	2	2	2	2.0	0.0	0.0	2	2	0
fam11634	2	2	2	2.0	0.0	0.0	2	2	0
fam11635	2	2	2	2.0	0.0	0.0	2	2	0
fam11636	2	2	2	2.0	0.0	0.0	2	2	0
fam11637	2	2	2	2.0	0.0	0.0	2	2	0
fam11638	2	2	2	2.0	0.0	0.0	2	2	0
fam11639	2	2	2	2.0	0.0	0.0	2	2	0
fam11640	2	2	2	2.0	0.0	0.0	2	2	0
fam11641	2	2	2	2.0	0.0	0.0	2	2	0
fam11642	2	2	2	2.0	0.0	0.0	2	2	0
fam11643	2	2	2	2.0	0.0	0.0	2	2	0
fam11644	2	2	2	2.0	0.0	0.0	2	2	0
fam11645	2	2	2	2.0	0.0	0.0	2	2	0
fam11646	2	2	2	2.0	0.0	0.0	2	2	0
fam11647	2	2	2	2.0	0.0	0.0	2	2	0
fam11648	2	2	2	2.0	0.0	0.0	2	2	0
fam11649	2	2	2	2.0	0.0	0.0	2	2	0
fam11650	2	2	2	2.0	0.0	0.0	2	2	0
fam11651	2	2	2	2.0	0.0	0.0	2	2	0
fam11652	2	2	2	2.0	0.0	0.0	2	2	0
fam11653	2	2	2	2.0	0.0	0.0	2	2	0
fam11654	2	2	2	2.0	0.0	0.0	2	2	0
fam11655	2	2	2	2.0	0.0	0.0	2	2	0
fam11656	2	2	2	2.0	0.0	0.0	2	2	0
fam11657	2	2	2	2.0	0.0	0.0	2	2	0
fam11658	2	2	2	2.0	0.0	0.0	2	2	0
fam11659	2	2	2	2.0	0.0	0.0	2	2	0
fam11660	2	2	2	2.0	0.0	0.0	2	2	0
fam11661	2	2	2	2.0	0.0	0.0	2	2	0
fam11662	2	2	2	2.0	0.0	0.0	2	2	0
fam11663	2	2	2	2.0	0.0	0.0	2	2	0
fam11664	2	2	2	2.0	0.0	0.0	2	2	0
fam11665	2	2	2	2.0	0.0	0.0	2	2	0
fam11666	2	2	2	2.0	0.0	0.0	2	2	0
fam11667	2	2	2	2.0	0.0	0.0	2	2	0
fam11668	2	2	2	2.0	0.0	0.0	2	2	0
fam11669	2	2	2	2.0	0.0	0.0	2	2	0
fam11670	2	2	2	2.0	0.0	0.0	2	2	0
fam11671	2	2	2	2.0	0.0	0.0	2	2	0
fam11672	2	2	2	2.0	0.0	0.0	2	2	0
fam11673	2	2	2	2.0	0.0	0.0	2	2	0
fam11674	2	2	2	2.0	0.0	0.0	2	2	0
fam11675	2	2	2	2.0	0.0	0.0	2	2	0
fam11676	2	2	2	2.0	0.0	0.0	2	2	0
fam11677	2	2	2	2.0	0.0	0.0	2	2	0
fam11678	2	2	2	2.0	0.0	0.0	2	2	0
fam11679	2	2	2	2.0	0.0	0.0	2	2	0
fam11680	2	2	2	2.0	0.0	0.0	2	2	0
fam11681	2	2	2	2.0	0.0	0.0	2	2	0
fam11682	2	2	2	2.0	0.0	0.0	2	2	0
fam11683	2	2	2	2.0	0.0	0.0	2	2	0
fam11684	2	2	2	2.0	0.0	0.0	2	2	0
fam11685	2	2	2	2.0	0.0	0.0	2	2	0
fam11686	2	2	2	2.0	0.0	0.0	2	2	0
fam11687	2	2	2	2.0	0.0	0.0	2	2	0
fam11688	2	2	2	2.0	0.0	0.0	2	2	0
fam11689	2	2	2	2.0	0.0	0.0	2	2	0
fam11690	2	2	2	2.0	0.0	0.0	2	2	0
fam11691	2	2	2	2.0	0.0	0.0	2	2	0
fam11692	2	2	2	2.0	0.0	0.0	2	2	0
fam11693	2	2	2	2.0	0.0	0.0	2	2	0
fam11694	2	2	2	2.0	0.0	0.0	2	2	0
fam11695	2	2	2	2.0	0.0	0.0	2	2	0
fam11696	2	2	2	2.0	0.0	0.0	2	2	0
fam11697	2	2	2	2.0	0.0	0.0	2	2	0
fam11698	2	2	2	2.0	0.0	0.0	2	2	0
fam11699	2	2	2	2.0	0.0	0.0	2	2	0
fam11700	2	2	2	2.0	0.0	0.0	2	2	0
fam11701	2	2	2	2.0	0.0	0.0	2	2	0
fam11702	2	2	2	2.0	0.0	0.0	2	2	0
fam11703	2	2	2	2.0	0.0	0.0	2	2	0
fam11704	2	2	2	2.0	0.0	0.0	2	2	0
fam11705	2	2	2	2.0	0.0	0.0	2	2	0
fam11706	2	2	2	2.0	0.0	0.0	2	2	0
fam11707	2	2	2	2.0	0.0	0.0	2	2	0
fam11708	2	2	2	2.0	0.0	0.0	2	2	0
fam11709	2	2	2	2.0	0.0	0.0	2	2	0
fam11710	2	2	2	2.0	0.0	0.0	2	2	0
fam11711	2	2	2	2.0	0.0	0.0	2	2	0
fam11712	2	2	2	2.0	0.0	0.0	2	2	0
fam11713	2	2	2	2.0	0.0	0.0	2	2	0
fam11714	2	2	2	2.0	0.0	0.0	2	2	0
fam11715	2	2	2	2.0	0.0	0.0	2	2	0
fam11716	2	2	2	2.0	0.0	0.0	2	2	0
fam11717	2	2	2	2.0	0.0	0.0	2	2	0
fam11718	2	2	2	2.0	0.0	0.0	2	2	0
fam11719	2	2	2	2.0	0.0	0.0	2	2	0
fam11720	2	2	2	2.0	0.0	0.0	2	2	0
fam11721	2	2	2	2.0	0.0	0.0	2	2	0
fam11722	2	2	2	2.0	0.0	0.0	2	2	0
fam11723	2	2	2	2.0	0.0	0.0	2	2	0
fam11724	2	2	2	2.0	0.0	0.0	2	2	0
fam11725	2	2	2	2.0	0.0	0.0	2	2	0
fam11726	2	2	2	2.0	0.0	0.0	2	2	0
fam11727	2	2	2	2.0	0.0	0.0	2	2	0
fam11728	2	2	2	2.0	0.0	0.0	2	2	0
fam11729	2	2	2	2.0	0.0	0.0	2	2	0
fam11730	2	2	2	2.0	0.0	0.0	2	2	0
fam11731	2	2	2	2.0	0.0	0.0	2	2	0
fam11732	2	2	2	2.0	0.0	0.0	2	2	0
fam11733	2	2	2	2.0	0.0	0.0	2	2	0
fam11734	2	2	2	2.0	0.0	0.0	2	2	0
fam11735	2	2	2	2.0	0.0	0.0	2	2	0
fam11736	2	2	2	2.0	0.0	0.0	2	2	0
fam11737	2	2	2	2.0	0.0	0.0	2	2	0
fam11738	2	2	2	2.0	0.0	0.0	2	2	0
fam11739	2	2	2	2.0	0.0	0.0	2	2	0
fam11740	2	2	2	2.0	0.0	0.0	2	2	0
fam11741	2	2	2	2.0	0.0	0.0	2	2	0
fam11742	2	2	2	2.0	0.0	0.0	2	2	0
fam11743	2	2	2	2.0	0.0	0.0	2	2	0
fam11744	2	2	2	2.0	0.0	0.0	2	2	0
fam11745	2	2	2	2.0	0.0	0.0	2	2	0
fam11746	2	2	2	2.0	0.0	0.0	2	2	0
fam11747	2	2	2	2.0	0.0	0.0	2	2	0
fam11748	2	2	2	2.0	0.0	0.0	2	2	0
fam11749	2	2	2	2.0	0.0	0.0	2	2	0
fam11750	2	2	2	2.0	0.0	0.0	2	2	0
fam11751	2	2	2	2.0	0.0	0.0	2	2	0
fam11752	2	2	2	2.0	0.0	0.0	2	2	0
fam11753	2	2	2	2.0	0.0	0.0	2	2	0
fam11754	2	2	2	2.0	0.0	0.0	2	2	0
fam11755	2	2	2	2.0	0.0	0.0	2	2	0
fam11756	2	2	2	2.0	0.0	0.0	2	2	0
fam11757	2	2	2	2.0	0.0	0.0	2	2	0
fam11758	2	2	2	2.0	0.0	0.0	2	2	0
fam11759	2	2	2	2.0	0.0	0.0	2	2	0
fam11760	2	2	2	2.0	0.0	0.0	2	2	0
fam11761	2	2	2	2.0	0.0	0.0	2	2	0
fam11762	2	2	2	2.0	0.0	0.0	2	2	0
fam11763	2	2	2	2.0	0.0	0.0	2	2	0
fam11764	2	2	2	2.0	0.0	0.0	2	2	0
fam11765	2	2	2	2.0	0.0	0.0	2	2	0
fam11766	2	2	2	2.0	0.0	0.0	2	2	0
fam11767	2	2	2	2.0	0.0	0.0	2	2	0
fam11768	2	2	2	2.0	0.0	0.0	2	2	0
fam11769	2	2	2	2.0	0.0	0.0	2	2	0
fam11770	2	2	2	2.0	0.0	0.0	2	2	0
fam11771	2	2	2	2.0	0.0	0.0	2	2	0
fam11772	2	2	2	2.0	0.0	0.0	2	2	0
fam11773	2	2	2	2.0	0.0	0.0	2	2	0
fam11774	2	2	2	2.0	0.0	0.0	2	2	0
fam11775	2	2	2	2.0	0.0	0.0	2	2	0
fam11776	2	2	2	2.0	0.0	0.0	2	2	0
fam11777	2	2	2	2.0	0.0	0.0	2	2	0
fam11778	2	2	2	2.0	0.0	0.0	2	2	0
fam11779	2	2	2	2.0	0.0	0.0	2	2	0
fam11780	2	2	2	2.0	0.0	0.0	2	2	0
fam11781	2	2	2	2.0	0.0	0.0	2	2	0
fam11782	2	2	2	2.0	0.0	0.0	2	2	0
fam11783	2	2	2	2.0	0.0	0.0	2	2	0
fam11784	2	2	2	2.0	0.0	0.0	2	2	0
fam11785	2	2	2	2.0	0.0	0.0	2	2	0
fam11786	2	2	2	2.0	0.0	0.0	2	2	0
fam11787	2	2	2	2.0	0.0	0.0	2	2	0
fam11788	2	2	2	2.0	0.0	0.0	2	2	0
fam11789	2	2	2	2.0	0.0	0.0	2	2	0
fam11790	2	2	2	2.0	0.0	0.0	2	2	0
fam11791	2	2	2	2.0	0.0	0.0	2	2	0
fam11792	2	2	2	2.0	0.0	0.0	2	2	0
fam11793	2	2	2	2.0	0.0	0.0	2	2	0
fam11794	2	2	2	2.0	0.0	0.0	2	2	0
fam11795	2	2	2	2.0	0.0	0.0	2	2	0
fam11796	2	2	2	2.0	0.0	0.0	2	2	0
fam11797	2	2	2	2.0	0.0	0.0	2	2	0
fam11798	2	2	2	2.0	0.0	0.0	2	2	0
fam11799	2	2	2	2.0	0.0	0.0	2	2	0
fam11800	2	2	2	2.0	0.0	0.0	2	2	0
fam11801	2	2	2	2.0	0.0	0.0	2	2	0
fam11802	2	2	2	2.0	0.0	0.0	2	2	0
fam11803	2	2	2	2.0	0.0	0.0	2	2	0
fam11804	2	2	2	2.0	0.0	0.0	2	2	0
fam11805	2	2	2	2.0	0.0	0.0	2	2	0
fam11806	2	2	2	2.0	0.0	0.0	2	2	0
fam11807	2	2	2	2.0	0.0	0.0	2	2	0
fam11808	2	2	2	2.0	0.0	0.0	2	2	0
fam11809	2	2	2	2.0	0.0	0.0	2	2	0
fam11810	2	2	2	2.0	0.0	0.0	2	2	0
fam11811	2	2	2	2.0	0.0	0.0	2	2	0
fam11812	2	2	2	2.0	0.0	0.0	2	2	0
fam11813	2	2	2	2.0	0.0	0.0	2	2	0
fam11814	2	2	2	2.0	0.0	0.0	2	2	0
fam11815	2	2	2	2.0	0.0	0.0	2	2	0
fam11816	2	2	2	2.0	0.0	0.0	2	2	0
fam11817	2	2	2	2.0	0.0	0.0	2	2	0
fam11818	2	2	2	2.0	0.0	0.0	2	2	0
fam11819	2	2	2	2.0	0.0	0.0	2	2	0
fam11820	2	2	2	2.0	0.0	0.0	2	2	0
fam11821	2	2	2	2.0	0.0	0.0	2	2	0
fam11822	2	2	2	2.0	0.0	0.0	2	2	0
fam11823	2	2	2	2.0	0.0	0.0	2	2	0
fam11824	2	2	2	2.0	0.0	0.0	2	2	0
fam11825	2	2	2	2.0	0.0	0.0	2	2	0
fam11826	2	2	2	2.0	0.0	0.0	2	2	0
fam11827	2	2	2	2.0	0.0	0.0	2	2	0
fam11828	2	2	2	2.0	0.0	0.0	2	2	0
fam11829	2	2	2	2.0	0.0	0.0	2	2	0
fam11830	2	2	2	2.0	0.0	0.0	2	2	0
fam11831	2	2	2	2.0	0.0	0.0	2	2	0
fam11832	2	2	2	2.0	0.0	0.0	2	2	0
fam11833	2	2	2	2.0	0.0	0.0	2	2	0
fam11834	2	2	2	2.0	0.0	0.0	2	2	0
fam11835	2	2	2	2.0	0.0	0.0	2	2	0
fam11836	2	2	2	2.0	0.0	0.0	2	2	0
fam11837	2	2	2	2.0	0.0	0.0	2	2	0
fam11838	2	2	2	2.0	0.0	0.0	2	2	0
fam11839	2	2	2	2.0	0.0	0.0	2	2	0
fam11840	2	2	2	2.0	0.0	0.0	2	2	0
fam11841	2	2	2	2.0	0.0	0.0	2	2	0
fam11842	2	2	2	2.0	0.0	0.0	2	2	0
fam11843	2	2	2	2.0	0.0	0.0	2	2	0
fam11844	2	2	2	2.0	0.0	0.0	2	2	0
fam11845	2	2	2	2.0	0.0	0.0	2	2	0
fam11846	2	2	2	2.0	0.0	0.0	2	2	0
fam11847	2	2	2	2.0	0.0	0.0	2	2	0
fam11848	2	2	2	2.0	0.0	0.0	2	2	0
fam11849	2	2	2	2.0	0.0	0.0	2	2	0
fam11850	2	2	2	2.0	0.0	0.0	2	2	0
fam11851	2	2	2	2.0	0.0	0.0	2	2	0
fam11852	2	2	2	2.0	0.0	0.0	2	2	0
fam11853	2	2	2	2.0	0.0	0.0	2	2	0
fam11854	2	2	2	2.0	0.0	0.0	2	2	0
fam11855	2	2	2	2.0	0.0	0.0	2	2	0
fam11856	2	2	2	2.0	0.0	0.0	2	2	0
fam11857	2	2	2	2.0	0.0	0.0	2	2	0
fam11858	2	2	2	2.0	0.0	0.0	2	2	0
fam11859	2	2	2	2.0	0.0	0.0	2	2	0
fam11860	2	2	2	2.0	0.0	0.0	2	2	0
fam11861	2	2	2	2.0	0.0	0.0	2	2	0
fam11862	2	2	2	2.0	0.0	0.0	2	2	0
fam11863	2	2	2	2.0	0.0	0.0	2	2	0
fam11864	2	2	2	2.0	0.0	0.0	2	2	0
fam11865	2	2	2	2.0	0.0	0.0	2	2	0
fam11866	2	2	2	2.0	0.0	0.0	2	2	0
fam11867	2	2	2	2.0	0.0	0.0	2	2	0
fam11868	2	2	2	2.0	0.0	0.0	2	2	0
fam11869	2	2	2	2.0	0.0	0.0	2	2	0
fam11870	2	2	2	2.0	0.0	0.0	2	2	0
fam11871	2	2	2	2.0	0.0	0.0	2	2	0
fam11872	2	2	2	2.0	0.0	0.0	2	2	0
fam11873	2	2	2	2.0	0.0	0.0	2	2	0
fam11874	2	2	2	2.0	0.0	0.0	2	2	0
fam11875	2	2	2	2.0	0.0	0.0	2	2	0
fam11876	2	2	2	2.0	0.0	0.0	2	2	0
fam11877	2	2	2	2.0	0.0	0.0	2	2	0
fam11878	2	2	2	2.0	0.0	0.0	2	2	0
fam11879	2	2	2	2.0	0.0	0.0	2	2	0
fam11880	2	2	2	2.0	0.0	0.0	2	2	0
fam11881	2	2	2	2.0	0.0	0.0	2	2	0
fam11882	2	2	2	2.0	0.0	0.0	2	2	0
fam11883	2	2	2	2.0	0.0	0.0	2	2	0
fam11884	2	2	2	2.0	0.0	0.0	2	2	0
fam11885	2	2	2	2.0	0.0	0.0	2	2	0
fam11886	2	2	2	2.0	0.0	0.0	2	2	0
fam11887	2	2	2	2.0	0.0	0.0	2	2	0
fam11888	2	2	2	2.0	0.0	0.0	2	2	0
fam11889	2	2	2	2.0	0.0	0.0	2	2	0
fam11890	2	2	2	2.0	0.0	0.0	2	2	0
fam11891	2	2	2	2.0	0.0	0.0	2	2	0
fam11892	2	2	2	2.0	0.0	0.0	2	2	0
fam11893	2	2	2	2.0	0.0	0.0	2	2	0
fam11894	2	2	2	2.0	0.0	0.0	2	2	0
fam11895	2	2	2	2.0	0.0	0.0	2	2	0
fam11896	2	2	2	2.0	0.0	0.0	2	2	0
fam11897	2	2	2	2.0	0.0	0.0	2	2	0
fam11898	2	2	2	2.0	0.0	0.0	2	2	0
fam11899	2	2	2	2.0	0.0	0.0	2	2	0
fam11900	2	2	2	2.0	0.0	0.0	2	2	0
fam11901	2	2	2	2.0	0.0	0.0	2	2	0
fam11902	2	2	2	2.0	0.0	0.0	2	2	0
fam11903	2	2	2	2.0	0.0	0.0	2	2	0
fam11904	2	2	2	2.0	0.0	0.0	2	2	0
fam11905	2	2	2	2.0	0.0	0.0	2	2	0
fam11906	2	2	2	2.0	0.0	0.0	2	2	0
fam11907	2	2	2	2.0	0.0	0.0	2	2	0
fam11908	2	2	2	2.0	0.0	0.0	2	2	0
fam11909	2	2	2	2.0	0.0	0.0	2	2	0
fam11910	2	2	2	2.0	0.0	0.0	2	2	0
fam11911	2	2	2	2.0	0.0	0.0	2	2	0
fam11912	2	2	2	2.0	0.0	0.0	2	2	0
fam11913	2	2	2	2.0	0.0	0.0	2	2	0
fam11914	2	2	2	2.0	0.0	0.0	2	2	0
fam11915	2	2	2	2.0	0.0	0.0	2	2	0
fam11916	2	2	2	2.0	0.0	0.0	2	2	0
fam11917	2	2	2	2.0	0.0	0.0	2	2	0
fam11918	2	2	2	2.0	0.0	0.0	2	2	0
fam11919	2	2	2	2.0	0.0	0.0	2	2	0
fam11920	2	2	2	2.0	0.0	0.0	2	2	0
fam11921	2	2	2	2.0	0.0	0.0	2	2	0
fam11922	2	2	2	2.0	0.0	0.0	2	2	0
fam11923	2	2	2	2.0	0.0	0.0	2	2	0
fam11924	2	2	2	2.0	0.0	0.0	2	2	0
fam11925	2	2	2	2.0	0.0	0.0	2	2	0
fam11926	2	2	2	2.0	0.0	0.0	2	2	0
fam11927	2	2	2	2.0	0.0	0.0	2	2	0
fam11928	2	2	2	2.0	0.0	0.0	2	2	0
fam11929	2	2	2	2.0	0.0	0.0	2	2	0
fam11930	2	2	2	2.0	0.0	0.0	2	2	0
fam11931	2	2	2	2.0	0.0	0.0	2	2	0
fam11932	2	2	2	2.0	0.0	0.0	2	2	0
fam11933	2	2	2	2.0	0.0	0.0	2	2	0
fam11934	2	2	2	2.0	0.0	0.0	2	2	0
fam11935	2	2	2	2.0	0.0	0.0	2	2	0
fam11936	2	2	2	2.0	0.0	0.0	2	2	0
fam11937	2	2	2	2.0	0.0	0.0	2	2	0
fam11938	2	2	2	2.0	0.0	0.0	2	2	0
fam11939	2	2	2	2.0	0.0	0.0	2	2	0
fam11940	2	2	2	2.0	0.0	0.0	2	2	0
fam11941	2	2	2	2.0	0.0	0.0	2	2	0
fam11942	2	2	2	2.0	0.0	0.0	2	2	0
fam11943	2	2	2	2.0	0.0	0.0	2	2	0
fam11944	2	2	2	2.0	0.0	0.0	2	2	0
fam11945	2	2	2	2.0	0.0	0.0	2	2	0
fam11946	2	2	2	2.0	0.0	0.0	2	2	0
fam11947	2	2	2	2.0	0.0	0.0	2	2	0
fam11948	2	2	2	2.0	0.0	0.0	2	2	0
fam11949	2	2	2	2.0	0.0	0.0	2	2	0
fam11950	2	2	2	2.0	0.0	0.0	2	2	0
fam11951	2	2	2	2.0	0.0	0.0	2	2	0
fam11952	2	2	2	2.0	0.0	0.0	2	2	0
fam11953	2	2	2	2.0	0.0	0.0	2	2	0
fam11954	2	2	2	2.0	0.0	0.0	2	2	0
fam11955	2	2	2	2.0	0.0	0.0	2	2	0
fam11956	2	2	2	2.0	0.0	0.0	2	2	0
fam11957	2	2	2	2.0	0.0	0.0	2	2	0
fam11958	2	2	2	2.0	0.0	0.0	2	2	0
fam11959	2	2	2	2.0	0.0	0.0	2	2	0
fam11960	2	2	2	2.0	0.0	0.0	2	2	0
fam11961	2	2	2	2.0	0.0	0.0	2	2	0
fam11962	2	2	2	2.0	0.0	0.0	2	2	0
fam11963	2	2	2	2.0	0.0	0.0	2	2	0
fam11964	2	2	2	2.0	0.0	0.0	2	2	0
fam11965	2	2	2	2.0	0.0	0.0	2	2	0
fam11966	2	2	2	2.0	0.0	0.0	2	2	0
fam11967	2	2	2	2.0	0.0	0.0	2	2	0
fam11968	2	2	2	2.0	0.0	0.0	2	2	0
fam11969	2	2	2	2.0	0.0	0.0	2	2	0
fam11970	2	2	2	2.0	0.0	0.0	2	2	0
fam11971	2	2	2	2.0	0.0	0.0	2	2	0
fam11972	2	2	2	2.0	0.0	0.0	2	2	0
fam11973	2	2	2	2.0	0.0	0.0	2	2	0
fam11974	2	2	2	2.0	0.0	0.0	2	2	0
fam11975	2	2	2	2.0	0.0	0.0	2	2	0
fam11976	2	2	2	2.0	0.0	0.0	2	2	0
fam11977	2	2	2	2.0	0.0	0.0	2	2	0
fam11978	2	2	2	2.0	0.0	0.0	2	2	0
fam11979	2	2	2	2.0	0.0	0.0	2	2	0
fam11980	2	2	2	2.0	0.0	0.0	2	2	0
fam11981	2	2	2	2.0	0.0	0.0	2	2	0
fam11982	2	2	2	2.0	0.0	0.0	2	2	0
fam11983	2	2	2	2.0	0.0	0.0	2	2	0
fam11984	2	2	2	2.0	0.0	0.0	2	2	0
fam11985	2	2	2	2.0	0.0	0.0	2	2	0
fam11986	2	2	2	2.0	0.0	0.0	2	2	0
fam11987	2	2	2	2.0	0.0	0.0	2	2	0
fam11988	2	2	2	2.0	0.0	0.0	2	2	0
fam11989	2	2	2	2.0	0.0	0.0	2	2	0
fam11990	2	2	2	2.0	0.0	0.0	2	2	0
fam11991	2	2	2	2.0	0.0	0.0	2	2	0
fam11992	2	2	2	2.0	0.0	0.0	2	2	0
fam11993	2	2	2	2.0	0.0	0.0	2	2	0
fam11994	2	2	2	2.0	0.0	0.0	2	2	0
fam11995	2	2	2	2.0	0.0	0.0	2	2	0
fam11996	2	2	2	2.0	0.0	0.0	2	2	0
fam11997	2	2	2	2.0	0.0	0.0	2	2	0
fam11998	2	2	2	2.0	0.0	0.0	2	2	0
fam11999	2	2	2	2.0	0.0	0.0	2	2	0
fam12000	2	2	2	2.0	0.0	0.0	2	2	0
fam12001	2	2	2	2.0	0.0	0.0	2	2	0
fam12002	2	2	2	2.0	0.0	0.0	2	2	0
fam12003	2	2	2	2.0	0.0	0.0	2	2	0
fam12004	2	2	2	2.0	0.0	0.0	2	2	0
fam12005	2	2	2	2.0	0.0	0.0	2	2	0
fam12006	2	2	2	2.0	0.0	0.0	2	2	0
fam12007	2	2	2	2.0	0.0	0.0	2	2	0
fam12008	2	2	2	2.0	0.0	0.0	2	2	0
fam12009	2	2	2	2.0	0.0	0.0	2	2	0
fam12010	2	2	2	2.0	0.0	0.0	2	2	0
fam12011	2	2	2	2.0	0.0	0.0	2	2	0
fam12012	2	2	2	2.0	0.0	0.0	2	2	0
fam12013	2	2	2	2.0	0.0	0.0	2	2	0
fam12014	2	2	2	2.0	0.0	0.0	2	2	0
fam12015	2	2	2	2.0	0.0	0.0	2	2	0
fam12016	2	2	2	2.0	0.0	0.0	2	2	0
fam12017	2	2	2	2.0	0.0	0.0	2	2	0
fam12018	2	2	2	2.0	0.0	0.0	2	2	0
fam12019	2	2	2	2.0	0.0	0.0	2	2	0
fam12020	2	2	2	2.0	0.0	0.0	2	2	0
fam12021	2	2	2	2.0	0.0	0.0	2	2	0
fam12022	2	2	2	2.0	0.0	0.0	2	2	0
fam12023	2	2	2	2.0	0.0	0.0	2	2	0
fam12024	2	2	2	2.0	0.0	0.0	2	2	0
fam12025	2	2	2	2.0	0.0	0.0	2	2	0
fam12026	2	2	2	2.0	0.0	0.0	2	2	0
fam12027	2	2	2	2.0	0.0	0.0	2	2	0
fam12028	2	2	2	2.0	0.0	0.0	2	2	0
fam12029	2	2	2	2.0	0.0	0.0	2	2	0
fam12030	2	2	2	2.0	0.0	0.0	2	2	0
fam12031	2	2	2	2.0	0.0	0.0	2	2	0
fam12032	2	2	2	2.0	0.0	0.0	2	2	0
fam12033	2	2	2	2.0	0.0	0.0	2	2	0
fam12034	2	2	2	2.0	0.0	0.0	2	2	0
fam12035	2	2	2	2.0	0.0	0.0	2	2	0
fam12036	2	2	2	2.0	0.0	0.0	2	2	0
fam12037	2	2	2	2.0	0.0	0.0	2	2	0
fam12038	2	2	2	2.0	0.0	0.0	2	2	0
fam12039	2	2	2	2.0	0.0	0.0	2	2	0
fam12040	2	2	2	2.0	0.0	0.0	2	2	0
fam12041	2	2	2	2.0	0.0	0.0	2	2	0
fam12042	2	2	2	2.0	0.0	0.0	2	2	0
fam12043	2	2	2	2.0	0.0	0.0	2	2	0
fam12044	2	2	2	2.0	0.0	0.0	2	2	0
fam12045	2	2	2	2.0	0.0	0.0	2	2	0
fam12046	2	2	2	2.0	0.0	0.0	2	2	0
fam12047	2	2	2	2.0	0.0	0.0	2	2	0
fam12048	2	2	2	2.0	0.0	0.0	2	2	0
fam12049	2	2	2	2.0	0.0	0.0	2	2	0
fam12050	2	2	2	2.0	0.0	0.0	2	2	0
fam12051	2	2	2	2.0	0.0	0.0	2	2	0
fam12052	2	2	2	2.0	0.0	0.0	2	2	0
fam12053	2	2	2	2.0	0.0	0.0	2	2	0
fam12054	2	2	2	2.0	0.0	0.0	2	2	0
fam12055	2	2	2	2.0	0.0	0.0	2	2	0
fam12056	2	2	2	2.0	0.0	0.0	2	2	0
fam12057	2	2	2	2.0	0.0	0.0	2	2	0
fam12058	2	2	2	2.0	0.0	0.0	2	2	0
fam12059	2	2	2	2.0	0.0	0.0	2	2	0
fam12060	2	2	2	2.0	0.0	0.0	2	2	0
fam12061	2	2	2	2.0	0.0	0.0	2	2	0
fam12062	2	2	2	2.0	0.0	0.0	2	2	0
fam12063	2	2	2	2.0	0.0	0.0	2	2	0
fam12064	2	2	2	2.0	0.0	0.0	2	2	0
fam12065	2	2	2	2.0	0.0	0.0	2	2	0
fam12066	2	2	2	2.0	0.0	0.0	2	2	0
fam12067	2	2	2	2.0	0.0	0.0	2	2	0
fam12068	2	2	2	2.0	0.0	0.0	2	2	0
fam12069	2	2	2	2.0	0.0	0.0	2	2	0
fam12070	2	2	2	2.0	0.0	0.0	2	2	0
fam12071	2	2	2	2.0	0.0	0.0	2	2	0
fam12072	2	2	2	2.0	0.0	0.0	2	2	0
fam12073	2	2	2	2.0	0.0	0.0	2	2	0
fam12074	2	2	2	2.0	0.0	0.0	2	2	0
fam12075	2	2	2	2.0	0.0	0.0	2	2	0
fam12076	2	2	2	2.0	0.0	0.0	2	2	0
fam12077	2	2	2	2.0	0.0	0.0	2	2	0
fam12078	2	2	2	2.0	0.0	0.0	2	2	0
fam12079	2	2	2	2.0	0.0	0.0	2	2	0
fam12080	2	2	2	2.0	0.0	0.0	2	2	0
fam12081	2	2	2	2.0	0.0	0.0	2	2	0
fam12082	2	2	2	2.0	0.0	0.0	2	2	0
fam12083	2	2	2	2.0	0.0	0.0	2	2	0
fam12084	2	2	2	2.0	0.0	0.0	2	2	0
fam12085	2	2	2	2.0	0.0	0.0	2	2	0
fam12086	2	2	2	2.0	0.0	0.0	2	2	0
fam12087	2	2	2	2.0	0.0	0.0	2	2	0
fam12088	2	2	2	2.0	0.0	0.0	2	2	0
fam12089	2	2	2	2.0	0.0	0.0	2	2	0
fam12090	2	2	2	2.0	0.0	0.0	2	2	0
fam12091	2	2	2	2.0	0.0	0.0	2	2	0
fam12092	2	2	2	2.0	0.0	0.0	2	2	0
fam12093	2	2	2	2.0	0.0	0.0	2	2	0
fam12094	2	2	2	2.0	0.0	0.0	2	2	0
fam12095	2	2	2	2.0	0.0	0.0	2	2	0
fam12096	2	2	2	2.0	0.0	0.0	2	2	0
fam12097	2	2	2	2.0	0.0	0.0	2	2	0
fam12098	2	2	2	2.0	0.0	0.0	2	2	0
fam12099	2	2	2	2.0	0.0	0.0	2	2	0
fam12100	2	2	2	2.0	0.0	0.0	2	2	0
fam12101	2	2	2	2.0	0.0	0.0	2	2	0
fam12102	2	2	2	2.0	0.0	0.0	2	2	0
fam12103	2	2	2	2.0	0.0	0.0	2	2	0
fam12104	2	2	2	2.0	0.0	0.0	2	2	0
fam12105	2	2	2	2.0	0.0	0.0	2	2	0
fam12106	2	2	2	2.0	0.0	0.0	2	2	0
fam12107	2	2	2	2.0	0.0	0.0	2	2	0
fam12108	2	2	2	2.0	0.0	0.0	2	2	0
fam12109	2	2	2	2.0	0.0	0.0	2	2	0
fam12110	2	2	2	2.0	0.0	0.0	2	2	0
fam12111	2	2	2	2.0	0.0	0.0	2	2	0
fam12112	2	2	2	2.0	0.0	0.0	2	2	0
fam12113	2	2	2	2.0	0.0	0.0	2	2	0
fam12114	2	2	2	2.0	0.0	0.0	2	2	0
fam12115	2	2	2	2.0	0.0	0.0	2	2	0
fam12116	2	2	2	2.0	0.0	0.0	2	2	0
fam12117	2	2	2	2.0	0.0	0.0	2	2	0
fam12118	2	2	2	2.0	0.0	0.0	2	2	0
fam12119	2	2	2	2.0	0.0	0.0	2	2	0
fam12120	2	2	2	2.0	0.0	0.0	2	2	0
fam12121	2	2	2	2.0	0.0	0.0	2	2	0
fam12122	2	2	2	2.0	0.0	0.0	2	2	0
fam12123	2	2	2	2.0	0.0	0.0	2	2	0
fam12124	2	2	2	2.0	0.0	0.0	2	2	0
fam12125	2	2	2	2.0	0.0	0.0	2	2	0
fam12126	2	2	2	2.0	0.0	0.0	2	2	0
fam12127	2	2	2	2.0	0.0	0.0	2	2	0
fam12128	2	2	2	2.0	0.0	0.0	2	2	0
fam12129	2	2	2	2.0	0.0	0.0	2	2	0
fam12130	2	2	2	2.0	0.0	0.0	2	2	0
fam12131	2	2	2	2.0	0.0	0.0	2	2	0
fam12132	2	2	2	2.0	0.0	0.0	2	2	0
fam12133	2	2	2	2.0	0.0	0.0	2	2	0
fam12134	2	2	2	2.0	0.0	0.0	2	2	0
fam12135	2	2	2	2.0	0.0	0.0	2	2	0
fam12136	2	2	2	2.0	0.0	0.0	2	2	0
fam12137	2	2	2	2.0	0.0	0.0	2	2	0
fam12138	2	2	2	2.0	0.0	0.0	2	2	0
fam12139	2	2	2	2.0	0.0	0.0	2	2	0
fam12140	2	2	2	2.0	0.0	0.0	2	2	0
fam12141	2	2	2	2.0	0.0	0.0	2	2	0
fam12142	2	2	2	2.0	0.0	0.0	2	2	0
fam12143	2	2	2	2.0	0.0	0.0	2	2	0
fam12144	2	2	2	2.0	0.0	0.0	2	2	0
fam12145	2	2	2	2.0	0.0	0.0	2	2	0
fam12146	2	2	2	2.0	0.0	0.0	2	2	0
fam12147	2	2	2	2.0	0.0	0.0	2	2	0
fam12148	2	2	2	2.0	0.0	0.0	2	2	0
fam12149	2	2	2	2.0	0.0	0.0	2	2	0
fam12150	2	2	2	2.0	0.0	0.0	2	2	0
fam12151	2	2	2	2.0	0.0	0.0	2	2	0
fam12152	2	2	2	2.0	0.0	0.0	2	2	0
fam12153	2	2	2	2.0	0.0	0.0	2	2	0
fam12154	2	2	2	2.0	0.0	0.0	2	2	0
fam12155	2	2	2	2.0	0.0	0.0	2	2	0
fam12156	2	2	2	2.0	0.0	0.0	2	2	0
fam12157	2	2	2	2.0	0.0	0.0	2	2	0
fam12158	2	2	2	2.0	0.0	0.0	2	2	0
fam12159	2	2	2	2.0	0.0	0.0	2	2	0
fam12160	2	2	2	2.0	0.0	0.0	2	2	0
fam12161	2	2	2	2.0	0.0	0.0	2	2	0
fam12162	2	2	2	2.0	0.0	0.0	2	2	0
fam12163	2	2	2	2.0	0.0	0.0	2	2	0
fam12164	2	2	2	2.0	0.0	0.0	2	2	0
fam12165	2	2	2	2.0	0.0	0.0	2	2	0
fam12166	2	2	2	2.0	0.0	0.0	2	2	0
fam12167	2	2	2	2.0	0.0	0.0	2	2	0
fam12168	2	2	2	2.0	0.0	0.0	2	2	0
fam12169	2	2	2	2.0	0.0	0.0	2	2	0
fam12170	2	2	2	2.0	0.0	0.0	2	2	0
fam12171	2	2	2	2.0	0.0	0.0	2	2	0
fam12172	2	2	2	2.0	0.0	0.0	2	2	0
fam12173	2	2	2	2.0	0.0	0.0	2	2	0
fam12174	2	2	2	2.0	0.0	0.0	2	2	0
fam12175	2	2	2	2.0	0.0	0.0	2	2	0
fam12176	2	2	2	2.0	0.0	0.0	2	2	0
fam12177	2	2	2	2.0	0.0	0.0	2	2	0
fam12178	2	2	2	2.0	0.0	0.0	2	2	0
fam12179	2	2	2	2.0	0.0	0.0	2	2	0
fam12180	2	2	2	2.0	0.0	0.0	2	2	0
fam12181	2	2	2	2.0	0.0	0.0	2	2	0
fam12182	2	2	2	2.0	0.0	0.0	2	2	0
fam12183	2	2	2	2.0	0.0	0.0	2	2	0
fam12184	2	2	2	2.0	0.0	0.0	2	2	0
fam12185	2	2	2	2.0	0.0	0.0	2	2	0
fam12186	2	2	2	2.0	0.0	0.0	2	2	0
fam12187	2	2	2	2.0	0.0	0.0	2	2	0
fam12188	2	2	2	2.0	0.0	0.0	2	2	0
fam12189	2	2	2	2.0	0.0	0.0	2	2	0
fam12190	2	2	2	2.0	0.0	0.0	2	2	0
fam12191	2	2	2	2.0	0.0	0.0	2	2	0
fam12192	2	2	2	2.0	0.0	0.0	2	2	0
fam12193	2	2	2	2.0	0.0	0.0	2	2	0
fam12194	2	2	2	2.0	0.0	0.0	2	2	0
fam12195	2	2	2	2.0	0.0	0.0	2	2	0
fam12196	2	2	2	2.0	0.0	0.0	2	2	0
fam12197	2	2	2	2.0	0.0	0.0	2	2	0
fam12198	2	2	2	2.0	0.0	0.0	2	2	0
fam12199	2	2	2	2.0	0.0	0.0	2	2	0
fam12200	2	2	2	2.0	0.0	0.0	2	2	0
fam12201	2	2	2	2.0	0.0	0.0	2	2	0
fam12202	2	2	2	2.0	0.0	0.0	2	2	0
fam12203	2	2	2	2.0	0.0	0.0	2	2	0
fam12204	2	2	2	2.0	0.0	0.0	2	2	0
fam12205	2	2	2	2.0	0.0	0.0	2	2	0
fam12206	2	2	2	2.0	0.0	0.0	2	2	0
fam12207	2	2	2	2.0	0.0	0.0	2	2	0
fam12208	2	2	2	2.0	0.0	0.0	2	2	0
fam12209	2	2	2	2.0	0.0	0.0	2	2	0
fam12210	2	2	2	2.0	0.0	0.0	2	2	0
fam12211	2	2	2	2.0	0.0	0.0	2	2	0
fam12212	2	2	2	2.0	0.0	0.0	2	2	0
fam12213	2	2	2	2.0	0.0	0.0	2	2	0
fam12214	2	2	2	2.0	0.0	0.0	2	2	0
fam12215	2	2	2	2.0	0.0	0.0	2	2	0
fam12216	2	2	2	2.0	0.0	0.0	2	2	0
fam12217	2	2	2	2.0	0.0	0.0	2	2	0
fam12218	2	2	2	2.0	0.0	0.0	2	2	0
fam12219	2	2	2	2.0	0.0	0.0	2	2	0
fam12220	2	2	2	2.0	0.0	0.0	2	2	0
fam12221	2	2	2	2.0	0.0	0.0	2	2	0
fam12222	2	2	2	2.0	0.0	0.0	2	2	0
fam12223	2	2	2	2.0	0.0	0.0	2	2	0
fam12224	2	2	2	2.0	0.0	0.0	2	2	0
fam12225	2	2	2	2.0	0.0	0.0	2	2	0
fam12226	2	2	2	2.0	0.0	0.0	2	2	0
fam12227	2	2	2	2.0	0.0	0.0	2	2	0
fam12228	2	2	2	2.0	0.0	0.0	2	2	0
fam12229	2	2	2	2.0	0.0	0.0	2	2	0
fam12230	2	2	2	2.0	0.0	0.0	2	2	0
fam12231	2	2	2	2.0	0.0	0.0	2	2	0
fam12232	2	2	2	2.0	0.0	0.0	2	2	0
fam12233	2	2	2	2.0	0.0	0.0	2	2	0
fam12234	2	2	2	2.0	0.0	0.0	2	2	0
fam12235	2	2	2	2.0	0.0	0.0	2	2	0
fam12236	2	2	2	2.0	0.0	0.0	2	2	0
fam12237	2	2	2	2.0	0.0	0.0	2	2	0
fam12238	2	2	2	2.0	0.0	0.0	2	2	0
fam12239	2	2	2	2.0	0.0	0.0	2	2	0
fam12240	2	2	2	2.0	0.0	0.0	2	2	0
fam12241	2	2	2	2.0	0.0	0.0	2	2	0
fam12242	2	2	2	2.0	0.0	0.0	2	2	0
fam12243	2	2	2	2.0	0.0	0.0	2	2	0
fam12244	2	2	2	2.0	0.0	0.0	2	2	0
fam12245	2	2	2	2.0	0.0	0.0	2	2	0
fam12246	2	2	2	2.0	0.0	0.0	2	2	0
fam12247	2	2	2	2.0	0.0	0.0	2	2	0
fam12248	2	2	2	2.0	0.0	0.0	2	2	0
fam12249	2	2	2	2.0	0.0	0.0	2	2	0
fam12250	2	2	2	2.0	0.0	0.0	2	2	0
fam12251	2	2	2	2.0	0.0	0.0	2	2	0
fam12252	2	2	2	2.0	0.0	0.0	2	2	0
fam12253	2	2	2	2.0	0.0	0.0	2	2	0
fam12254	2	2	2	2.0	0.0	0.0	2	2	0
fam12255	2	2	2	2.0	0.0	0.0	2	2	0
fam12256	2	2	2	2.0	0.0	0.0	2	2	0
fam12257	2	2	2	2.0	0.0	0.0	2	2	0
fam12258	2	2	2	2.0	0.0	0.0	2	2	0
fam12259	2	2	2	2.0	0.0	0.0	2	2	0
fam12260	2	2	2	2.0	0.0	0.0	2	2	0
fam12261	2	2	2	2.0	0.0	0.0	2	2	0
fam12262	2	2	2	2.0	0.0	0.0	2	2	0
fam12263	2	2	2	2.0	0.0	0.0	2	2	0
fam12264	2	2	2	2.0	0.0	0.0	2	2	0
fam12265	2	2	2	2.0	0.0	0.0	2	2	0
fam12266	2	2	2	2.0	0.0	0.0	2	2	0
fam12267	2	2	2	2.0	0.0	0.0	2	2	0
fam12268	2	2	2	2.0	0.0	0.0	2	2	0
fam12269	2	2	2	2.0	0.0	0.0	2	2	0
fam12270	2	2	2	2.0	0.0	0.0	2	2	0
fam12271	2	2	2	2.0	0.0	0.0	2	2	0
fam12272	2	2	2	2.0	0.0	0.0	2	2	0
fam12273	2	2	2	2.0	0.0	0.0	2	2	0
fam12274	2	2	2	2.0	0.0	0.0	2	2	0
fam12275	2	2	2	2.0	0.0	0.0	2	2	0
fam12276	2	2	2	2.0	0.0	0.0	2	2	0
fam12277	2	2	2	2.0	0.0	0.0	2	2	0
fam12278	2	2	2	2.0	0.0	0.0	2	2	0
fam12279	2	2	2	2.0	0.0	0.0	2	2	0
fam12280	2	2	2	2.0	0.0	0.0	2	2	0
fam12281	2	2	2	2.0	0.0	0.0	2	2	0
fam12282	2	2	2	2.0	0.0	0.0	2	2	0
fam12283	2	2	2	2.0	0.0	0.0	2	2	0
fam12284	2	2	2	2.0	0.0	0.0	2	2	0
fam12285	2	2	2	2.0	0.0	0.0	2	2	0
fam12286	2	2	2	2.0	0.0	0.0	2	2	0
fam12287	2	2	2	2.0	0.0	0.0	2	2	0
fam12288	2	2	2	2.0	0.0	0.0	2	2	0
fam12289	2	2	2	2.0	0.0	0.0	2	2	0
fam12290	2	2	2	2.0	0.0	0.0	2	2	0
fam12291	2	2	2	2.0	0.0	0.0	2	2	0
fam12292	2	2	2	2.0	0.0	0.0	2	2	0
fam12293	2	2	2	2.0	0.0	0.0	2	2	0
fam12294	2	2	2	2.0	0.0	0.0	2	2	0
fam12295	2	2	2	2.0	0.0	0.0	2	2	0
fam12296	2	2	2	2.0	0.0	0.0	2	2	0
fam12297	2	2	2	2.0	0.0	0.0	2	2	0
fam12298	2	2	2	2.0	0.0	0.0	2	2	0
fam12299	2	2	2	2.0	0.0	0.0	2	2	0
fam12300	2	2	2	2.0	0.0	0.0	2	2	0
fam12301	2	2	2	2.0	0.0	0.0	2	2	0
fam12302	2	2	2	2.0	0.0	0.0	2	2	0
fam12303	2	2	2	2.0	0.0	0.0	2	2	0
fam12304	2	2	2	2.0	0.0	0.0	2	2	0
fam12305	2	2	2	2.0	0.0	0.0	2	2	0
fam12306	2	2	2	2.0	0.0	0.0	2	2	0
fam12307	2	2	2	2.0	0.0	0.0	2	2	0
fam12308	2	2	2	2.0	0.0	0.0	2	2	0
fam12309	2	2	2	2.0	0.0	0.0	2	2	0
fam12310	2	2	2	2.0	0.0	0.0	2	2	0
fam12311	2	2	2	2.0	0.0	0.0	2	2	0
fam12312	2	2	2	2.0	0.0	0.0	2	2	0
fam12313	2	2	2	2.0	0.0	0.0	2	2	0
fam12314	2	2	2	2.0	0.0	0.0	2	2	0
fam12315	2	2	2	2.0	0.0	0.0	2	2	0
fam12316	2	2	2	2.0	0.0	0.0	2	2	0
fam12317	2	2	2	2.0	0.0	0.0	2	2	0
fam12318	2	2	2	2.0	0.0	0.0	2	2	0
fam12319	2	2	2	2.0	0.0	0.0	2	2	0
fam12320	2	2	2	2.0	0.0	0.0	2	2	0
fam12321	2	2	2	2.0	0.0	0.0	2	2	0
fam12322	2	2	2	2.0	0.0	0.0	2	2	0
fam12323	2	2	2	2.0	0.0	0.0	2	2	0
fam12324	2	2	2	2.0	0.0	0.0	2	2	0
fam12325	2	2	2	2.0	0.0	0.0	2	2	0
fam12326	2	2	2	2.0	0.0	0.0	2	2	0
fam12327	2	2	2	2.0	0.0	0.0	2	2	0
fam12328	2	2	2	2.0	0.0	0.0	2	2	0
fam12329	2	2	2	2.0	0.0	0.0	2	2	0
fam12330	2	2	2	2.0	0.0	0.0	2	2	0
fam12331	2	2	2	2.0	0.0	0.0	2	2	0
fam12332	2	2	2	2.0	0.0	0.0	2	2	0
fam12333	2	2	2	2.0	0.0	0.0	2	2	0
fam12334	2	2	2	2.0	0.0	0.0	2	2	0
fam12335	2	2	2	2.0	0.0	0.0	2	2	0
fam12336	2	2	2	2.0	0.0	0.0	2	2	0
fam12337	2	2	2	2.0	0.0	0.0	2	2	0
fam12338	2	2	2	2.0	0.0	0.0	2	2	0
fam12339	2	2	2	2.0	0.0	0.0	2	2	0
fam12340	2	2	2	2.0	0.0	0.0	2	2	0
fam12341	2	2	2	2.0	0.0	0.0	2	2	0
fam12342	2	2	2	2.0	0.0	0.0	2	2	0
fam12343	2	2	2	2.0	0.0	0.0	2	2	0
fam12344	2	2	2	2.0	0.0	0.0	2	2	0
fam12345	2	2	2	2.0	0.0	0.0	2	2	0
fam12346	2	2	2	2.0	0.0	0.0	2	2	0
fam12347	2	2	2	2.0	0.0	0.0	2	2	0
fam12348	2	2	2	2.0	0.0	0.0	2	2	0
fam12349	2	2	2	2.0	0.0	0.0	2	2	0
fam12350	2	2	2	2.0	0.0	0.0	2	2	0
fam12351	2	2	2	2.0	0.0	0.0	2	2	0
fam12352	2	2	2	2.0	0.0	0.0	2	2	0
fam12353	2	2	2	2.0	0.0	0.0	2	2	0
fam12354	2	2	2	2.0	0.0	0.0	2	2	0
fam12355	2	2	2	2.0	0.0	0.0	2	2	0
fam12356	2	2	2	2.0	0.0	0.0	2	2	0
fam12357	2	2	2	2.0	0.0	0.0	2	2	0
fam12358	2	2	2	2.0	0.0	0.0	2	2	0
fam12359	2	2	2	2.0	0.0	0.0	2	2	0
fam12360	2	2	2	2.0	0.0	0.0	2	2	0
fam12361	2	2	2	2.0	0.0	0.0	2	2	0
fam12362	2	2	2	2.0	0.0	0.0	2	2	0
fam12363	2	2	2	2.0	0.0	0.0	2	2	0
fam12364	2	2	2	2.0	0.0	0.0	2	2	0
fam12365	2	2	2	2.0	0.0	0.0	2	2	0
fam12366	2	2	2	2.0	0.0	0.0	2	2	0
fam12367	2	2	2	2.0	0.0	0.0	2	2	0
fam12368	2	2	2	2.0	0.0	0.0	2	2	0
fam12369	2	2	2	2.0	0.0	0.0	2	2	0
fam12370	2	2	2	2.0	0.0	0.0	2	2	0
fam12371	2	2	2	2.0	0.0	0.0	2	2	0
fam12372	2	2	2	2.0	0.0	0.0	2	2	0
fam12373	2	2	2	2.0	0.0	0.0	2	2	0
fam12374	2	2	2	2.0	0.0	0.0	2	2	0
fam12375	2	2	2	2.0	0.0	0.0	2	2	0
fam12376	2	2	2	2.0	0.0	0.0	2	2	0
fam12377	2	2	2	2.0	0.0	0.0	2	2	0
fam12378	2	2	2	2.0	0.0	0.0	2	2	0
fam12379	2	2	2	2.0	0.0	0.0	2	2	0
fam12380	2	2	2	2.0	0.0	0.0	2	2	0
fam12381	2	2	2	2.0	0.0	0.0	2	2	0
fam12382	2	2	2	2.0	0.0	0.0	2	2	0
fam12383	2	2	2	2.0	0.0	0.0	2	2	0
fam12384	2	2	2	2.0	0.0	0.0	2	2	0
fam12385	2	2	2	2.0	0.0	0.0	2	2	0
fam12386	2	2	2	2.0	0.0	0.0	2	2	0
fam12387	2	2	2	2.0	0.0	0.0	2	2	0
fam12388	2	2	2	2.0	0.0	0.0	2	2	0
fam12389	2	2	2	2.0	0.0	0.0	2	2	0
fam12390	2	2	2	2.0	0.0	0.0	2	2	0
fam12391	2	2	2	2.0	0.0	0.0	2	2	0
fam12392	2	2	2	2.0	0.0	0.0	2	2	0
fam12393	2	2	2	2.0	0.0	0.0	2	2	0
fam12394	2	2	2	2.0	0.0	0.0	2	2	0
fam12395	2	2	2	2.0	0.0	0.0	2	2	0
fam12396	2	2	2	2.0	0.0	0.0	2	2	0
fam12397	2	2	2	2.0	0.0	0.0	2	2	0
fam12398	2	2	2	2.0	0.0	0.0	2	2	0
fam12399	2	2	2	2.0	0.0	0.0	2	2	0
fam12400	2	2	2	2.0	0.0	0.0	2	2	0
fam12401	2	2	2	2.0	0.0	0.0	2	2	0
fam12402	2	2	2	2.0	0.0	0.0	2	2	0
fam12403	2	2	2	2.0	0.0	0.0	2	2	0
fam12404	2	2	2	2.0	0.0	0.0	2	2	0
fam12405	2	2	2	2.0	0.0	0.0	2	2	0
fam12406	2	2	2	2.0	0.0	0.0	2	2	0
fam12407	2	2	2	2.0	0.0	0.0	2	2	0
fam12408	2	2	2	2.0	0.0	0.0	2	2	0
fam12409	2	2	2	2.0	0.0	0.0	2	2	0
fam12410	2	2	2	2.0	0.0	0.0	2	2	0
fam12411	2	2	2	2.0	0.0	0.0	2	2	0
fam12412	2	2	2	2.0	0.0	0.0	2	2	0
fam12413	2	2	2	2.0	0.0	0.0	2	2	0
fam12414	2	2	2	2.0	0.0	0.0	2	2	0
fam12415	2	2	2	2.0	0.0	0.0	2	2	0
fam12416	2	2	2	2.0	0.0	0.0	2	2	0
fam12417	2	2	2	2.0	0.0	0.0	2	2	0
fam12418	2	2	2	2.0	0.0	0.0	2	2	0
fam12419	2	2	2	2.0	0.0	0.0	2	2	0
fam12420	2	2	2	2.0	0.0	0.0	2	2	0
fam12421	2	2	2	2.0	0.0	0.0	2	2	0
fam12422	2	2	2	2.0	0.0	0.0	2	2	0
fam12423	2	2	2	2.0	0.0	0.0	2	2	0
fam12424	2	2	2	2.0	0.0	0.0	2	2	0
fam12425	2	2	2	2.0	0.0	0.0	2	2	0
fam12426	2	2	2	2.0	0.0	0.0	2	2	0
fam12427	2	2	2	2.0	0.0	0.0	2	2	0
fam12428	2	2	2	2.0	0.0	0.0	2	2	0
fam12429	2	2	2	2.0	0.0	0.0	2	2	0
fam12430	2	2	2	2.0	0.0	0.0	2	2	0
fam12431	2	2	2	2.0	0.0	0.0	2	2	0
fam12432	2	2	2	2.0	0.0	0.0	2	2	0
fam12433	2	2	2	2.0	0.0	0.0	2	2	0
fam12434	2	2	2	2.0	0.0	0.0	2	2	0
fam12435	2	2	2	2.0	0.0	0.0	2	2	0
fam12436	2	2	2	2.0	0.0	0.0	2	2	0
fam12437	2	2	2	2.0	0.0	0.0	2	2	0
fam12438	2	2	2	2.0	0.0	0.0	2	2	0
fam12439	2	2	2	2.0	0.0	0.0	2	2	0
fam12440	2	2	2	2.0	0.0	0.0	2	2	0
fam12441	2	2	2	2.0	0.0	0.0	2	2	0
fam12442	2	2	2	2.0	0.0	0.0	2	2	0
fam12443	2	2	2	2.0	0.0	0.0	2	2	0
fam12444	2	2	2	2.0	0.0	0.0	2	2	0
fam12445	2	2	2	2.0	0.0	0.0	2	2	0
fam12446	2	2	2	2.0	0.0	0.0	2	2	0
fam12447	2	2	2	2.0	0.0	0.0	2	2	0
fam12448	2	2	2	2.0	0.0	0.0	2	2	0
fam12449	2	2	2	2.0	0.0	0.0	2	2	0
fam12450	2	2	2	2.0	0.0	0.0	2	2	0
fam12451	2	2	2	2.0	0.0	0.0	2	2	0
fam12452	2	2	2	2.0	0.0	0.0	2	2	0
fam12453	2	2	2	2.0	0.0	0.0	2	2	0
fam12454	2	2	2	2.0	0.0	0.0	2	2	0
fam12455	2	2	2	2.0	0.0	0.0	2	2	0
fam12456	2	2	2	2.0	0.0	0.0	2	2	0
fam12457	2	2	2	2.0	0.0	0.0	2	2	0
fam12458	2	2	2	2.0	0.0	0.0	2	2	0
fam12459	2	2	2	2.0	0.0	0.0	2	2	0
fam12460	2	2	2	2.0	0.0	0.0	2	2	0
fam12461	2	2	2	2.0	0.0	0.0	2	2	0
fam12462	2	2	2	2.0	0.0	0.0	2	2	0
fam12463	2	2	2	2.0	0.0	0.0	2	2	0
fam12464	2	2	2	2.0	0.0	0.0	2	2	0
fam12465	2	2	2	2.0	0.0	0.0	2	2	0
fam12466	2	2	2	2.0	0.0	0.0	2	2	0
fam12467	2	2	2	2.0	0.0	0.0	2	2	0
fam12468	2	2	2	2.0	0.0	0.0	2	2	0
fam12469	2	2	2	2.0	0.0	0.0	2	2	0
fam12470	2	2	2	2.0	0.0	0.0	2	2	0
fam12471	2	2	2	2.0	0.0	0.0	2	2	0
fam12472	2	2	2	2.0	0.0	0.0	2	2	0
fam12473	2	2	2	2.0	0.0	0.0	2	2	0
fam12474	2	2	2	2.0	0.0	0.0	2	2	0
fam12475	2	2	2	2.0	0.0	0.0	2	2	0
fam12476	2	2	2	2.0	0.0	0.0	2	2	0
fam12477	2	2	2	2.0	0.0	0.0	2	2	0
fam12478	2	2	2	2.0	0.0	0.0	2	2	0
fam12479	2	2	2	2.0	0.0	0.0	2	2	0
fam12480	2	2	2	2.0	0.0	0.0	2	2	0
fam12481	2	2	2	2.0	0.0	0.0	2	2	0
fam12482	2	2	2	2.0	0.0	0.0	2	2	0
fam12483	2	2	2	2.0	0.0	0.0	2	2	0
fam12484	2	2	2	2.0	0.0	0.0	2	2	0
fam12485	2	2	2	2.0	0.0	0.0	2	2	0
fam12486	2	2	2	2.0	0.0	0.0	2	2	0
fam12487	2	2	2	2.0	0.0	0.0	2	2	0
fam12488	2	2	2	2.0	0.0	0.0	2	2	0
fam12489	2	2	2	2.0	0.0	0.0	2	2	0
fam12490	2	2	2	2.0	0.0	0.0	2	2	0
fam12491	2	2	2	2.0	0.0	0.0	2	2	0
fam12492	2	2	2	2.0	0.0	0.0	2	2	0
fam12493	2	2	2	2.0	0.0	0.0	2	2	0
fam12494	2	2	2	2.0	0.0	0.0	2	2	0
fam12495	2	2	2	2.0	0.0	0.0	2	2	0
fam12496	2	2	2	2.0	0.0	0.0	2	2	0
fam12497	2	2	2	2.0	0.0	0.0	2	2	0
fam12498	2	2	2	2.0	0.0	0.0	2	2	0
fam12499	2	2	2	2.0	0.0	0.0	2	2	0
fam12500	2	2	2	2.0	0.0	0.0	2	2	0
fam12501	2	2	2	2.0	0.0	0.0	2	2	0
fam12502	2	2	2	2.0	0.0	0.0	2	2	0
fam12503	2	2	2	2.0	0.0	0.0	2	2	0
fam12504	2	2	2	2.0	0.0	0.0	2	2	0
fam12505	2	2	2	2.0	0.0	0.0	2	2	0
fam12506	2	2	2	2.0	0.0	0.0	2	2	0
fam12507	2	2	2	2.0	0.0	0.0	2	2	0
fam12508	2	2	2	2.0	0.0	0.0	2	2	0
fam12509	2	2	2	2.0	0.0	0.0	2	2	0
fam12510	2	2	2	2.0	0.0	0.0	2	2	0
fam12511	2	2	2	2.0	0.0	0.0	2	2	0
fam12512	2	2	2	2.0	0.0	0.0	2	2	0
fam12513	2	2	2	2.0	0.0	0.0	2	2	0
fam12514	2	2	2	2.0	0.0	0.0	2	2	0
fam12515	2	2	2	2.0	0.0	0.0	2	2	0
fam12516	2	2	2	2.0	0.0	0.0	2	2	0
fam12517	2	2	2	2.0	0.0	0.0	2	2	0
fam12518	2	2	2	2.0	0.0	0.0	2	2	0
fam12519	2	2	2	2.0	0.0	0.0	2	2	0
fam12520	2	2	2	2.0	0.0	0.0	2	2	0
fam12521	2	2	2	2.0	0.0	0.0	2	2	0
fam12522	2	2	2	2.0	0.0	0.0	2	2	0
fam12523	2	2	2	2.0	0.0	0.0	2	2	0
fam12524	2	2	2	2.0	0.0	0.0	2	2	0
fam12525	2	2	2	2.0	0.0	0.0	2	2	0
fam12526	2	2	2	2.0	0.0	0.0	2	2	0
fam12527	2	2	2	2.0	0.0	0.0	2	2	0
fam12528	2	2	2	2.0	0.0	0.0	2	2	0
fam12529	2	2	2	2.0	0.0	0.0	2	2	0
fam12530	2	2	2	2.0	0.0	0.0	2	2	0
fam12531	2	2	2	2.0	0.0	0.0	2	2	0
fam12532	2	2	2	2.0	0.0	0.0	2	2	0
fam12533	2	2	2	2.0	0.0	0.0	2	2	0
fam12534	2	2	2	2.0	0.0	0.0	2	2	0
fam12535	2	2	2	2.0	0.0	0.0	2	2	0
fam12536	2	2	2	2.0	0.0	0.0	2	2	0
fam12537	2	2	2	2.0	0.0	0.0	2	2	0
fam12538	2	2	2	2.0	0.0	0.0	2	2	0
fam12539	2	2	2	2.0	0.0	0.0	2	2	0
fam12540	2	2	2	2.0	0.0	0.0	2	2	0
fam12541	2	2	2	2.0	0.0	0.0	2	2	0
fam12542	2	2	2	2.0	0.0	0.0	2	2	0
fam12543	2	2	2	2.0	0.0	0.0	2	2	0
fam12544	2	2	2	2.0	0.0	0.0	2	2	0
fam12545	2	2	2	2.0	0.0	0.0	2	2	0
fam12546	2	2	2	2.0	0.0	0.0	2	2	0
fam12547	2	2	2	2.0	0.0	0.0	2	2	0
fam12548	2	2	2	2.0	0.0	0.0	2	2	0
fam12549	2	2	2	2.0	0.0	0.0	2	2	0
fam12550	2	2	2	2.0	0.0	0.0	2	2	0
fam12551	2	2	2	2.0	0.0	0.0	2	2	0
fam12552	2	2	2	2.0	0.0	0.0	2	2	0
fam12553	2	2	2	2.0	0.0	0.0	2	2	0
fam12554	2	2	2	2.0	0.0	0.0	2	2	0
fam12555	2	2	2	2.0	0.0	0.0	2	2	0
fam12556	2	2	2	2.0	0.0	0.0	2	2	0
fam12557	2	2	2	2.0	0.0	0.0	2	2	0
fam12558	2	2	2	2.0	0.0	0.0	2	2	0
fam12559	2	2	2	2.0	0.0	0.0	2	2	0
fam12560	2	2	2	2.0	0.0	0.0	2	2	0
fam12561	2	2	2	2.0	0.0	0.0	2	2	0
fam12562	2	2	2	2.0	0.0	0.0	2	2	0
fam12563	2	2	2	2.0	0.0	0.0	2	2	0
fam12564	2	2	2	2.0	0.0	0.0	2	2	0
fam12565	2	2	2	2.0	0.0	0.0	2	2	0
fam12566	2	2	2	2.0	0.0	0.0	2	2	0
fam12567	2	2	2	2.0	0.0	0.0	2	2	0
fam12568	2	2	2	2.0	0.0	0.0	2	2	0
fam12569	2	2	2	2.0	0.0	0.0	2	2	0
fam12570	2	2	2	2.0	0.0	0.0	2	2	0
fam12571	2	2	2	2.0	0.0	0.0	2	2	0
fam12572	2	2	2	2.0	0.0	0.0	2	2	0
fam12573	2	2	2	2.0	0.0	0.0	2	2	0
fam12574	2	2	2	2.0	0.0	0.0	2	2	0
fam12575	2	2	2	2.0	0.0	0.0	2	2	0
fam12576	2	2	2	2.0	0.0	0.0	2	2	0
fam12577	2	2	2	2.0	0.0	0.0	2	2	0
fam12578	2	2	2	2.0	0.0	0.0	2	2	0
fam12579	2	2	2	2.0	0.0	0.0	2	2	0
fam12580	2	2	2	2.0	0.0	0.0	2	2	0
fam12581	2	2	2	2.0	0.0	0.0	2	2	0
fam12582	2	2	2	2.0	0.0	0.0	2	2	0
fam12583	2	2	2	2.0	0.0	0.0	2	2	0
fam12584	2	2	2	2.0	0.0	0.0	2	2	0
fam12585	2	2	2	2.0	0.0	0.0	2	2	0
fam12586	2	2	2	2.0	0.0	0.0	2	2	0
fam12587	2	2	2	2.0	0.0	0.0	2	2	0
fam12588	2	2	2	2.0	0.0	0.0	2	2	0
fam12589	2	2	2	2.0	0.0	0.0	2	2	0
fam12590	2	2	2	2.0	0.0	0.0	2	2	0
fam12591	2	2	2	2.0	0.0	0.0	2	2	0
fam12592	2	2	2	2.0	0.0	0.0	2	2	0
fam12593	2	2	2	2.0	0.0	0.0	2	2	0
fam12594	2	2	2	2.0	0.0	0.0	2	2	0
fam12595	2	2	2	2.0	0.0	0.0	2	2	0
fam12596	2	2	2	2.0	0.0	0.0	2	2	0
fam12597	2	2	2	2.0	0.0	0.0	2	2	0
fam12598	2	2	2	2.0	0.0	0.0	2	2	0
fam12599	2	2	2	2.0	0.0	0.0	2	2	0
fam12600	2	2	2	2.0	0.0	0.0	2	2	0
fam12601	2	2	2	2.0	0.0	0.0	2	2	0
fam12602	2	2	2	2.0	0.0	0.0	2	2	0
fam12603	2	2	2	2.0	0.0	0.0	2	2	0
fam12604	2	2	2	2.0	0.0	0.0	2	2	0
fam12605	2	2	2	2.0	0.0	0.0	2	2	0
fam12606	2	2	2	2.0	0.0	0.0	2	2	0
fam12607	2	2	2	2.0	0.0	0.0	2	2	0
fam12608	2	2	2	2.0	0.0	0.0	2	2	0
fam12609	2	2	2	2.0	0.0	0.0	2	2	0
fam12610	2	2	2	2.0	0.0	0.0	2	2	0
fam12611	2	2	2	2.0	0.0	0.0	2	2	0
fam12612	2	2	2	2.0	0.0	0.0	2	2	0
fam12613	2	2	2	2.0	0.0	0.0	2	2	0
fam12614	2	2	2	2.0	0.0	0.0	2	2	0
fam12615	2	2	2	2.0	0.0	0.0	2	2	0
fam12616	2	2	2	2.0	0.0	0.0	2	2	0
fam12617	2	2	2	2.0	0.0	0.0	2	2	0
fam12618	2	2	2	2.0	0.0	0.0	2	2	0
fam12619	2	2	2	2.0	0.0	0.0	2	2	0
fam12620	2	2	2	2.0	0.0	0.0	2	2	0
fam12621	2	2	2	2.0	0.0	0.0	2	2	0
fam12622	2	2	2	2.0	0.0	0.0	2	2	0
fam12623	2	2	2	2.0	0.0	0.0	2	2	0
fam12624	2	2	2	2.0	0.0	0.0	2	2	0
fam12625	2	2	2	2.0	0.0	0.0	2	2	0
fam12626	2	2	2	2.0	0.0	0.0	2	2	0
fam12627	2	2	2	2.0	0.0	0.0	2	2	0
fam12628	2	2	2	2.0	0.0	0.0	2	2	0
fam12629	2	2	2	2.0	0.0	0.0	2	2	0
fam12630	2	2	2	2.0	0.0	0.0	2	2	0
fam12631	2	2	2	2.0	0.0	0.0	2	2	0
fam12632	2	2	2	2.0	0.0	0.0	2	2	0
fam12633	2	2	2	2.0	0.0	0.0	2	2	0
fam12634	2	2	2	2.0	0.0	0.0	2	2	0
fam12635	2	2	2	2.0	0.0	0.0	2	2	0
fam12636	2	2	2	2.0	0.0	0.0	2	2	0
fam12637	2	2	2	2.0	0.0	0.0	2	2	0
fam12638	2	2	2	2.0	0.0	0.0	2	2	0
fam12639	2	2	2	2.0	0.0	0.0	2	2	0
fam12640	2	2	2	2.0	0.0	0.0	2	2	0
fam12641	2	2	2	2.0	0.0	0.0	2	2	0
fam12642	2	2	2	2.0	0.0	0.0	2	2	0
fam12643	2	2	2	2.0	0.0	0.0	2	2	0
fam12644	2	2	2	2.0	0.0	0.0	2	2	0
fam12645	2	2	2	2.0	0.0	0.0	2	2	0
fam12646	2	2	2	2.0	0.0	0.0	2	2	0
fam12647	2	2	2	2.0	0.0	0.0	2	2	0
fam12648	2	2	2	2.0	0.0	0.0	2	2	0
fam12649	2	2	2	2.0	0.0	0.0	2	2	0
fam12650	2	2	2	2.0	0.0	0.0	2	2	0
fam12651	2	2	2	2.0	0.0	0.0	2	2	0
fam12652	2	2	2	2.0	0.0	0.0	2	2	0
fam12653	2	2	2	2.0	0.0	0.0	2	2	0
fam12654	2	2	2	2.0	0.0	0.0	2	2	0
fam12655	2	2	2	2.0	0.0	0.0	2	2	0
fam12656	2	2	2	2.0	0.0	0.0	2	2	0
fam12657	2	2	2	2.0	0.0	0.0	2	2	0
fam12658	2	2	2	2.0	0.0	0.0	2	2	0
fam12659	2	2	2	2.0	0.0	0.0	2	2	0
fam12660	2	2	2	2.0	0.0	0.0	2	2	0
fam12661	2	2	2	2.0	0.0	0.0	2	2	0
fam12662	2	2	2	2.0	0.0	0.0	2	2	0
fam12663	2	2	2	2.0	0.0	0.0	2	2	0
fam12664	2	2	2	2.0	0.0	0.0	2	2	0
fam12665	2	2	2	2.0	0.0	0.0	2	2	0
fam12666	2	2	2	2.0	0.0	0.0	2	2	0
fam12667	2	2	2	2.0	0.0	0.0	2	2	0
fam12668	2	2	2	2.0	0.0	0.0	2	2	0
fam12669	2	2	2	2.0	0.0	0.0	2	2	0
fam12670	2	2	2	2.0	0.0	0.0	2	2	0
fam12671	2	2	2	2.0	0.0	0.0	2	2	0
fam12672	2	2	2	2.0	0.0	0.0	2	2	0
fam12673	2	2	2	2.0	0.0	0.0	2	2	0
fam12674	2	2	2	2.0	0.0	0.0	2	2	0
fam12675	2	2	2	2.0	0.0	0.0	2	2	0
fam12676	2	2	2	2.0	0.0	0.0	2	2	0
fam12677	2	2	2	2.0	0.0	0.0	2	2	0
fam12678	2	2	2	2.0	0.0	0.0	2	2	0
fam12679	2	2	2	2.0	0.0	0.0	2	2	0
fam12680	2	2	2	2.0	0.0	0.0	2	2	0
fam12681	2	2	2	2.0	0.0	0.0	2	2	0
fam12682	2	2	2	2.0	0.0	0.0	2	2	0
fam12683	2	2	2	2.0	0.0	0.0	2	2	0
fam12684	2	2	2	2.0	0.0	0.0	2	2	0
fam12685	2	2	2	2.0	0.0	0.0	2	2	0
fam12686	2	2	2	2.0	0.0	0.0	2	2	0
fam12687	2	2	2	2.0	0.0	0.0	2	2	0
fam12688	2	2	2	2.0	0.0	0.0	2	2	0
fam12689	2	2	2	2.0	0.0	0.0	2	2	0
fam12690	2	2	2	2.0	0.0	0.0	2	2	0
fam12691	2	2	2	2.0	0.0	0.0	2	2	0
fam12692	2	2	2	2.0	0.0	0.0	2	2	0
fam12693	2	2	2	2.0	0.0	0.0	2	2	0
fam12694	2	2	2	2.0	0.0	0.0	2	2	0
fam12695	2	2	2	2.0	0.0	0.0	2	2	0
fam12696	2	2	2	2.0	0.0	0.0	2	2	0
fam12697	2	2	2	2.0	0.0	0.0	2	2	0
fam12698	2	2	2	2.0	0.0	0.0	2	2	0
fam12699	2	2	2	2.0	0.0	0.0	2	2	0
fam12700	2	2	2	2.0	0.0	0.0	2	2	0
fam12701	2	2	2	2.0	0.0	0.0	2	2	0
fam12702	2	2	2	2.0	0.0	0.0	2	2	0
fam12703	2	2	2	2.0	0.0	0.0	2	2	0
fam12704	2	2	2	2.0	0.0	0.0	2	2	0
fam12705	2	2	2	2.0	0.0	0.0	2	2	0
fam12706	2	2	2	2.0	0.0	0.0	2	2	0
fam12707	2	2	2	2.0	0.0	0.0	2	2	0
fam12708	2	2	2	2.0	0.0	0.0	2	2	0
fam12709	2	2	2	2.0	0.0	0.0	2	2	0
fam12710	2	2	2	2.0	0.0	0.0	2	2	0
fam12711	2	2	2	2.0	0.0	0.0	2	2	0
fam12712	2	2	2	2.0	0.0	0.0	2	2	0
fam12713	2	2	2	2.0	0.0	0.0	2	2	0
fam12714	2	2	2	2.0	0.0	0.0	2	2	0
fam12715	2	2	2	2.0	0.0	0.0	2	2	0
fam12716	2	2	2	2.0	0.0	0.0	2	2	0
fam12717	2	2	2	2.0	0.0	0.0	2	2	0
fam12718	2	2	2	2.0	0.0	0.0	2	2	0
fam12719	2	2	2	2.0	0.0	0.0	2	2	0
fam12720	2	2	2	2.0	0.0	0.0	2	2	0
fam12721	2	2	2	2.0	0.0	0.0	2	2	0
fam12722	2	2	2	2.0	0.0	0.0	2	2	0
fam12723	2	2	2	2.0	0.0	0.0	2	2	0
fam12724	2	2	2	2.0	0.0	0.0	2	2	0
fam12725	2	2	2	2.0	0.0	0.0	2	2	0
fam12726	2	2	2	2.0	0.0	0.0	2	2	0
fam12727	2	2	2	2.0	0.0	0.0	2	2	0
fam12728	2	2	2	2.0	0.0	0.0	2	2	0
fam12729	2	2	2	2.0	0.0	0.0	2	2	0
fam12730	2	2	2	2.0	0.0	0.0	2	2	0
fam12731	2	2	2	2.0	0.0	0.0	2	2	0
fam12732	2	2	2	2.0	0.0	0.0	2	2	0
fam12733	2	2	2	2.0	0.0	0.0	2	2	0
fam12734	2	2	2	2.0	0.0	0.0	2	2	0
fam12735	2	2	2	2.0	0.0	0.0	2	2	0
fam12736	2	2	2	2.0	0.0	0.0	2	2	0
fam12737	2	2	2	2.0	0.0	0.0	2	2	0
fam12738	2	2	2	2.0	0.0	0.0	2	2	0
fam12739	2	2	2	2.0	0.0	0.0	2	2	0
fam12740	2	2	2	2.0	0.0	0.0	2	2	0
fam12741	2	2	2	2.0	0.0	0.0	2	2	0
fam12742	2	2	2	2.0	0.0	0.0	2	2	0
fam12743	2	2	2	2.0	0.0	0.0	2	2	0
fam12744	2	2	2	2.0	0.0	0.0	2	2	0
fam12745	2	2	2	2.0	0.0	0.0	2	2	0
fam12746	2	2	2	2.0	0.0	0.0	2	2	0
fam12747	2	2	2	2.0	0.0	0.0	2	2	0
fam12748	2	2	2	2.0	0.0	0.0	2	2	0
fam12749	2	2	2	2.0	0.0	0.0	2	2	0
fam12750	2	2	2	2.0	0.0	0.0	2	2	0
fam12751	2	2	2	2.0	0.0	0.0	2	2	0
fam12752	2	2	2	2.0	0.0	0.0	2	2	0
fam12753	2	2	2	2.0	0.0	0.0	2	2	0
fam12754	2	2	2	2.0	0.0	0.0	2	2	0
fam12755	2	2	2	2.0	0.0	0.0	2	2	0
fam12756	2	2	2	2.0	0.0	0.0	2	2	0
fam12757	2	2	2	2.0	0.0	0.0	2	2	0
fam12758	2	2	2	2.0	0.0	0.0	2	2	0
fam12759	2	2	2	2.0	0.0	0.0	2	2	0
fam12760	2	2	2	2.0	0.0	0.0	2	2	0
fam12761	2	2	2	2.0	0.0	0.0	2	2	0
fam12762	2	2	2	2.0	0.0	0.0	2	2	0
fam12763	2	2	2	2.0	0.0	0.0	2	2	0
fam12764	2	2	2	2.0	0.0	0.0	2	2	0
fam12765	2	2	2	2.0	0.0	0.0	2	2	0
fam12766	2	2	2	2.0	0.0	0.0	2	2	0
fam12767	2	2	2	2.0	0.0	0.0	2	2	0
fam12768	2	2	2	2.0	0.0	0.0	2	2	0
fam12769	2	2	2	2.0	0.0	0.0	2	2	0
fam12770	2	2	2	2.0	0.0	0.0	2	2	0
fam12771	2	2	2	2.0	0.0	0.0	2	2	0
fam12772	2	2	2	2.0	0.0	0.0	2	2	0
fam12773	2	2	2	2.0	0.0	0.0	2	2	0
fam12774	2	2	2	2.0	0.0	0.0	2	2	0
fam12775	2	2	2	2.0	0.0	0.0	2	2	0
fam12776	2	2	2	2.0	0.0	0.0	2	2	0
fam12777	2	2	2	2.0	0.0	0.0	2	2	0
fam12778	2	2	2	2.0	0.0	0.0	2	2	0
fam12779	2	2	2	2.0	0.0	0.0	2	2	0
fam12780	2	2	2	2.0	0.0	0.0	2	2	0
fam12781	2	2	2	2.0	0.0	0.0	2	2	0
fam12782	2	2	2	2.0	0.0	0.0	2	2	0
fam12783	2	2	2	2.0	0.0	0.0	2	2	0
fam12784	2	2	2	2.0	0.0	0.0	2	2	0
fam12785	2	2	2	2.0	0.0	0.0	2	2	0
fam12786	2	2	2	2.0	0.0	0.0	2	2	0
fam12787	2	2	2	2.0	0.0	0.0	2	2	0
fam12788	2	2	2	2.0	0.0	0.0	2	2	0
fam12789	2	2	2	2.0	0.0	0.0	2	2	0
fam12790	2	2	2	2.0	0.0	0.0	2	2	0
fam12791	2	2	2	2.0	0.0	0.0	2	2	0
fam12792	2	2	2	2.0	0.0	0.0	2	2	0
fam12793	2	2	2	2.0	0.0	0.0	2	2	0
fam12794	2	2	2	2.0	0.0	0.0	2	2	0
fam12795	2	2	2	2.0	0.0	0.0	2	2	0
fam12796	2	2	2	2.0	0.0	0.0	2	2	0
fam12797	2	2	2	2.0	0.0	0.0	2	2	0
fam12798	2	2	2	2.0	0.0	0.0	2	2	0
fam12799	2	2	2	2.0	0.0	0.0	2	2	0
fam12800	2	2	2	2.0	0.0	0.0	2	2	0
fam12801	2	2	2	2.0	0.0	0.0	2	2	0
fam12802	2	2	2	2.0	0.0	0.0	2	2	0
fam12803	2	2	2	2.0	0.0	0.0	2	2	0
fam12804	2	2	2	2.0	0.0	0.0	2	2	0
fam12805	2	2	2	2.0	0.0	0.0	2	2	0
fam12806	2	2	2	2.0	0.0	0.0	2	2	0
fam12807	2	2	2	2.0	0.0	0.0	2	2	0
fam12808	2	2	2	2.0	0.0	0.0	2	2	0
fam12809	2	2	2	2.0	0.0	0.0	2	2	0
fam12810	2	2	2	2.0	0.0	0.0	2	2	0
fam12811	2	2	2	2.0	0.0	0.0	2	2	0
fam12812	2	2	2	2.0	0.0	0.0	2	2	0
fam12813	2	2	2	2.0	0.0	0.0	2	2	0
fam12814	2	2	2	2.0	0.0	0.0	2	2	0
fam12815	2	2	2	2.0	0.0	0.0	2	2	0
fam12816	2	2	2	2.0	0.0	0.0	2	2	0
fam12817	2	2	2	2.0	0.0	0.0	2	2	0
fam12818	2	2	2	2.0	0.0	0.0	2	2	0
fam12819	2	2	2	2.0	0.0	0.0	2	2	0
fam12820	2	2	2	2.0	0.0	0.0	2	2	0
fam12821	2	2	2	2.0	0.0	0.0	2	2	0
fam12822	2	2	2	2.0	0.0	0.0	2	2	0
fam12823	2	2	2	2.0	0.0	0.0	2	2	0
fam12824	2	2	2	2.0	0.0	0.0	2	2	0
fam12825	2	2	2	2.0	0.0	0.0	2	2	0
fam12826	2	2	2	2.0	0.0	0.0	2	2	0
fam12827	2	2	2	2.0	0.0	0.0	2	2	0
fam12828	2	2	2	2.0	0.0	0.0	2	2	0
fam12829	2	2	2	2.0	0.0	0.0	2	2	0
fam12830	2	2	2	2.0	0.0	0.0	2	2	0
fam12831	2	2	2	2.0	0.0	0.0	2	2	0
fam12832	2	2	2	2.0	0.0	0.0	2	2	0
fam12833	2	2	2	2.0	0.0	0.0	2	2	0
fam12834	2	2	2	2.0	0.0	0.0	2	2	0
fam12835	2	2	2	2.0	0.0	0.0	2	2	0
fam12836	2	2	2	2.0	0.0	0.0	2	2	0
fam12837	2	2	2	2.0	0.0	0.0	2	2	0
fam12838	2	2	2	2.0	0.0	0.0	2	2	0
fam12839	2	2	2	2.0	0.0	0.0	2	2	0
fam12840	2	2	2	2.0	0.0	0.0	2	2	0
fam12841	2	2	2	2.0	0.0	0.0	2	2	0
fam12842	2	2	2	2.0	0.0	0.0	2	2	0
fam12843	2	2	2	2.0	0.0	0.0	2	2	0
fam12844	2	2	2	2.0	0.0	0.0	2	2	0
fam12845	2	2	2	2.0	0.0	0.0	2	2	0
fam12846	2	2	2	2.0	0.0	0.0	2	2	0
fam12847	2	2	2	2.0	0.0	0.0	2	2	0
fam12848	2	2	2	2.0	0.0	0.0	2	2	0
fam12849	2	2	2	2.0	0.0	0.0	2	2	0
fam12850	2	2	2	2.0	0.0	0.0	2	2	0
fam12851	2	2	2	2.0	0.0	0.0	2	2	0
fam12852	2	2	2	2.0	0.0	0.0	2	2	0
fam12853	2	2	2	2.0	0.0	0.0	2	2	0
fam12854	2	2	2	2.0	0.0	0.0	2	2	0
fam12855	2	2	2	2.0	0.0	0.0	2	2	0
fam12856	2	2	2	2.0	0.0	0.0	2	2	0
fam12857	2	2	2	2.0	0.0	0.0	2	2	0
fam12858	2	2	2	2.0	0.0	0.0	2	2	0
fam12859	2	2	2	2.0	0.0	0.0	2	2	0
fam12860	2	2	2	2.0	0.0	0.0	2	2	0
fam12861	2	2	2	2.0	0.0	0.0	2	2	0
fam12862	2	2	2	2.0	0.0	0.0	2	2	0
fam12863	2	2	2	2.0	0.0	0.0	2	2	0
fam12864	2	2	2	2.0	0.0	0.0	2	2	0
fam12865	2	2	2	2.0	0.0	0.0	2	2	0
fam12866	2	2	2	2.0	0.0	0.0	2	2	0
fam12867	2	2	2	2.0	0.0	0.0	2	2	0
fam12868	2	2	2	2.0	0.0	0.0	2	2	0
fam12869	2	2	2	2.0	0.0	0.0	2	2	0
fam12870	2	2	2	2.0	0.0	0.0	2	2	0
fam12871	2	2	2	2.0	0.0	0.0	2	2	0
fam12872	2	2	2	2.0	0.0	0.0	2	2	0
fam12873	2	2	2	2.0	0.0	0.0	2	2	0
fam12874	2	2	2	2.0	0.0	0.0	2	2	0
fam12875	2	2	2	2.0	0.0	0.0	2	2	0
fam12876	2	2	2	2.0	0.0	0.0	2	2	0
fam12877	2	2	2	2.0	0.0	0.0	2	2	0
fam12878	2	2	2	2.0	0.0	0.0	2	2	0
fam12879	2	2	2	2.0	0.0	0.0	2	2	0
fam12880	2	2	2	2.0	0.0	0.0	2	2	0
fam12881	2	2	2	2.0	0.0	0.0	2	2	0
fam12882	2	2	2	2.0	0.0	0.0	2	2	0
fam12883	2	2	2	2.0	0.0	0.0	2	2	0
fam12884	2	2	2	2.0	0.0	0.0	2	2	0
fam12885	2	2	2	2.0	0.0	0.0	2	2	0
fam12886	2	2	2	2.0	0.0	0.0	2	2	0
fam12887	2	2	2	2.0	0.0	0.0	2	2	0
fam12888	2	2	2	2.0	0.0	0.0	2	2	0
fam12889	2	2	2	2.0	0.0	0.0	2	2	0
fam12890	2	2	2	2.0	0.0	0.0	2	2	0
fam12891	2	2	2	2.0	0.0	0.0	2	2	0
fam12892	2	2	2	2.0	0.0	0.0	2	2	0
fam12893	2	2	2	2.0	0.0	0.0	2	2	0
fam12894	2	2	2	2.0	0.0	0.0	2	2	0
fam12895	2	2	2	2.0	0.0	0.0	2	2	0
fam12896	2	2	2	2.0	0.0	0.0	2	2	0
fam12897	2	2	2	2.0	0.0	0.0	2	2	0
fam12898	2	2	2	2.0	0.0	0.0	2	2	0
fam12899	2	2	2	2.0	0.0	0.0	2	2	0
fam12900	2	2	2	2.0	0.0	0.0	2	2	0
fam12901	2	2	2	2.0	0.0	0.0	2	2	0
fam12902	2	2	2	2.0	0.0	0.0	2	2	0
fam12903	2	2	2	2.0	0.0	0.0	2	2	0
fam12904	2	2	2	2.0	0.0	0.0	2	2	0
fam12905	2	2	2	2.0	0.0	0.0	2	2	0
fam12906	2	2	2	2.0	0.0	0.0	2	2	0
fam12907	2	2	2	2.0	0.0	0.0	2	2	0
fam12908	2	2	2	2.0	0.0	0.0	2	2	0
fam12909	2	2	2	2.0	0.0	0.0	2	2	0
fam12910	2	2	2	2.0	0.0	0.0	2	2	0
fam12911	2	2	2	2.0	0.0	0.0	2	2	0
fam12912	2	2	2	2.0	0.0	0.0	2	2	0
fam12913	2	2	2	2.0	0.0	0.0	2	2	0
fam12914	2	2	2	2.0	0.0	0.0	2	2	0
fam12915	2	2	2	2.0	0.0	0.0	2	2	0
fam12916	2	2	2	2.0	0.0	0.0	2	2	0
fam12917	2	2	2	2.0	0.0	0.0	2	2	0
fam12918	2	2	2	2.0	0.0	0.0	2	2	0
fam12919	2	2	2	2.0	0.0	0.0	2	2	0
fam12920	2	2	2	2.0	0.0	0.0	2	2	0
fam12921	2	2	2	2.0	0.0	0.0	2	2	0
fam12922	2	2	2	2.0	0.0	0.0	2	2	0
fam12923	2	2	2	2.0	0.0	0.0	2	2	0
fam12924	2	2	2	2.0	0.0	0.0	2	2	0
fam12925	2	2	2	2.0	0.0	0.0	2	2	0
fam12926	2	2	2	2.0	0.0	0.0	2	2	0
fam12927	2	2	2	2.0	0.0	0.0	2	2	0
fam12928	2	2	2	2.0	0.0	0.0	2	2	0
fam12929	2	2	2	2.0	0.0	0.0	2	2	0
fam12930	2	2	2	2.0	0.0	0.0	2	2	0
fam12931	2	2	2	2.0	0.0	0.0	2	2	0
fam12932	2	2	2	2.0	0.0	0.0	2	2	0
fam12933	2	2	2	2.0	0.0	0.0	2	2	0
fam12934	2	2	2	2.0	0.0	0.0	2	2	0
fam12935	2	2	2	2.0	0.0	0.0	2	2	0
fam12936	2	2	2	2.0	0.0	0.0	2	2	0
fam12937	2	2	2	2.0	0.0	0.0	2	2	0
fam12938	2	2	2	2.0	0.0	0.0	2	2	0
fam12939	2	2	2	2.0	0.0	0.0	2	2	0
fam12940	2	2	2	2.0	0.0	0.0	2	2	0
fam12941	2	2	2	2.0	0.0	0.0	2	2	0
fam12942	2	2	2	2.0	0.0	0.0	2	2	0
fam12943	2	2	2	2.0	0.0	0.0	2	2	0
fam12944	2	2	2	2.0	0.0	0.0	2	2	0
fam12945	2	2	2	2.0	0.0	0.0	2	2	0
fam12946	2	2	2	2.0	0.0	0.0	2	2	0
fam12947	2	2	2	2.0	0.0	0.0	2	2	0
fam12948	2	2	2	2.0	0.0	0.0	2	2	0
fam12949	2	2	2	2.0	0.0	0.0	2	2	0
fam12950	2	2	2	2.0	0.0	0.0	2	2	0
fam12951	2	2	2	2.0	0.0	0.0	2	2	0
fam12952	2	2	2	2.0	0.0	0.0	2	2	0
fam12953	2	2	2	2.0	0.0	0.0	2	2	0
fam12954	2	2	2	2.0	0.0	0.0	2	2	0
fam12955	2	2	2	2.0	0.0	0.0	2	2	0
fam12956	2	2	2	2.0	0.0	0.0	2	2	0
fam12957	2	2	2	2.0	0.0	0.0	2	2	0
fam12958	2	2	2	2.0	0.0	0.0	2	2	0
fam12959	2	2	2	2.0	0.0	0.0	2	2	0
fam12960	2	2	2	2.0	0.0	0.0	2	2	0
fam12961	2	2	2	2.0	0.0	0.0	2	2	0
fam12962	2	2	2	2.0	0.0	0.0	2	2	0
fam12963	2	2	2	2.0	0.0	0.0	2	2	0
fam12964	2	2	2	2.0	0.0	0.0	2	2	0
fam12965	2	2	2	2.0	0.0	0.0	2	2	0
fam12966	2	2	2	2.0	0.0	0.0	2	2	0
fam12967	2	2	2	2.0	0.0	0.0	2	2	0
fam12968	2	2	2	2.0	0.0	0.0	2	2	0
fam12969	2	2	2	2.0	0.0	0.0	2	2	0
fam12970	2	2	2	2.0	0.0	0.0	2	2	0
fam12971	2	2	2	2.0	0.0	0.0	2	2	0
fam12972	2	2	2	2.0	0.0	0.0	2	2	0
fam12973	2	2	2	2.0	0.0	0.0	2	2	0
fam12974	2	2	2	2.0	0.0	0.0	2	2	0
fam12975	2	2	2	2.0	0.0	0.0	2	2	0
fam12976	2	2	2	2.0	0.0	0.0	2	2	0
fam12977	2	2	2	2.0	0.0	0.0	2	2	0
fam12978	2	2	2	2.0	0.0	0.0	2	2	0
fam12979	2	2	2	2.0	0.0	0.0	2	2	0
fam12980	2	2	2	2.0	0.0	0.0	2	2	0
fam12981	2	2	2	2.0	0.0	0.0	2	2	0
fam12982	2	2	2	2.0	0.0	0.0	2	2	0
fam12983	2	2	2	2.0	0.0	0.0	2	2	0
fam12984	2	2	2	2.0	0.0	0.0	2	2	0
fam12985	2	2	2	2.0	0.0	0.0	2	2	0
fam12986	2	2	2	2.0	0.0	0.0	2	2	0
fam12987	2	2	2	2.0	0.0	0.0	2	2	0
fam12988	2	2	2	2.0	0.0	0.0	2	2	0
fam12989	2	2	2	2.0	0.0	0.0	2	2	0
fam12990	2	2	2	2.0	0.0	0.0	2	2	0
fam12991	2	2	2	2.0	0.0	0.0	2	2	0
fam12992	2	2	2	2.0	0.0	0.0	2	2	0
fam12993	2	2	2	2.0	0.0	0.0	2	2	0
fam12994	2	2	2	2.0	0.0	0.0	2	2	0
fam12995	2	2	2	2.0	0.0	0.0	2	2	0
fam12996	2	2	2	2.0	0.0	0.0	2	2	0
fam12997	2	2	2	2.0	0.0	0.0	2	2	0
fam12998	2	2	2	2.0	0.0	0.0	2	2	0
fam12999	2	2	2	2.0	0.0	0.0	2	2	0
fam13000	2	2	2	2.0	0.0	0.0	2	2	0
fam13001	2	2	2	2.0	0.0	0.0	2	2	0
fam13002	2	2	2	2.0	0.0	0.0	2	2	0
fam13003	2	2	2	2.0	0.0	0.0	2	2	0
fam13004	2	2	2	2.0	0.0	0.0	2	2	0
fam13005	2	2	2	2.0	0.0	0.0	2	2	0
fam13006	2	2	2	2.0	0.0	0.0	2	2	0
fam13007	2	2	2	2.0	0.0	0.0	2	2	0
fam13008	2	2	2	2.0	0.0	0.0	2	2	0
fam13009	2	2	2	2.0	0.0	0.0	2	2	0
fam13010	2	2	2	2.0	0.0	0.0	2	2	0
fam13011	2	2	2	2.0	0.0	0.0	2	2	0
fam13012	2	2	2	2.0	0.0	0.0	2	2	0
fam13013	2	2	2	2.0	0.0	0.0	2	2	0
fam13014	2	2	2	2.0	0.0	0.0	2	2	0
fam13015	2	2	2	2.0	0.0	0.0	2	2	0
fam13016	2	2	2	2.0	0.0	0.0	2	2	0
fam13017	2	2	2	2.0	0.0	0.0	2	2	0
fam13018	2	2	2	2.0	0.0	0.0	2	2	0
fam13019	2	2	2	2.0	0.0	0.0	2	2	0
fam13020	2	2	2	2.0	0.0	0.0	2	2	0
fam13021	2	2	2	2.0	0.0	0.0	2	2	0
fam13022	2	2	2	2.0	0.0	0.0	2	2	0
fam13023	2	2	2	2.0	0.0	0.0	2	2	0
fam13024	2	2	2	2.0	0.0	0.0	2	2	0
fam13025	2	2	2	2.0	0.0	0.0	2	2	0
fam13026	2	2	2	2.0	0.0	0.0	2	2	0
fam13027	2	2	2	2.0	0.0	0.0	2	2	0
fam13028	2	2	2	2.0	0.0	0.0	2	2	0
fam13029	2	2	2	2.0	0.0	0.0	2	2	0
fam13030	2	2	2	2.0	0.0	0.0	2	2	0
fam13031	2	2	2	2.0	0.0	0.0	2	2	0
fam13032	2	2	2	2.0	0.0	0.0	2	2	0
fam13033	2	2	2	2.0	0.0	0.0	2	2	0
fam13034	2	2	2	2.0	0.0	0.0	2	2	0
fam13035	2	2	2	2.0	0.0	0.0	2	2	0
fam13036	2	2	2	2.0	0.0	0.0	2	2	0
fam13037	2	2	2	2.0	0.0	0.0	2	2	0
fam13038	2	2	2	2.0	0.0	0.0	2	2	0
fam13039	2	2	2	2.0	0.0	0.0	2	2	0
fam13040	2	2	2	2.0	0.0	0.0	2	2	0
fam13041	2	2	2	2.0	0.0	0.0	2	2	0
fam13042	2	2	2	2.0	0.0	0.0	2	2	0
fam13043	2	2	2	2.0	0.0	0.0	2	2	0
fam13044	2	2	2	2.0	0.0	0.0	2	2	0
fam13045	2	2	2	2.0	0.0	0.0	2	2	0
fam13046	2	2	2	2.0	0.0	0.0	2	2	0
fam13047	2	2	2	2.0	0.0	0.0	2	2	0
fam13048	2	2	2	2.0	0.0	0.0	2	2	0
fam13049	2	2	2	2.0	0.0	0.0	2	2	0
fam13050	2	2	2	2.0	0.0	0.0	2	2	0
fam13051	2	2	2	2.0	0.0	0.0	2	2	0
fam13052	2	2	2	2.0	0.0	0.0	2	2	0
fam13053	2	2	2	2.0	0.0	0.0	2	2	0
fam13054	2	2	2	2.0	0.0	0.0	2	2	0
fam13055	2	2	2	2.0	0.0	0.0	2	2	0
fam13056	2	2	2	2.0	0.0	0.0	2	2	0
fam13057	2	2	2	2.0	0.0	0.0	2	2	0
fam13058	2	2	2	2.0	0.0	0.0	2	2	0
fam13059	2	2	2	2.0	0.0	0.0	2	2	0
fam13060	2	2	2	2.0	0.0	0.0	2	2	0
fam13061	2	2	2	2.0	0.0	0.0	2	2	0
fam13062	2	2	2	2.0	0.0	0.0	2	2	0
fam13063	2	2	2	2.0	0.0	0.0	2	2	0
fam13064	2	2	2	2.0	0.0	0.0	2	2	0
fam13065	2	2	2	2.0	0.0	0.0	2	2	0
fam13066	2	2	2	2.0	0.0	0.0	2	2	0
fam13067	2	2	2	2.0	0.0	0.0	2	2	0
fam13068	2	2	2	2.0	0.0	0.0	2	2	0
fam13069	2	2	2	2.0	0.0	0.0	2	2	0
fam13070	2	2	2	2.0	0.0	0.0	2	2	0
fam13071	2	2	2	2.0	0.0	0.0	2	2	0
fam13072	2	2	2	2.0	0.0	0.0	2	2	0
fam13073	2	2	2	2.0	0.0	0.0	2	2	0
fam13074	2	2	2	2.0	0.0	0.0	2	2	0
fam13075	2	2	2	2.0	0.0	0.0	2	2	0
fam13076	2	2	2	2.0	0.0	0.0	2	2	0
fam13077	2	2	2	2.0	0.0	0.0	2	2	0
fam13078	2	2	2	2.0	0.0	0.0	2	2	0
fam13079	2	2	2	2.0	0.0	0.0	2	2	0
fam13080	2	2	2	2.0	0.0	0.0	2	2	0
fam13081	2	2	2	2.0	0.0	0.0	2	2	0
fam13082	2	2	2	2.0	0.0	0.0	2	2	0
fam13083	2	2	2	2.0	0.0	0.0	2	2	0
fam13084	2	2	2	2.0	0.0	0.0	2	2	0
fam13085	2	2	2	2.0	0.0	0.0	2	2	0
fam13086	2	2	2	2.0	0.0	0.0	2	2	0
fam13087	2	2	2	2.0	0.0	0.0	2	2	0
fam13088	2	2	2	2.0	0.0	0.0	2	2	0
fam13089	2	2	2	2.0	0.0	0.0	2	2	0
fam13090	2	2	2	2.0	0.0	0.0	2	2	0
fam13091	2	2	2	2.0	0.0	0.0	2	2	0
fam13092	2	2	2	2.0	0.0	0.0	2	2	0
fam13093	2	2	2	2.0	0.0	0.0	2	2	0
fam13094	2	2	2	2.0	0.0	0.0	2	2	0
fam13095	2	2	2	2.0	0.0	0.0	2	2	0
fam13096	2	2	2	2.0	0.0	0.0	2	2	0
fam13097	2	2	2	2.0	0.0	0.0	2	2	0
fam13098	2	2	2	2.0	0.0	0.0	2	2	0
fam13099	2	2	2	2.0	0.0	0.0	2	2	0
fam13100	2	2	2	2.0	0.0	0.0	2	2	0
fam13101	2	2	2	2.0	0.0	0.0	2	2	0
fam13102	2	2	2	2.0	0.0	0.0	2	2	0
fam13103	2	2	2	2.0	0.0	0.0	2	2	0
fam13104	2	2	2	2.0	0.0	0.0	2	2	0
fam13105	2	2	2	2.0	0.0	0.0	2	2	0
fam13106	2	2	2	2.0	0.0	0.0	2	2	0
fam13107	2	2	2	2.0	0.0	0.0	2	2	0
fam13108	2	2	2	2.0	0.0	0.0	2	2	0
fam13109	2	2	2	2.0	0.0	0.0	2	2	0
fam13110	2	2	2	2.0	0.0	0.0	2	2	0
fam13111	2	2	2	2.0	0.0	0.0	2	2	0
fam13112	2	2	2	2.0	0.0	0.0	2	2	0
fam13113	2	2	2	2.0	0.0	0.0	2	2	0
fam13114	2	2	2	2.0	0.0	0.0	2	2	0
fam13115	2	2	2	2.0	0.0	0.0	2	2	0
fam13116	2	2	2	2.0	0.0	0.0	2	2	0
fam13117	2	2	2	2.0	0.0	0.0	2	2	0
fam13118	2	2	2	2.0	0.0	0.0	2	2	0
fam13119	2	2	2	2.0	0.0	0.0	2	2	0
fam13120	2	2	2	2.0	0.0	0.0	2	2	0
fam13121	2	2	2	2.0	0.0	0.0	2	2	0
fam13122	2	2	2	2.0	0.0	0.0	2	2	0
fam13123	2	2	2	2.0	0.0	0.0	2	2	0
fam13124	2	2	2	2.0	0.0	0.0	2	2	0
fam13125	2	2	2	2.0	0.0	0.0	2	2	0
fam13126	2	2	2	2.0	0.0	0.0	2	2	0
fam13127	2	2	2	2.0	0.0	0.0	2	2	0
fam13128	2	2	2	2.0	0.0	0.0	2	2	0
fam13129	2	2	2	2.0	0.0	0.0	2	2	0
fam13130	2	2	2	2.0	0.0	0.0	2	2	0
fam13131	2	2	2	2.0	0.0	0.0	2	2	0
fam13132	2	2	2	2.0	0.0	0.0	2	2	0
fam13133	2	2	2	2.0	0.0	0.0	2	2	0
fam13134	2	2	2	2.0	0.0	0.0	2	2	0
fam13135	2	2	2	2.0	0.0	0.0	2	2	0
fam13136	2	2	2	2.0	0.0	0.0	2	2	0
fam13137	2	2	2	2.0	0.0	0.0	2	2	0
fam13138	2	2	2	2.0	0.0	0.0	2	2	0
fam13139	2	2	2	2.0	0.0	0.0	2	2	0
fam13140	2	2	2	2.0	0.0	0.0	2	2	0
fam13141	2	2	2	2.0	0.0	0.0	2	2	0
fam13142	2	2	2	2.0	0.0	0.0	2	2	0
fam13143	2	2	2	2.0	0.0	0.0	2	2	0
fam13144	2	2	2	2.0	0.0	0.0	2	2	0
fam13145	2	2	2	2.0	0.0	0.0	2	2	0
fam13146	2	2	2	2.0	0.0	0.0	2	2	0
fam13147	2	2	2	2.0	0.0	0.0	2	2	0
fam13148	2	2	2	2.0	0.0	0.0	2	2	0
fam13149	2	2	2	2.0	0.0	0.0	2	2	0
fam13150	2	2	2	2.0	0.0	0.0	2	2	0
fam13151	2	2	2	2.0	0.0	0.0	2	2	0
fam13152	2	2	2	2.0	0.0	0.0	2	2	0
fam13153	2	2	2	2.0	0.0	0.0	2	2	0
fam13154	2	2	2	2.0	0.0	0.0	2	2	0
fam13155	2	2	2	2.0	0.0	0.0	2	2	0
fam13156	2	2	2	2.0	0.0	0.0	2	2	0
fam13157	2	2	2	2.0	0.0	0.0	2	2	0
fam13158	2	2	2	2.0	0.0	0.0	2	2	0
fam13159	2	2	2	2.0	0.0	0.0	2	2	0
fam13160	2	2	2	2.0	0.0	0.0	2	2	0
fam13161	2	2	2	2.0	0.0	0.0	2	2	0
fam13162	2	2	2	2.0	0.0	0.0	2	2	0
fam13163	2	2	2	2.0	0.0	0.0	2	2	0
fam13164	2	2	2	2.0	0.0	0.0	2	2	0
fam13165	2	2	2	2.0	0.0	0.0	2	2	0
fam13166	2	2	2	2.0	0.0	0.0	2	2	0
fam13167	2	2	2	2.0	0.0	0.0	2	2	0
fam13168	2	2	2	2.0	0.0	0.0	2	2	0
fam13169	2	2	2	2.0	0.0	0.0	2	2	0
fam13170	2	2	2	2.0	0.0	0.0	2	2	0
fam13171	2	2	2	2.0	0.0	0.0	2	2	0
fam13172	2	2	2	2.0	0.0	0.0	2	2	0
fam13173	2	2	2	2.0	0.0	0.0	2	2	0
fam13174	2	2	2	2.0	0.0	0.0	2	2	0
fam13175	2	2	2	2.0	0.0	0.0	2	2	0
fam13176	2	2	2	2.0	0.0	0.0	2	2	0
fam13177	2	2	2	2.0	0.0	0.0	2	2	0
fam13178	2	2	2	2.0	0.0	0.0	2	2	0
fam13179	2	2	2	2.0	0.0	0.0	2	2	0
fam13180	2	2	2	2.0	0.0	0.0	2	2	0
fam13181	2	2	2	2.0	0.0	0.0	2	2	0
fam13182	2	2	2	2.0	0.0	0.0	2	2	0
fam13183	2	2	2	2.0	0.0	0.0	2	2	0
fam13184	2	2	2	2.0	0.0	0.0	2	2	0
fam13185	2	2	2	2.0	0.0	0.0	2	2	0
fam13186	2	2	2	2.0	0.0	0.0	2	2	0
fam13187	2	2	2	2.0	0.0	0.0	2	2	0
fam13188	2	2	2	2.0	0.0	0.0	2	2	0
fam13189	2	2	2	2.0	0.0	0.0	2	2	0
fam13190	2	2	2	2.0	0.0	0.0	2	2	0
fam13191	2	2	2	2.0	0.0	0.0	2	2	0
fam13192	2	2	2	2.0	0.0	0.0	2	2	0
fam13193	2	2	2	2.0	0.0	0.0	2	2	0
fam13194	2	2	2	2.0	0.0	0.0	2	2	0
fam13195	2	2	2	2.0	0.0	0.0	2	2	0
fam13196	2	2	2	2.0	0.0	0.0	2	2	0
fam13197	2	2	2	2.0	0.0	0.0	2	2	0
fam13198	2	2	2	2.0	0.0	0.0	2	2	0
fam13199	2	2	2	2.0	0.0	0.0	2	2	0
fam13200	2	2	2	2.0	0.0	0.0	2	2	0
fam13201	2	2	2	2.0	0.0	0.0	2	2	0
fam13202	2	2	2	2.0	0.0	0.0	2	2	0
fam13203	2	2	2	2.0	0.0	0.0	2	2	0
fam13204	2	2	2	2.0	0.0	0.0	2	2	0
fam13205	2	2	2	2.0	0.0	0.0	2	2	0
fam13206	2	2	2	2.0	0.0	0.0	2	2	0
fam13207	2	2	2	2.0	0.0	0.0	2	2	0
fam13208	2	2	2	2.0	0.0	0.0	2	2	0
fam13209	2	2	2	2.0	0.0	0.0	2	2	0
fam13210	2	2	2	2.0	0.0	0.0	2	2	0
fam13211	2	2	2	2.0	0.0	0.0	2	2	0
fam13212	2	2	2	2.0	0.0	0.0	2	2	0
fam13213	2	2	2	2.0	0.0	0.0	2	2	0
fam13214	2	2	2	2.0	0.0	0.0	2	2	0
fam13215	2	2	2	2.0	0.0	0.0	2	2	0
fam13216	2	2	2	2.0	0.0	0.0	2	2	0
fam13217	2	2	2	2.0	0.0	0.0	2	2	0
fam13218	2	2	2	2.0	0.0	0.0	2	2	0
fam13219	2	2	2	2.0	0.0	0.0	2	2	0
fam13220	2	2	2	2.0	0.0	0.0	2	2	0
fam13221	2	2	2	2.0	0.0	0.0	2	2	0
fam13222	2	2	2	2.0	0.0	0.0	2	2	0
fam13223	2	2	2	2.0	0.0	0.0	2	2	0
fam13224	2	2	2	2.0	0.0	0.0	2	2	0
fam13225	2	2	2	2.0	0.0	0.0	2	2	0
fam13226	2	2	2	2.0	0.0	0.0	2	2	0
fam13227	2	2	2	2.0	0.0	0.0	2	2	0
fam13228	2	2	2	2.0	0.0	0.0	2	2	0
fam13229	2	2	2	2.0	0.0	0.0	2	2	0
fam13230	2	2	2	2.0	0.0	0.0	2	2	0
fam13231	2	2	2	2.0	0.0	0.0	2	2	0
fam13232	2	2	2	2.0	0.0	0.0	2	2	0
fam13233	2	2	2	2.0	0.0	0.0	2	2	0
fam13234	2	2	2	2.0	0.0	0.0	2	2	0
fam13235	2	2	2	2.0	0.0	0.0	2	2	0
fam13236	2	2	2	2.0	0.0	0.0	2	2	0
fam13237	2	2	2	2.0	0.0	0.0	2	2	0
fam13238	2	2	2	2.0	0.0	0.0	2	2	0
fam13239	2	2	2	2.0	0.0	0.0	2	2	0
fam13240	2	2	2	2.0	0.0	0.0	2	2	0
fam13241	2	2	2	2.0	0.0	0.0	2	2	0
fam13242	2	2	2	2.0	0.0	0.0	2	2	0
fam13243	2	2	2	2.0	0.0	0.0	2	2	0
fam13244	2	2	2	2.0	0.0	0.0	2	2	0
fam13245	2	2	2	2.0	0.0	0.0	2	2	0
fam13246	2	2	2	2.0	0.0	0.0	2	2	0
fam13247	2	2	2	2.0	0.0	0.0	2	2	0
fam13248	2	2	2	2.0	0.0	0.0	2	2	0
fam13249	2	2	2	2.0	0.0	0.0	2	2	0
fam13250	2	2	2	2.0	0.0	0.0	2	2	0
fam13251	2	2	2	2.0	0.0	0.0	2	2	0
fam13252	2	2	2	2.0	0.0	0.0	2	2	0
fam13253	2	2	2	2.0	0.0	0.0	2	2	0
fam13254	2	2	2	2.0	0.0	0.0	2	2	0
fam13255	2	2	2	2.0	0.0	0.0	2	2	0
fam13256	2	2	2	2.0	0.0	0.0	2	2	0
fam13257	2	2	2	2.0	0.0	0.0	2	2	0
fam13258	2	2	2	2.0	0.0	0.0	2	2	0
fam13259	2	2	2	2.0	0.0	0.0	2	2	0
fam13260	2	2	2	2.0	0.0	0.0	2	2	0
fam13261	2	2	2	2.0	0.0	0.0	2	2	0
fam13262	2	2	2	2.0	0.0	0.0	2	2	0
fam13263	2	2	2	2.0	0.0	0.0	2	2	0
fam13264	2	2	2	2.0	0.0	0.0	2	2	0
fam13265	2	2	2	2.0	0.0	0.0	2	2	0
fam13266	2	2	2	2.0	0.0	0.0	2	2	0
fam13267	2	2	2	2.0	0.0	0.0	2	2	0
fam13268	2	2	2	2.0	0.0	0.0	2	2	0
fam13269	2	2	2	2.0	0.0	0.0	2	2	0
fam13270	2	2	2	2.0	0.0	0.0	2	2	0
fam13271	2	2	2	2.0	0.0	0.0	2	2	0
fam13272	2	2	2	2.0	0.0	0.0	2	2	0
fam13273	2	2	2	2.0	0.0	0.0	2	2	0
fam13274	2	2	2	2.0	0.0	0.0	2	2	0
fam13275	2	2	2	2.0	0.0	0.0	2	2	0
fam13276	2	2	2	2.0	0.0	0.0	2	2	0
fam13277	2	2	2	2.0	0.0	0.0	2	2	0
fam13278	2	2	2	2.0	0.0	0.0	2	2	0
fam13279	2	2	2	2.0	0.0	0.0	2	2	0
fam13280	2	2	2	2.0	0.0	0.0	2	2	0
fam13281	2	2	2	2.0	0.0	0.0	2	2	0
fam13282	2	2	2	2.0	0.0	0.0	2	2	0
fam13283	2	2	2	2.0	0.0	0.0	2	2	0
fam13284	2	2	2	2.0	0.0	0.0	2	2	0
fam13285	2	2	2	2.0	0.0	0.0	2	2	0
fam13286	2	2	2	2.0	0.0	0.0	2	2	0
fam13287	2	2	2	2.0	0.0	0.0	2	2	0
fam13288	2	2	2	2.0	0.0	0.0	2	2	0
fam13289	2	2	2	2.0	0.0	0.0	2	2	0
fam13290	2	2	2	2.0	0.0	0.0	2	2	0
fam13291	2	2	2	2.0	0.0	0.0	2	2	0
fam13292	2	2	2	2.0	0.0	0.0	2	2	0
fam13293	2	2	2	2.0	0.0	0.0	2	2	0
fam13294	2	2	2	2.0	0.0	0.0	2	2	0
fam13295	2	2	2	2.0	0.0	0.0	2	2	0
fam13296	2	2	2	2.0	0.0	0.0	2	2	0
fam13297	2	2	2	2.0	0.0	0.0	2	2	0
fam13298	2	2	2	2.0	0.0	0.0	2	2	0
fam13299	2	2	2	2.0	0.0	0.0	2	2	0
fam13300	2	2	2	2.0	0.0	0.0	2	2	0
fam13301	2	2	2	2.0	0.0	0.0	2	2	0
fam13302	2	2	2	2.0	0.0	0.0	2	2	0
fam13303	2	2	2	2.0	0.0	0.0	2	2	0
fam13304	2	2	2	2.0	0.0	0.0	2	2	0
fam13305	2	2	2	2.0	0.0	0.0	2	2	0
fam13306	2	2	2	2.0	0.0	0.0	2	2	0
fam13307	2	2	2	2.0	0.0	0.0	2	2	0
fam13308	2	2	2	2.0	0.0	0.0	2	2	0
fam13309	2	2	2	2.0	0.0	0.0	2	2	0
fam13310	2	2	2	2.0	0.0	0.0	2	2	0
fam13311	2	2	2	2.0	0.0	0.0	2	2	0
fam13312	2	2	2	2.0	0.0	0.0	2	2	0
fam13313	2	2	2	2.0	0.0	0.0	2	2	0
fam13314	2	2	2	2.0	0.0	0.0	2	2	0
fam13315	2	2	2	2.0	0.0	0.0	2	2	0
fam13316	2	2	2	2.0	0.0	0.0	2	2	0
fam13317	2	2	2	2.0	0.0	0.0	2	2	0
fam13318	2	2	2	2.0	0.0	0.0	2	2	0
fam13319	2	2	2	2.0	0.0	0.0	2	2	0
fam13320	2	2	2	2.0	0.0	0.0	2	2	0
fam13321	2	2	2	2.0	0.0	0.0	2	2	0
fam13322	2	2	2	2.0	0.0	0.0	2	2	0
fam13323	2	2	2	2.0	0.0	0.0	2	2	0
fam13324	2	2	2	2.0	0.0	0.0	2	2	0
fam13325	2	2	2	2.0	0.0	0.0	2	2	0
fam13326	2	2	2	2.0	0.0	0.0	2	2	0
fam13327	2	2	2	2.0	0.0	0.0	2	2	0
fam13328	2	2	2	2.0	0.0	0.0	2	2	0
fam13329	2	2	2	2.0	0.0	0.0	2	2	0
fam13330	2	2	2	2.0	0.0	0.0	2	2	0
fam13331	2	2	2	2.0	0.0	0.0	2	2	0
fam13332	2	2	2	2.0	0.0	0.0	2	2	0
fam13333	2	2	2	2.0	0.0	0.0	2	2	0
fam13334	2	2	2	2.0	0.0	0.0	2	2	0
fam13335	2	2	2	2.0	0.0	0.0	2	2	0
fam13336	2	2	2	2.0	0.0	0.0	2	2	0
fam13337	2	2	2	2.0	0.0	0.0	2	2	0
fam13338	2	2	2	2.0	0.0	0.0	2	2	0
fam13339	2	2	2	2.0	0.0	0.0	2	2	0
fam13340	2	2	2	2.0	0.0	0.0	2	2	0
fam13341	2	2	2	2.0	0.0	0.0	2	2	0
fam13342	2	2	2	2.0	0.0	0.0	2	2	0
fam13343	2	2	2	2.0	0.0	0.0	2	2	0
fam13344	2	2	2	2.0	0.0	0.0	2	2	0
fam13345	2	2	2	2.0	0.0	0.0	2	2	0
fam13346	2	2	2	2.0	0.0	0.0	2	2	0
fam13347	2	2	2	2.0	0.0	0.0	2	2	0
fam13348	2	2	2	2.0	0.0	0.0	2	2	0
fam13349	2	2	2	2.0	0.0	0.0	2	2	0
fam13350	2	2	2	2.0	0.0	0.0	2	2	0
fam13351	2	2	2	2.0	0.0	0.0	2	2	0
fam13352	2	2	2	2.0	0.0	0.0	2	2	0
fam13353	2	2	2	2.0	0.0	0.0	2	2	0
fam13354	2	2	2	2.0	0.0	0.0	2	2	0
fam13355	2	2	2	2.0	0.0	0.0	2	2	0
fam13356	2	2	2	2.0	0.0	0.0	2	2	0
fam13357	2	2	2	2.0	0.0	0.0	2	2	0
fam13358	2	2	2	2.0	0.0	0.0	2	2	0
fam13359	2	2	2	2.0	0.0	0.0	2	2	0
fam13360	2	2	2	2.0	0.0	0.0	2	2	0
fam13361	2	2	2	2.0	0.0	0.0	2	2	0
fam13362	2	2	2	2.0	0.0	0.0	2	2	0
fam13363	2	2	2	2.0	0.0	0.0	2	2	0
fam13364	2	2	2	2.0	0.0	0.0	2	2	0
fam13365	2	2	2	2.0	0.0	0.0	2	2	0
fam13366	2	2	2	2.0	0.0	0.0	2	2	0
fam13367	2	2	2	2.0	0.0	0.0	2	2	0
fam13368	2	2	2	2.0	0.0	0.0	2	2	0
fam13369	2	2	2	2.0	0.0	0.0	2	2	0
fam13370	2	2	2	2.0	0.0	0.0	2	2	0
fam13371	2	2	2	2.0	0.0	0.0	2	2	0
fam13372	2	2	2	2.0	0.0	0.0	2	2	0
fam13373	2	2	2	2.0	0.0	0.0	2	2	0
fam13374	2	2	2	2.0	0.0	0.0	2	2	0
fam13375	2	2	2	2.0	0.0	0.0	2	2	0
fam13376	2	2	2	2.0	0.0	0.0	2	2	0
fam13377	2	2	2	2.0	0.0	0.0	2	2	0
fam13378	2	2	2	2.0	0.0	0.0	2	2	0
fam13379	2	2	2	2.0	0.0	0.0	2	2	0
fam13380	2	2	2	2.0	0.0	0.0	2	2	0
fam13381	2	2	2	2.0	0.0	0.0	2	2	0
fam13382	2	2	2	2.0	0.0	0.0	2	2	0
fam13383	2	2	2	2.0	0.0	0.0	2	2	0
fam13384	2	2	2	2.0	0.0	0.0	2	2	0
fam13385	2	2	2	2.0	0.0	0.0	2	2	0
fam13386	2	2	2	2.0	0.0	0.0	2	2	0
fam13387	2	2	2	2.0	0.0	0.0	2	2	0
fam13388	2	2	2	2.0	0.0	0.0	2	2	0
fam13389	2	2	2	2.0	0.0	0.0	2	2	0
fam13390	2	2	2	2.0	0.0	0.0	2	2	0
fam13391	2	2	2	2.0	0.0	0.0	2	2	0
fam13392	2	2	2	2.0	0.0	0.0	2	2	0
fam13393	2	2	2	2.0	0.0	0.0	2	2	0
fam13394	2	2	2	2.0	0.0	0.0	2	2	0
fam13395	2	2	2	2.0	0.0	0.0	2	2	0
fam13396	2	2	2	2.0	0.0	0.0	2	2	0
fam13397	2	2	2	2.0	0.0	0.0	2	2	0
fam13398	2	2	2	2.0	0.0	0.0	2	2	0
fam13399	2	2	2	2.0	0.0	0.0	2	2	0
fam13400	2	2	2	2.0	0.0	0.0	2	2	0
fam13401	2	2	2	2.0	0.0	0.0	2	2	0
fam13402	2	2	2	2.0	0.0	0.0	2	2	0
fam13403	2	2	2	2.0	0.0	0.0	2	2	0
fam13404	2	2	2	2.0	0.0	0.0	2	2	0
fam13405	2	2	2	2.0	0.0	0.0	2	2	0
fam13406	2	2	2	2.0	0.0	0.0	2	2	0
fam13407	2	2	2	2.0	0.0	0.0	2	2	0
fam13408	2	2	2	2.0	0.0	0.0	2	2	0
fam13409	2	2	2	2.0	0.0	0.0	2	2	0
fam13410	2	2	2	2.0	0.0	0.0	2	2	0
fam13411	2	2	2	2.0	0.0	0.0	2	2	0
fam13412	2	2	2	2.0	0.0	0.0	2	2	0
fam13413	2	2	2	2.0	0.0	0.0	2	2	0
fam13414	2	2	2	2.0	0.0	0.0	2	2	0
fam13415	2	2	2	2.0	0.0	0.0	2	2	0
fam13416	2	2	2	2.0	0.0	0.0	2	2	0
fam13417	2	2	2	2.0	0.0	0.0	2	2	0
fam13418	2	2	2	2.0	0.0	0.0	2	2	0
fam13419	2	2	2	2.0	0.0	0.0	2	2	0
fam13420	2	2	2	2.0	0.0	0.0	2	2	0
fam13421	2	2	2	2.0	0.0	0.0	2	2	0
fam13422	2	2	2	2.0	0.0	0.0	2	2	0
fam13423	2	2	2	2.0	0.0	0.0	2	2	0
fam13424	2	2	2	2.0	0.0	0.0	2	2	0
fam13425	2	2	2	2.0	0.0	0.0	2	2	0
fam13426	2	2	2	2.0	0.0	0.0	2	2	0
fam13427	2	2	2	2.0	0.0	0.0	2	2	0
fam13428	2	2	2	2.0	0.0	0.0	2	2	0
fam13429	2	2	2	2.0	0.0	0.0	2	2	0
fam13430	2	2	2	2.0	0.0	0.0	2	2	0
fam13431	2	2	2	2.0	0.0	0.0	2	2	0
fam13432	2	2	2	2.0	0.0	0.0	2	2	0
fam13433	2	2	2	2.0	0.0	0.0	2	2	0
fam13434	2	2	2	2.0	0.0	0.0	2	2	0
fam13435	2	2	2	2.0	0.0	0.0	2	2	0
fam13436	2	2	2	2.0	0.0	0.0	2	2	0
fam13437	2	2	2	2.0	0.0	0.0	2	2	0
fam13438	2	2	2	2.0	0.0	0.0	2	2	0
fam13439	2	2	2	2.0	0.0	0.0	2	2	0
fam13440	2	2	2	2.0	0.0	0.0	2	2	0
fam13441	2	2	2	2.0	0.0	0.0	2	2	0
fam13442	2	2	2	2.0	0.0	0.0	2	2	0
fam13443	2	2	2	2.0	0.0	0.0	2	2	0
fam13444	2	2	2	2.0	0.0	0.0	2	2	0
fam13445	2	2	2	2.0	0.0	0.0	2	2	0
fam13446	2	2	2	2.0	0.0	0.0	2	2	0
fam13447	2	2	2	2.0	0.0	0.0	2	2	0
fam13448	2	2	2	2.0	0.0	0.0	2	2	0
fam13449	2	2	2	2.0	0.0	0.0	2	2	0
fam13450	2	2	2	2.0	0.0	0.0	2	2	0
fam13451	2	2	2	2.0	0.0	0.0	2	2	0
fam13452	2	2	2	2.0	0.0	0.0	2	2	0
fam13453	2	2	2	2.0	0.0	0.0	2	2	0
fam13454	2	2	2	2.0	0.0	0.0	2	2	0
fam13455	2	2	2	2.0	0.0	0.0	2	2	0
fam13456	2	2	2	2.0	0.0	0.0	2	2	0
fam13457	2	2	2	2.0	0.0	0.0	2	2	0
fam13458	2	2	2	2.0	0.0	0.0	2	2	0
fam13459	2	2	2	2.0	0.0	0.0	2	2	0
fam13460	2	2	2	2.0	0.0	0.0	2	2	0
fam13461	2	2	2	2.0	0.0	0.0	2	2	0
fam13462	2	2	2	2.0	0.0	0.0	2	2	0
fam13463	2	2	2	2.0	0.0	0.0	2	2	0
fam13464	2	2	2	2.0	0.0	0.0	2	2	0
fam13465	2	2	2	2.0	0.0	0.0	2	2	0
fam13466	2	2	2	2.0	0.0	0.0	2	2	0
fam13467	2	2	2	2.0	0.0	0.0	2	2	0
fam13468	2	2	2	2.0	0.0	0.0	2	2	0
fam13469	2	2	2	2.0	0.0	0.0	2	2	0
fam13470	2	2	2	2.0	0.0	0.0	2	2	0
fam13471	2	2	2	2.0	0.0	0.0	2	2	0
fam13472	2	2	2	2.0	0.0	0.0	2	2	0
fam13473	2	2	2	2.0	0.0	0.0	2	2	0
fam13474	2	2	2	2.0	0.0	0.0	2	2	0
fam13475	2	2	2	2.0	0.0	0.0	2	2	0
fam13476	2	2	2	2.0	0.0	0.0	2	2	0
fam13477	2	2	2	2.0	0.0	0.0	2	2	0
fam13478	2	2	2	2.0	0.0	0.0	2	2	0
fam13479	2	2	2	2.0	0.0	0.0	2	2	0
fam13480	2	2	2	2.0	0.0	0.0	2	2	0
fam13481	2	2	2	2.0	0.0	0.0	2	2	0
fam13482	2	2	2	2.0	0.0	0.0	2	2	0
fam13483	2	2	2	2.0	0.0	0.0	2	2	0
fam13484	2	2	2	2.0	0.0	0.0	2	2	0
fam13485	2	2	2	2.0	0.0	0.0	2	2	0
fam13486	2	2	2	2.0	0.0	0.0	2	2	0
fam13487	2	2	2	2.0	0.0	0.0	2	2	0
fam13488	2	2	2	2.0	0.0	0.0	2	2	0
fam13489	2	2	2	2.0	0.0	0.0	2	2	0
fam13490	2	2	2	2.0	0.0	0.0	2	2	0
fam13491	2	2	2	2.0	0.0	0.0	2	2	0
fam13492	2	2	2	2.0	0.0	0.0	2	2	0
fam13493	2	2	2	2.0	0.0	0.0	2	2	0
fam13494	2	2	2	2.0	0.0	0.0	2	2	0
fam13495	2	2	2	2.0	0.0	0.0	2	2	0
fam13496	2	2	2	2.0	0.0	0.0	2	2	0
fam13497	2	2	2	2.0	0.0	0.0	2	2	0
fam13498	2	2	2	2.0	0.0	0.0	2	2	0
fam13499	2	2	2	2.0	0.0	0.0	2	2	0
fam13500	2	2	2	2.0	0.0	0.0	2	2	0
fam13501	2	2	2	2.0	0.0	0.0	2	2	0
fam13502	2	2	2	2.0	0.0	0.0	2	2	0
fam13503	2	2	2	2.0	0.0	0.0	2	2	0
fam13504	2	2	2	2.0	0.0	0.0	2	2	0
fam13505	2	2	2	2.0	0.0	0.0	2	2	0
fam13506	2	2	2	2.0	0.0	0.0	2	2	0
fam13507	2	2	2	2.0	0.0	0.0	2	2	0
fam13508	2	2	2	2.0	0.0	0.0	2	2	0
fam13509	2	2	2	2.0	0.0	0.0	2	2	0
fam13510	2	2	2	2.0	0.0	0.0	2	2	0
fam13511	2	2	2	2.0	0.0	0.0	2	2	0
fam13512	2	2	2	2.0	0.0	0.0	2	2	0
fam13513	2	2	2	2.0	0.0	0.0	2	2	0
fam13514	2	2	2	2.0	0.0	0.0	2	2	0
fam13515	2	2	2	2.0	0.0	0.0	2	2	0
fam13516	2	2	2	2.0	0.0	0.0	2	2	0
fam13517	2	2	2	2.0	0.0	0.0	2	2	0
fam13518	2	2	2	2.0	0.0	0.0	2	2	0
fam13519	2	2	2	2.0	0.0	0.0	2	2	0
fam13520	2	2	2	2.0	0.0	0.0	2	2	0
fam13521	2	2	2	2.0	0.0	0.0	2	2	0
fam13522	2	2	2	2.0	0.0	0.0	2	2	0
fam13523	2	2	2	2.0	0.0	0.0	2	2	0
fam13524	2	2	2	2.0	0.0	0.0	2	2	0
fam13525	2	2	2	2.0	0.0	0.0	2	2	0
fam13526	2	2	2	2.0	0.0	0.0	2	2	0
fam13527	2	2	2	2.0	0.0	0.0	2	2	0
fam13528	2	2	2	2.0	0.0	0.0	2	2	0
fam13529	2	2	2	2.0	0.0	0.0	2	2	0
fam13530	2	2	2	2.0	0.0	0.0	2	2	0
fam13531	2	2	2	2.0	0.0	0.0	2	2	0
fam13532	2	2	2	2.0	0.0	0.0	2	2	0
fam13533	2	2	2	2.0	0.0	0.0	2	2	0
fam13534	2	2	2	2.0	0.0	0.0	2	2	0
fam13535	2	2	2	2.0	0.0	0.0	2	2	0
fam13536	2	2	2	2.0	0.0	0.0	2	2	0
fam13537	2	2	2	2.0	0.0	0.0	2	2	0
fam13538	2	2	2	2.0	0.0	0.0	2	2	0
fam13539	2	2	2	2.0	0.0	0.0	2	2	0
fam13540	2	2	2	2.0	0.0	0.0	2	2	0
fam13541	2	2	2	2.0	0.0	0.0	2	2	0
fam13542	2	2	2	2.0	0.0	0.0	2	2	0
fam13543	2	2	2	2.0	0.0	0.0	2	2	0
fam13544	2	2	2	2.0	0.0	0.0	2	2	0
fam13545	2	2	2	2.0	0.0	0.0	2	2	0
fam13546	2	2	2	2.0	0.0	0.0	2	2	0
fam13547	2	2	2	2.0	0.0	0.0	2	2	0
fam13548	2	2	2	2.0	0.0	0.0	2	2	0
fam13549	2	2	2	2.0	0.0	0.0	2	2	0
fam13550	2	2	2	2.0	0.0	0.0	2	2	0
fam13551	2	2	2	2.0	0.0	0.0	2	2	0
fam13552	2	2	2	2.0	0.0	0.0	2	2	0
fam13553	2	2	2	2.0	0.0	0.0	2	2	0
fam13554	2	2	2	2.0	0.0	0.0	2	2	0
fam13555	2	2	2	2.0	0.0	0.0	2	2	0
fam13556	2	2	2	2.0	0.0	0.0	2	2	0
fam13557	2	2	2	2.0	0.0	0.0	2	2	0
fam13558	2	2	2	2.0	0.0	0.0	2	2	0
fam13559	2	2	2	2.0	0.0	0.0	2	2	0
fam13560	2	2	2	2.0	0.0	0.0	2	2	0
fam13561	2	2	2	2.0	0.0	0.0	2	2	0
fam13562	2	2	2	2.0	0.0	0.0	2	2	0
fam13563	2	2	2	2.0	0.0	0.0	2	2	0
fam13564	2	2	2	2.0	0.0	0.0	2	2	0
fam13565	2	2	2	2.0	0.0	0.0	2	2	0
fam13566	2	2	2	2.0	0.0	0.0	2	2	0
fam13567	2	2	2	2.0	0.0	0.0	2	2	0
fam13568	2	2	2	2.0	0.0	0.0	2	2	0
fam13569	2	2	2	2.0	0.0	0.0	2	2	0
fam13570	2	2	2	2.0	0.0	0.0	2	2	0
fam13571	2	2	2	2.0	0.0	0.0	2	2	0
fam13572	2	2	2	2.0	0.0	0.0	2	2	0
fam13573	2	2	2	2.0	0.0	0.0	2	2	0
fam13574	2	2	2	2.0	0.0	0.0	2	2	0
fam13575	2	2	2	2.0	0.0	0.0	2	2	0
fam13576	2	2	2	2.0	0.0	0.0	2	2	0
fam13577	2	2	2	2.0	0.0	0.0	2	2	0
fam13578	2	2	2	2.0	0.0	0.0	2	2	0
fam13579	2	2	2	2.0	0.0	0.0	2	2	0
fam13580	2	2	2	2.0	0.0	0.0	2	2	0
fam13581	2	2	2	2.0	0.0	0.0	2	2	0
fam13582	2	2	2	2.0	0.0	0.0	2	2	0
fam13583	2	2	2	2.0	0.0	0.0	2	2	0
fam13584	2	2	2	2.0	0.0	0.0	2	2	0
fam13585	2	2	2	2.0	0.0	0.0	2	2	0
fam13586	2	2	2	2.0	0.0	0.0	2	2	0
fam13587	2	2	2	2.0	0.0	0.0	2	2	0
fam13588	2	2	2	2.0	0.0	0.0	2	2	0
fam13589	2	2	2	2.0	0.0	0.0	2	2	0
fam13590	2	2	2	2.0	0.0	0.0	2	2	0
fam13591	2	2	2	2.0	0.0	0.0	2	2	0
fam13592	2	2	2	2.0	0.0	0.0	2	2	0
fam13593	2	2	2	2.0	0.0	0.0	2	2	0
fam13594	2	2	2	2.0	0.0	0.0	2	2	0
fam13595	2	2	2	2.0	0.0	0.0	2	2	0
fam13596	2	2	2	2.0	0.0	0.0	2	2	0
fam13597	2	2	2	2.0	0.0	0.0	2	2	0
fam13598	2	2	2	2.0	0.0	0.0	2	2	0
fam13599	2	2	2	2.0	0.0	0.0	2	2	0
fam13600	2	2	2	2.0	0.0	0.0	2	2	0
fam13601	2	2	2	2.0	0.0	0.0	2	2	0
fam13602	2	2	2	2.0	0.0	0.0	2	2	0
fam13603	2	2	2	2.0	0.0	0.0	2	2	0
fam13604	2	2	2	2.0	0.0	0.0	2	2	0
fam13605	2	2	2	2.0	0.0	0.0	2	2	0
fam13606	2	2	2	2.0	0.0	0.0	2	2	0
fam13607	2	2	2	2.0	0.0	0.0	2	2	0
fam13608	2	2	2	2.0	0.0	0.0	2	2	0
fam13609	2	2	2	2.0	0.0	0.0	2	2	0
fam13610	2	2	2	2.0	0.0	0.0	2	2	0
fam13611	2	2	2	2.0	0.0	0.0	2	2	0
fam13612	2	2	2	2.0	0.0	0.0	2	2	0
fam13613	2	2	2	2.0	0.0	0.0	2	2	0
fam13614	2	2	2	2.0	0.0	0.0	2	2	0
fam13615	2	2	2	2.0	0.0	0.0	2	2	0
fam13616	2	2	2	2.0	0.0	0.0	2	2	0
fam13617	2	2	2	2.0	0.0	0.0	2	2	0
fam13618	2	2	2	2.0	0.0	0.0	2	2	0
fam13619	2	2	2	2.0	0.0	0.0	2	2	0
fam13620	2	2	2	2.0	0.0	0.0	2	2	0
fam13621	2	2	2	2.0	0.0	0.0	2	2	0
fam13622	2	2	2	2.0	0.0	0.0	2	2	0
fam13623	2	2	2	2.0	0.0	0.0	2	2	0
fam13624	2	2	2	2.0	0.0	0.0	2	2	0
fam13625	2	2	2	2.0	0.0	0.0	2	2	0
fam13626	2	2	2	2.0	0.0	0.0	2	2	0
fam13627	2	2	2	2.0	0.0	0.0	2	2	0
fam13628	2	2	2	2.0	0.0	0.0	2	2	0
fam13629	2	2	2	2.0	0.0	0.0	2	2	0
fam13630	2	2	2	2.0	0.0	0.0	2	2	0
fam13631	2	2	2	2.0	0.0	0.0	2	2	0
fam13632	2	2	2	2.0	0.0	0.0	2	2	0
fam13633	2	2	2	2.0	0.0	0.0	2	2	0
fam13634	2	2	2	2.0	0.0	0.0	2	2	0
fam13635	2	2	2	2.0	0.0	0.0	2	2	0
fam13636	2	2	2	2.0	0.0	0.0	2	2	0
fam13637	2	2	2	2.0	0.0	0.0	2	2	0
fam13638	2	2	2	2.0	0.0	0.0	2	2	0
fam13639	2	2	2	2.0	0.0	0.0	2	2	0
fam13640	2	2	2	2.0	0.0	0.0	2	2	0
fam13641	2	2	2	2.0	0.0	0.0	2	2	0
fam13642	2	2	2	2.0	0.0	0.0	2	2	0
fam13643	2	2	2	2.0	0.0	0.0	2	2	0
fam13644	2	2	2	2.0	0.0	0.0	2	2	0
fam13645	2	2	2	2.0	0.0	0.0	2	2	0
fam13646	2	2	2	2.0	0.0	0.0	2	2	0
fam13647	2	2	2	2.0	0.0	0.0	2	2	0
fam13648	2	2	2	2.0	0.0	0.0	2	2	0
fam13649	2	2	2	2.0	0.0	0.0	2	2	0
fam13650	2	2	2	2.0	0.0	0.0	2	2	0
fam13651	2	2	2	2.0	0.0	0.0	2	2	0
fam13652	2	2	2	2.0	0.0	0.0	2	2	0
fam13653	2	2	2	2.0	0.0	0.0	2	2	0
fam13654	2	2	2	2.0	0.0	0.0	2	2	0
fam13655	2	2	2	2.0	0.0	0.0	2	2	0
fam13656	2	2	2	2.0	0.0	0.0	2	2	0
fam13657	2	2	2	2.0	0.0	0.0	2	2	0
fam13658	2	2	2	2.0	0.0	0.0	2	2	0
fam13659	2	2	2	2.0	0.0	0.0	2	2	0
fam13660	2	2	2	2.0	0.0	0.0	2	2	0
fam13661	2	2	2	2.0	0.0	0.0	2	2	0
fam13662	2	2	2	2.0	0.0	0.0	2	2	0
fam13663	2	2	2	2.0	0.0	0.0	2	2	0
fam13664	2	2	2	2.0	0.0	0.0	2	2	0
fam13665	2	2	2	2.0	0.0	0.0	2	2	0
fam13666	2	2	2	2.0	0.0	0.0	2	2	0
fam13667	2	2	2	2.0	0.0	0.0	2	2	0
fam13668	2	2	2	2.0	0.0	0.0	2	2	0
fam13669	2	2	2	2.0	0.0	0.0	2	2	0
fam13670	2	2	2	2.0	0.0	0.0	2	2	0
fam13671	2	2	2	2.0	0.0	0.0	2	2	0
fam13672	2	2	2	2.0	0.0	0.0	2	2	0
fam13673	2	2	2	2.0	0.0	0.0	2	2	0
fam13674	2	2	2	2.0	0.0	0.0	2	2	0
fam13675	2	2	2	2.0	0.0	0.0	2	2	0
fam13676	2	2	2	2.0	0.0	0.0	2	2	0
fam13677	2	2	2	2.0	0.0	0.0	2	2	0
fam13678	2	2	2	2.0	0.0	0.0	2	2	0
fam13679	2	2	2	2.0	0.0	0.0	2	2	0
fam13680	2	2	2	2.0	0.0	0.0	2	2	0
fam13681	2	2	2	2.0	0.0	0.0	2	2	0
fam13682	2	2	2	2.0	0.0	0.0	2	2	0
fam13683	2	2	2	2.0	0.0	0.0	2	2	0
fam13684	2	2	2	2.0	0.0	0.0	2	2	0
fam13685	2	2	2	2.0	0.0	0.0	2	2	0
fam13686	2	2	2	2.0	0.0	0.0	2	2	0
fam13687	2	2	2	2.0	0.0	0.0	2	2	0
fam13688	2	2	2	2.0	0.0	0.0	2	2	0
fam13689	2	2	2	2.0	0.0	0.0	2	2	0
fam13690	2	2	2	2.0	0.0	0.0	2	2	0
fam13691	2	2	2	2.0	0.0	0.0	2	2	0
fam13692	2	2	2	2.0	0.0	0.0	2	2	0
fam13693	2	2	2	2.0	0.0	0.0	2	2	0
fam13694	2	2	2	2.0	0.0	0.0	2	2	0
fam13695	2	2	2	2.0	0.0	0.0	2	2	0
fam13696	2	2	2	2.0	0.0	0.0	2	2	0
fam13697	2	2	2	2.0	0.0	0.0	2	2	0
fam13698	2	2	2	2.0	0.0	0.0	2	2	0
fam13699	2	2	2	2.0	0.0	0.0	2	2	0
fam13700	2	2	2	2.0	0.0	0.0	2	2	0
fam13701	2	2	2	2.0	0.0	0.0	2	2	0
fam13702	2	2	2	2.0	0.0	0.0	2	2	0
fam13703	2	2	2	2.0	0.0	0.0	2	2	0
fam13704	2	2	2	2.0	0.0	0.0	2	2	0
fam13705	2	2	2	2.0	0.0	0.0	2	2	0
fam13706	2	2	2	2.0	0.0	0.0	2	2	0
fam13707	2	2	2	2.0	0.0	0.0	2	2	0
fam13708	2	2	2	2.0	0.0	0.0	2	2	0
fam13709	2	2	2	2.0	0.0	0.0	2	2	0
fam13710	2	2	2	2.0	0.0	0.0	2	2	0
fam13711	2	2	2	2.0	0.0	0.0	2	2	0
fam13712	2	2	2	2.0	0.0	0.0	2	2	0
fam13713	2	2	2	2.0	0.0	0.0	2	2	0
fam13714	2	2	2	2.0	0.0	0.0	2	2	0
fam13715	2	2	2	2.0	0.0	0.0	2	2	0
fam13716	2	2	2	2.0	0.0	0.0	2	2	0
fam13717	2	2	2	2.0	0.0	0.0	2	2	0
fam13718	2	2	2	2.0	0.0	0.0	2	2	0
fam13719	2	2	2	2.0	0.0	0.0	2	2	0
fam13720	2	2	2	2.0	0.0	0.0	2	2	0
fam13721	2	2	2	2.0	0.0	0.0	2	2	0
fam13722	2	2	2	2.0	0.0	0.0	2	2	0
fam13723	2	2	2	2.0	0.0	0.0	2	2	0
fam13724	2	2	2	2.0	0.0	0.0	2	2	0
fam13725	2	2	2	2.0	0.0	0.0	2	2	0
fam13726	2	2	2	2.0	0.0	0.0	2	2	0
fam13727	2	2	2	2.0	0.0	0.0	2	2	0
fam13728	2	2	2	2.0	0.0	0.0	2	2	0
fam13729	2	2	2	2.0	0.0	0.0	2	2	0
fam13730	2	2	2	2.0	0.0	0.0	2	2	0
fam13731	2	2	2	2.0	0.0	0.0	2	2	0
fam13732	2	2	2	2.0	0.0	0.0	2	2	0
fam13733	2	2	2	2.0	0.0	0.0	2	2	0
fam13734	2	2	2	2.0	0.0	0.0	2	2	0
fam13735	2	2	2	2.0	0.0	0.0	2	2	0
fam13736	2	2	2	2.0	0.0	0.0	2	2	0
fam13737	2	2	2	2.0	0.0	0.0	2	2	0
fam13738	2	2	2	2.0	0.0	0.0	2	2	0
fam13739	2	2	2	2.0	0.0	0.0	2	2	0
fam13740	2	2	2	2.0	0.0	0.0	2	2	0
fam13741	2	2	2	2.0	0.0	0.0	2	2	0
fam13742	2	2	2	2.0	0.0	0.0	2	2	0
fam13743	2	2	2	2.0	0.0	0.0	2	2	0
fam13744	2	2	2	2.0	0.0	0.0	2	2	0
fam13745	2	2	2	2.0	0.0	0.0	2	2	0
fam13746	2	2	2	2.0	0.0	0.0	2	2	0
fam13747	2	2	2	2.0	0.0	0.0	2	2	0
fam13748	2	2	2	2.0	0.0	0.0	2	2	0
fam13749	2	2	2	2.0	0.0	0.0	2	2	0
fam13750	2	2	2	2.0	0.0	0.0	2	2	0
fam13751	2	2	2	2.0	0.0	0.0	2	2	0
fam13752	2	2	2	2.0	0.0	0.0	2	2	0
fam13753	2	2	2	2.0	0.0	0.0	2	2	0
fam13754	2	2	2	2.0	0.0	0.0	2	2	0
fam13755	2	2	2	2.0	0.0	0.0	2	2	0
fam13756	2	2	2	2.0	0.0	0.0	2	2	0
fam13757	2	2	2	2.0	0.0	0.0	2	2	0
fam13758	2	2	2	2.0	0.0	0.0	2	2	0
fam13759	2	2	2	2.0	0.0	0.0	2	2	0
fam13760	2	2	2	2.0	0.0	0.0	2	2	0
fam13761	2	2	2	2.0	0.0	0.0	2	2	0
fam13762	2	2	2	2.0	0.0	0.0	2	2	0
fam13763	2	2	2	2.0	0.0	0.0	2	2	0
fam13764	2	2	2	2.0	0.0	0.0	2	2	0
fam13765	2	2	2	2.0	0.0	0.0	2	2	0
fam13766	2	2	2	2.0	0.0	0.0	2	2	0
fam13767	2	2	2	2.0	0.0	0.0	2	2	0
fam13768	2	2	2	2.0	0.0	0.0	2	2	0
fam13769	2	2	2	2.0	0.0	0.0	2	2	0
fam13770	2	2	2	2.0	0.0	0.0	2	2	0
fam13771	2	2	2	2.0	0.0	0.0	2	2	0
fam13772	2	2	2	2.0	0.0	0.0	2	2	0
fam13773	2	2	2	2.0	0.0	0.0	2	2	0
fam13774	2	2	2	2.0	0.0	0.0	2	2	0
fam13775	2	2	2	2.0	0.0	0.0	2	2	0
fam13776	2	2	2	2.0	0.0	0.0	2	2	0
fam13777	2	2	2	2.0	0.0	0.0	2	2	0
fam13778	2	2	2	2.0	0.0	0.0	2	2	0
fam13779	2	2	2	2.0	0.0	0.0	2	2	0
fam13780	2	2	2	2.0	0.0	0.0	2	2	0
fam13781	2	2	2	2.0	0.0	0.0	2	2	0
fam13782	2	2	2	2.0	0.0	0.0	2	2	0
fam13783	2	2	2	2.0	0.0	0.0	2	2	0
fam13784	2	2	2	2.0	0.0	0.0	2	2	0
fam13785	2	2	2	2.0	0.0	0.0	2	2	0
fam13786	2	2	2	2.0	0.0	0.0	2	2	0
fam13787	2	2	2	2.0	0.0	0.0	2	2	0
fam13788	2	2	2	2.0	0.0	0.0	2	2	0
fam13789	2	2	2	2.0	0.0	0.0	2	2	0
fam13790	2	2	2	2.0	0.0	0.0	2	2	0
fam13791	2	2	2	2.0	0.0	0.0	2	2	0
fam13792	2	2	2	2.0	0.0	0.0	2	2	0
fam13793	2	2	2	2.0	0.0	0.0	2	2	0
fam13794	2	2	2	2.0	0.0	0.0	2	2	0
fam13795	2	2	2	2.0	0.0	0.0	2	2	0
fam13796	2	2	2	2.0	0.0	0.0	2	2	0
fam13797	2	2	2	2.0	0.0	0.0	2	2	0
fam13798	2	2	2	2.0	0.0	0.0	2	2	0
fam13799	2	2	2	2.0	0.0	0.0	2	2	0
fam13800	2	2	2	2.0	0.0	0.0	2	2	0
fam13801	2	2	2	2.0	0.0	0.0	2	2	0
fam13802	2	2	2	2.0	0.0	0.0	2	2	0
fam13803	2	2	2	2.0	0.0	0.0	2	2	0
fam13804	2	2	2	2.0	0.0	0.0	2	2	0
fam13805	2	2	2	2.0	0.0	0.0	2	2	0
fam13806	2	2	2	2.0	0.0	0.0	2	2	0
fam13807	2	2	2	2.0	0.0	0.0	2	2	0
fam13808	2	2	2	2.0	0.0	0.0	2	2	0
fam13809	2	2	2	2.0	0.0	0.0	2	2	0
fam13810	2	2	2	2.0	0.0	0.0	2	2	0
fam13811	2	2	2	2.0	0.0	0.0	2	2	0
fam13812	2	2	2	2.0	0.0	0.0	2	2	0
fam13813	2	2	2	2.0	0.0	0.0	2	2	0
fam13814	2	2	2	2.0	0.0	0.0	2	2	0
fam13815	2	2	2	2.0	0.0	0.0	2	2	0
fam13816	2	2	2	2.0	0.0	0.0	2	2	0
fam13817	2	2	2	2.0	0.0	0.0	2	2	0
fam13818	2	2	2	2.0	0.0	0.0	2	2	0
fam13819	2	2	2	2.0	0.0	0.0	2	2	0
fam13820	2	2	2	2.0	0.0	0.0	2	2	0
fam13821	2	2	2	2.0	0.0	0.0	2	2	0
fam13822	2	2	2	2.0	0.0	0.0	2	2	0
fam13823	2	2	2	2.0	0.0	0.0	2	2	0
fam13824	2	2	2	2.0	0.0	0.0	2	2	0
fam13825	2	2	2	2.0	0.0	0.0	2	2	0
fam13826	2	2	2	2.0	0.0	0.0	2	2	0
fam13827	2	2	2	2.0	0.0	0.0	2	2	0
fam13828	2	2	2	2.0	0.0	0.0	2	2	0
fam13829	2	2	2	2.0	0.0	0.0	2	2	0
fam13830	2	2	2	2.0	0.0	0.0	2	2	0
fam13831	2	2	2	2.0	0.0	0.0	2	2	0
fam13832	2	2	2	2.0	0.0	0.0	2	2	0
fam13833	2	2	2	2.0	0.0	0.0	2	2	0
fam13834	2	2	2	2.0	0.0	0.0	2	2	0
fam13835	2	2	2	2.0	0.0	0.0	2	2	0
fam13836	2	2	2	2.0	0.0	0.0	2	2	0
fam13837	2	2	2	2.0	0.0	0.0	2	2	0
fam13838	2	2	2	2.0	0.0	0.0	2	2	0
fam13839	2	2	2	2.0	0.0	0.0	2	2	0
fam13840	2	2	2	2.0	0.0	0.0	2	2	0
fam13841	2	2	2	2.0	0.0	0.0	2	2	0
fam13842	2	2	2	2.0	0.0	0.0	2	2	0
fam13843	2	2	2	2.0	0.0	0.0	2	2	0
fam13844	2	2	2	2.0	0.0	0.0	2	2	0
fam13845	2	2	2	2.0	0.0	0.0	2	2	0
fam13846	2	2	2	2.0	0.0	0.0	2	2	0
fam13847	2	2	2	2.0	0.0	0.0	2	2	0
fam13848	2	2	2	2.0	0.0	0.0	2	2	0
fam13849	2	2	2	2.0	0.0	0.0	2	2	0
fam13850	2	2	2	2.0	0.0	0.0	2	2	0
fam13851	2	2	2	2.0	0.0	0.0	2	2	0
fam13852	2	2	2	2.0	0.0	0.0	2	2	0
fam13853	2	2	2	2.0	0.0	0.0	2	2	0
fam13854	2	2	2	2.0	0.0	0.0	2	2	0
fam13855	2	2	2	2.0	0.0	0.0	2	2	0
fam13856	2	2	2	2.0	0.0	0.0	2	2	0
fam13857	2	2	2	2.0	0.0	0.0	2	2	0
fam13858	2	2	2	2.0	0.0	0.0	2	2	0
fam13859	2	2	2	2.0	0.0	0.0	2	2	0
fam13860	2	2	2	2.0	0.0	0.0	2	2	0
fam13861	2	2	2	2.0	0.0	0.0	2	2	0
fam13862	2	2	2	2.0	0.0	0.0	2	2	0
fam13863	2	2	2	2.0	0.0	0.0	2	2	0
fam13864	2	2	2	2.0	0.0	0.0	2	2	0
fam13865	2	2	2	2.0	0.0	0.0	2	2	0
fam13866	2	2	2	2.0	0.0	0.0	2	2	0
fam13867	2	2	2	2.0	0.0	0.0	2	2	0
fam13868	2	2	2	2.0	0.0	0.0	2	2	0
fam13869	2	2	2	2.0	0.0	0.0	2	2	0
fam13870	2	2	2	2.0	0.0	0.0	2	2	0
fam13871	2	2	2	2.0	0.0	0.0	2	2	0
fam13872	2	2	2	2.0	0.0	0.0	2	2	0
fam13873	2	2	2	2.0	0.0	0.0	2	2	0
fam13874	2	2	2	2.0	0.0	0.0	2	2	0
fam13875	2	2	2	2.0	0.0	0.0	2	2	0
fam13876	2	2	2	2.0	0.0	0.0	2	2	0
fam13877	2	2	2	2.0	0.0	0.0	2	2	0
fam13878	2	2	2	2.0	0.0	0.0	2	2	0
fam13879	2	2	2	2.0	0.0	0.0	2	2	0
fam13880	2	2	2	2.0	0.0	0.0	2	2	0
fam13881	2	2	2	2.0	0.0	0.0	2	2	0
fam13882	2	2	2	2.0	0.0	0.0	2	2	0
fam13883	2	2	2	2.0	0.0	0.0	2	2	0
fam13884	2	2	2	2.0	0.0	0.0	2	2	0
fam13885	2	2	2	2.0	0.0	0.0	2	2	0
fam13886	2	2	2	2.0	0.0	0.0	2	2	0
fam13887	2	2	2	2.0	0.0	0.0	2	2	0
fam13888	2	2	2	2.0	0.0	0.0	2	2	0
fam13889	2	2	2	2.0	0.0	0.0	2	2	0
fam13890	2	2	2	2.0	0.0	0.0	2	2	0
fam13891	2	2	2	2.0	0.0	0.0	2	2	0
fam13892	2	2	2	2.0	0.0	0.0	2	2	0
fam13893	2	2	2	2.0	0.0	0.0	2	2	0
fam13894	2	2	2	2.0	0.0	0.0	2	2	0
fam13895	2	2	2	2.0	0.0	0.0	2	2	0
fam13896	2	2	2	2.0	0.0	0.0	2	2	0
fam13897	2	2	2	2.0	0.0	0.0	2	2	0
fam13898	2	2	2	2.0	0.0	0.0	2	2	0
fam13899	2	2	2	2.0	0.0	0.0	2	2	0
fam13900	2	2	2	2.0	0.0	0.0	2	2	0
fam13901	2	2	2	2.0	0.0	0.0	2	2	0
fam13902	2	2	2	2.0	0.0	0.0	2	2	0
fam13903	2	2	2	2.0	0.0	0.0	2	2	0
fam13904	2	2	2	2.0	0.0	0.0	2	2	0
fam13905	2	2	2	2.0	0.0	0.0	2	2	0
fam13906	2	2	2	2.0	0.0	0.0	2	2	0
fam13907	2	2	2	2.0	0.0	0.0	2	2	0
fam13908	2	2	2	2.0	0.0	0.0	2	2	0
fam13909	2	2	2	2.0	0.0	0.0	2	2	0
fam13910	2	2	2	2.0	0.0	0.0	2	2	0
fam13911	2	2	2	2.0	0.0	0.0	2	2	0
fam13912	2	2	2	2.0	0.0	0.0	2	2	0
fam13913	2	2	2	2.0	0.0	0.0	2	2	0
fam13914	2	2	2	2.0	0.0	0.0	2	2	0
fam13915	2	2	2	2.0	0.0	0.0	2	2	0
fam13916	2	2	2	2.0	0.0	0.0	2	2	0
fam13917	2	2	2	2.0	0.0	0.0	2	2	0
fam13918	2	2	2	2.0	0.0	0.0	2	2	0
fam13919	2	2	2	2.0	0.0	0.0	2	2	0
fam13920	2	2	2	2.0	0.0	0.0	2	2	0
fam13921	2	2	2	2.0	0.0	0.0	2	2	0
fam13922	2	2	2	2.0	0.0	0.0	2	2	0
fam13923	2	2	2	2.0	0.0	0.0	2	2	0
fam13924	2	2	2	2.0	0.0	0.0	2	2	0
fam13925	2	2	2	2.0	0.0	0.0	2	2	0
fam13926	2	2	2	2.0	0.0	0.0	2	2	0
fam13927	2	2	2	2.0	0.0	0.0	2	2	0
fam13928	2	2	2	2.0	0.0	0.0	2	2	0
fam13929	2	2	2	2.0	0.0	0.0	2	2	0
fam13930	2	2	2	2.0	0.0	0.0	2	2	0
fam13931	2	2	2	2.0	0.0	0.0	2	2	0
fam13932	2	2	2	2.0	0.0	0.0	2	2	0
fam13933	2	2	2	2.0	0.0	0.0	2	2	0
fam13934	2	2	2	2.0	0.0	0.0	2	2	0
fam13935	2	2	2	2.0	0.0	0.0	2	2	0
fam13936	2	2	2	2.0	0.0	0.0	2	2	0
fam13937	2	2	2	2.0	0.0	0.0	2	2	0
fam13938	2	2	2	2.0	0.0	0.0	2	2	0
fam13939	2	2	2	2.0	0.0	0.0	2	2	0
fam13940	2	2	2	2.0	0.0	0.0	2	2	0
fam13941	2	2	2	2.0	0.0	0.0	2	2	0
fam13942	2	2	2	2.0	0.0	0.0	2	2	0
fam13943	2	2	2	2.0	0.0	0.0	2	2	0
fam13944	2	2	2	2.0	0.0	0.0	2	2	0
fam13945	2	2	2	2.0	0.0	0.0	2	2	0
fam13946	2	2	2	2.0	0.0	0.0	2	2	0
fam13947	2	2	2	2.0	0.0	0.0	2	2	0
fam13948	2	2	2	2.0	0.0	0.0	2	2	0
fam13949	2	2	2	2.0	0.0	0.0	2	2	0
fam13950	2	2	2	2.0	0.0	0.0	2	2	0
fam13951	2	2	2	2.0	0.0	0.0	2	2	0
fam13952	2	2	2	2.0	0.0	0.0	2	2	0
fam13953	2	2	2	2.0	0.0	0.0	2	2	0
fam13954	2	2	2	2.0	0.0	0.0	2	2	0
fam13955	2	2	2	2.0	0.0	0.0	2	2	0
fam13956	2	2	2	2.0	0.0	0.0	2	2	0
fam13957	2	2	2	2.0	0.0	0.0	2	2	0
fam13958	2	2	2	2.0	0.0	0.0	2	2	0
fam13959	2	2	2	2.0	0.0	0.0	2	2	0
fam13960	2	2	2	2.0	0.0	0.0	2	2	0
fam13961	2	2	2	2.0	0.0	0.0	2	2	0
fam13962	2	2	2	2.0	0.0	0.0	2	2	0
fam13963	2	2	2	2.0	0.0	0.0	2	2	0
fam13964	2	2	2	2.0	0.0	0.0	2	2	0
fam13965	2	2	2	2.0	0.0	0.0	2	2	0
fam13966	2	2	2	2.0	0.0	0.0	2	2	0
fam13967	2	2	2	2.0	0.0	0.0	2	2	0
fam13968	2	2	2	2.0	0.0	0.0	2	2	0
fam13969	2	2	2	2.0	0.0	0.0	2	2	0
fam13970	2	2	2	2.0	0.0	0.0	2	2	0
fam13971	2	2	2	2.0	0.0	0.0	2	2	0
fam13972	2	2	2	2.0	0.0	0.0	2	2	0
fam13973	2	2	2	2.0	0.0	0.0	2	2	0
fam13974	2	2	2	2.0	0.0	0.0	2	2	0
fam13975	2	2	2	2.0	0.0	0.0	2	2	0
fam13976	2	2	2	2.0	0.0	0.0	2	2	0
fam13977	2	2	2	2.0	0.0	0.0	2	2	0
fam13978	2	2	2	2.0	0.0	0.0	2	2	0
fam13979	2	2	2	2.0	0.0	0.0	2	2	0
fam13980	2	2	2	2.0	0.0	0.0	2	2	0
fam13981	2	2	2	2.0	0.0	0.0	2	2	0
fam13982	2	2	2	2.0	0.0	0.0	2	2	0
fam13983	2	2	2	2.0	0.0	0.0	2	2	0
fam13984	2	2	2	2.0	0.0	0.0	2	2	0
fam13985	2	2	2	2.0	0.0	0.0	2	2	0
fam13986	2	2	2	2.0	0.0	0.0	2	2	0
fam13987	2	2	2	2.0	0.0	0.0	2	2	0
fam13988	2	2	2	2.0	0.0	0.0	2	2	0
fam13989	2	2	2	2.0	0.0	0.0	2	2	0
fam13990	2	2	2	2.0	0.0	0.0	2	2	0
fam13991	2	2	2	2.0	0.0	0.0	2	2	0
fam13992	2	2	2	2.0	0.0	0.0	2	2	0
fam13993	2	2	2	2.0	0.0	0.0	2	2	0
fam13994	2	2	2	2.0	0.0	0.0	2	2	0
fam13995	2	2	2	2.0	0.0	0.0	2	2	0
fam13996	2	2	2	2.0	0.0	0.0	2	2	0
fam13997	2	2	2	2.0	0.0	0.0	2	2	0
fam13998	2	2	2	2.0	0.0	0.0	2	2	0
fam13999	2	2	2	2.0	0.0	0.0	2	2	0
fam14000	2	2	2	2.0	0.0	0.0	2	2	0
fam14001	2	2	2	2.0	0.0	0.0	2	2	0
fam14002	2	2	2	2.0	0.0	0.0	2	2	0
fam14003	2	2	2	2.0	0.0	0.0	2	2	0
fam14004	2	2	2	2.0	0.0	0.0	2	2	0
fam14005	2	2	2	2.0	0.0	0.0	2	2	0
fam14006	2	2	2	2.0	0.0	0.0	2	2	0
fam14007	2	2	2	2.0	0.0	0.0	2	2	0
fam14008	2	2	2	2.0	0.0	0.0	2	2	0
fam14009	2	2	2	2.0	0.0	0.0	2	2	0
fam14010	2	2	2	2.0	0.0	0.0	2	2	0
fam14011	2	2	2	2.0	0.0	0.0	2	2	0
fam14012	2	2	2	2.0	0.0	0.0	2	2	0
fam14013	2	2	2	2.0	0.0	0.0	2	2	0
fam14014	2	2	2	2.0	0.0	0.0	2	2	0
fam14015	2	2	2	2.0	0.0	0.0	2	2	0
fam14016	2	2	2	2.0	0.0	0.0	2	2	0
fam14017	2	2	2	2.0	0.0	0.0	2	2	0
fam14018	2	2	2	2.0	0.0	0.0	2	2	0
fam14019	2	2	2	2.0	0.0	0.0	2	2	0
fam14020	2	2	2	2.0	0.0	0.0	2	2	0
fam14021	2	2	2	2.0	0.0	0.0	2	2	0
fam14022	2	2	2	2.0	0.0	0.0	2	2	0
fam14023	2	2	2	2.0	0.0	0.0	2	2	0
fam14024	2	2	2	2.0	0.0	0.0	2	2	0
fam14025	2	2	2	2.0	0.0	0.0	2	2	0
fam14026	2	2	2	2.0	0.0	0.0	2	2	0
fam14027	2	2	2	2.0	0.0	0.0	2	2	0
fam14028	2	2	2	2.0	0.0	0.0	2	2	0
fam14029	2	2	2	2.0	0.0	0.0	2	2	0
fam14030	2	2	2	2.0	0.0	0.0	2	2	0
fam14031	2	2	2	2.0	0.0	0.0	2	2	0
fam14032	2	2	2	2.0	0.0	0.0	2	2	0
fam14033	2	2	2	2.0	0.0	0.0	2	2	0
fam14034	2	2	2	2.0	0.0	0.0	2	2	0
fam14035	2	2	2	2.0	0.0	0.0	2	2	0
fam14036	2	2	2	2.0	0.0	0.0	2	2	0
fam14037	2	2	2	2.0	0.0	0.0	2	2	0
fam14038	2	2	2	2.0	0.0	0.0	2	2	0
fam14039	2	2	2	2.0	0.0	0.0	2	2	0
fam14040	2	2	2	2.0	0.0	0.0	2	2	0
fam14041	2	2	2	2.0	0.0	0.0	2	2	0
fam14042	2	2	2	2.0	0.0	0.0	2	2	0
fam14043	2	2	2	2.0	0.0	0.0	2	2	0
fam14044	2	2	2	2.0	0.0	0.0	2	2	0
fam14045	2	2	2	2.0	0.0	0.0	2	2	0
fam14046	2	2	2	2.0	0.0	0.0	2	2	0
fam14047	2	2	2	2.0	0.0	0.0	2	2	0
fam14048	2	2	2	2.0	0.0	0.0	2	2	0
fam14049	2	2	2	2.0	0.0	0.0	2	2	0
fam14050	2	2	2	2.0	0.0	0.0	2	2	0
fam14051	2	2	2	2.0	0.0	0.0	2	2	0
fam14052	2	2	2	2.0	0.0	0.0	2	2	0
fam14053	2	2	2	2.0	0.0	0.0	2	2	0
fam14054	2	2	2	2.0	0.0	0.0	2	2	0
fam14055	2	2	2	2.0	0.0	0.0	2	2	0
fam14056	2	2	2	2.0	0.0	0.0	2	2	0
fam14057	2	2	2	2.0	0.0	0.0	2	2	0
fam14058	2	2	2	2.0	0.0	0.0	2	2	0
fam14059	2	2	2	2.0	0.0	0.0	2	2	0
fam14060	2	2	2	2.0	0.0	0.0	2	2	0
fam14061	2	2	2	2.0	0.0	0.0	2	2	0
fam14062	2	2	2	2.0	0.0	0.0	2	2	0
fam14063	2	2	2	2.0	0.0	0.0	2	2	0
fam14064	2	2	2	2.0	0.0	0.0	2	2	0
fam14065	2	2	2	2.0	0.0	0.0	2	2	0
fam14066	2	2	2	2.0	0.0	0.0	2	2	0
fam14067	2	2	2	2.0	0.0	0.0	2	2	0
fam14068	2	2	2	2.0	0.0	0.0	2	2	0
fam14069	2	2	2	2.0	0.0	0.0	2	2	0
fam14070	2	2	2	2.0	0.0	0.0	2	2	0
fam14071	2	2	2	2.0	0.0	0.0	2	2	0
fam14072	2	2	2	2.0	0.0	0.0	2	2	0
fam14073	2	2	2	2.0	0.0	0.0	2	2	0
fam14074	2	2	2	2.0	0.0	0.0	2	2	0
fam14075	2	2	2	2.0	0.0	0.0	2	2	0
fam14076	2	2	2	2.0	0.0	0.0	2	2	0
fam14077	2	2	2	2.0	0.0	0.0	2	2	0
fam14078	2	2	2	2.0	0.0	0.0	2	2	0
fam14079	2	2	2	2.0	0.0	0.0	2	2	0
fam14080	2	2	2	2.0	0.0	0.0	2	2	0
fam14081	2	2	2	2.0	0.0	0.0	2	2	0
fam14082	2	2	2	2.0	0.0	0.0	2	2	0
fam14083	2	2	2	2.0	0.0	0.0	2	2	0
fam14084	2	2	2	2.0	0.0	0.0	2	2	0
fam14085	2	2	2	2.0	0.0	0.0	2	2	0
fam14086	2	2	2	2.0	0.0	0.0	2	2	0
fam14087	2	2	2	2.0	0.0	0.0	2	2	0
fam14088	2	2	2	2.0	0.0	0.0	2	2	0
fam14089	2	2	2	2.0	0.0	0.0	2	2	0
fam14090	2	2	2	2.0	0.0	0.0	2	2	0
fam14091	2	2	2	2.0	0.0	0.0	2	2	0
fam14092	2	2	2	2.0	0.0	0.0	2	2	0
fam14093	2	2	2	2.0	0.0	0.0	2	2	0
fam14094	2	2	2	2.0	0.0	0.0	2	2	0
fam14095	2	2	2	2.0	0.0	0.0	2	2	0
fam14096	2	2	2	2.0	0.0	0.0	2	2	0
fam14097	2	2	2	2.0	0.0	0.0	2	2	0
fam14098	2	2	2	2.0	0.0	0.0	2	2	0
fam14099	2	2	2	2.0	0.0	0.0	2	2	0
fam14100	2	2	2	2.0	0.0	0.0	2	2	0
fam14101	2	2	2	2.0	0.0	0.0	2	2	0
fam14102	2	2	2	2.0	0.0	0.0	2	2	0
fam14103	2	2	2	2.0	0.0	0.0	2	2	0
fam14104	2	2	2	2.0	0.0	0.0	2	2	0
fam14105	2	2	2	2.0	0.0	0.0	2	2	0
fam14106	2	2	2	2.0	0.0	0.0	2	2	0
fam14107	2	2	2	2.0	0.0	0.0	2	2	0
fam14108	2	2	2	2.0	0.0	0.0	2	2	0
fam14109	2	2	2	2.0	0.0	0.0	2	2	0
fam14110	2	2	2	2.0	0.0	0.0	2	2	0
fam14111	2	2	2	2.0	0.0	0.0	2	2	0
fam14112	2	2	2	2.0	0.0	0.0	2	2	0
fam14113	2	2	2	2.0	0.0	0.0	2	2	0
fam14114	2	2	2	2.0	0.0	0.0	2	2	0
fam14115	2	2	2	2.0	0.0	0.0	2	2	0
fam14116	2	2	2	2.0	0.0	0.0	2	2	0
fam14117	2	2	2	2.0	0.0	0.0	2	2	0
fam14118	2	2	2	2.0	0.0	0.0	2	2	0
fam14119	2	2	2	2.0	0.0	0.0	2	2	0
fam14120	2	2	2	2.0	0.0	0.0	2	2	0
fam14121	2	2	2	2.0	0.0	0.0	2	2	0
fam14122	2	2	2	2.0	0.0	0.0	2	2	0
fam14123	2	2	2	2.0	0.0	0.0	2	2	0
fam14124	2	2	2	2.0	0.0	0.0	2	2	0
fam14125	2	2	2	2.0	0.0	0.0	2	2	0
fam14126	2	2	2	2.0	0.0	0.0	2	2	0
fam14127	2	2	2	2.0	0.0	0.0	2	2	0
fam14128	2	2	2	2.0	0.0	0.0	2	2	0
fam14129	2	2	2	2.0	0.0	0.0	2	2	0
fam14130	2	2	2	2.0	0.0	0.0	2	2	0
fam14131	2	2	2	2.0	0.0	0.0	2	2	0
fam14132	2	2	2	2.0	0.0	0.0	2	2	0
fam14133	2	2	2	2.0	0.0	0.0	2	2	0
fam14134	2	2	2	2.0	0.0	0.0	2	2	0
fam14135	2	2	2	2.0	0.0	0.0	2	2	0
fam14136	2	2	2	2.0	0.0	0.0	2	2	0
fam14137	2	2	2	2.0	0.0	0.0	2	2	0
fam14138	2	2	2	2.0	0.0	0.0	2	2	0
fam14139	2	2	2	2.0	0.0	0.0	2	2	0
fam14140	2	2	2	2.0	0.0	0.0	2	2	0
fam14141	2	2	2	2.0	0.0	0.0	2	2	0
fam14142	2	2	2	2.0	0.0	0.0	2	2	0
fam14143	2	2	2	2.0	0.0	0.0	2	2	0
fam14144	2	2	2	2.0	0.0	0.0	2	2	0
fam14145	2	2	2	2.0	0.0	0.0	2	2	0
fam14146	2	2	2	2.0	0.0	0.0	2	2	0
fam14147	2	2	2	2.0	0.0	0.0	2	2	0
fam14148	2	2	2	2.0	0.0	0.0	2	2	0
fam14149	2	2	2	2.0	0.0	0.0	2	2	0
fam14150	2	2	2	2.0	0.0	0.0	2	2	0
fam14151	2	2	2	2.0	0.0	0.0	2	2	0
fam14152	2	2	2	2.0	0.0	0.0	2	2	0
fam14153	2	2	2	2.0	0.0	0.0	2	2	0
fam14154	2	2	2	2.0	0.0	0.0	2	2	0
fam14155	2	2	2	2.0	0.0	0.0	2	2	0
fam14156	2	2	2	2.0	0.0	0.0	2	2	0
fam14157	2	2	2	2.0	0.0	0.0	2	2	0
fam14158	2	2	2	2.0	0.0	0.0	2	2	0
fam14159	2	2	2	2.0	0.0	0.0	2	2	0
fam14160	2	2	2	2.0	0.0	0.0	2	2	0
fam14161	2	2	2	2.0	0.0	0.0	2	2	0
fam14162	2	2	2	2.0	0.0	0.0	2	2	0
fam14163	2	2	2	2.0	0.0	0.0	2	2	0
fam14164	2	2	2	2.0	0.0	0.0	2	2	0
fam14165	2	2	2	2.0	0.0	0.0	2	2	0
fam14166	2	2	2	2.0	0.0	0.0	2	2	0
fam14167	2	2	2	2.0	0.0	0.0	2	2	0
fam14168	2	2	2	2.0	0.0	0.0	2	2	0
fam14169	2	2	2	2.0	0.0	0.0	2	2	0
fam14170	2	2	2	2.0	0.0	0.0	2	2	0
fam14171	2	2	2	2.0	0.0	0.0	2	2	0
fam14172	2	2	2	2.0	0.0	0.0	2	2	0
fam14173	2	2	2	2.0	0.0	0.0	2	2	0
fam14174	2	2	2	2.0	0.0	0.0	2	2	0
fam14175	2	2	2	2.0	0.0	0.0	2	2	0
fam14176	2	2	2	2.0	0.0	0.0	2	2	0
fam14177	2	2	2	2.0	0.0	0.0	2	2	0
fam14178	2	2	2	2.0	0.0	0.0	2	2	0
fam14179	2	2	2	2.0	0.0	0.0	2	2	0
fam14180	2	2	2	2.0	0.0	0.0	2	2	0
fam14181	2	2	2	2.0	0.0	0.0	2	2	0
fam14182	2	2	2	2.0	0.0	0.0	2	2	0
fam14183	2	2	2	2.0	0.0	0.0	2	2	0
fam14184	2	2	2	2.0	0.0	0.0	2	2	0
fam14185	2	2	2	2.0	0.0	0.0	2	2	0
fam14186	2	2	2	2.0	0.0	0.0	2	2	0
fam14187	2	2	2	2.0	0.0	0.0	2	2	0
fam14188	2	2	2	2.0	0.0	0.0	2	2	0
fam14189	2	2	2	2.0	0.0	0.0	2	2	0
fam14190	2	2	2	2.0	0.0	0.0	2	2	0
fam14191	2	2	2	2.0	0.0	0.0	2	2	0
fam14192	2	2	2	2.0	0.0	0.0	2	2	0
fam14193	2	2	2	2.0	0.0	0.0	2	2	0
fam14194	2	2	2	2.0	0.0	0.0	2	2	0
fam14195	2	2	2	2.0	0.0	0.0	2	2	0
fam14196	2	2	2	2.0	0.0	0.0	2	2	0
fam14197	2	2	2	2.0	0.0	0.0	2	2	0
fam14198	2	2	2	2.0	0.0	0.0	2	2	0
fam14199	2	2	2	2.0	0.0	0.0	2	2	0
fam14200	2	2	2	2.0	0.0	0.0	2	2	0
fam14201	2	2	2	2.0	0.0	0.0	2	2	0
fam14202	2	2	2	2.0	0.0	0.0	2	2	0
fam14203	2	2	2	2.0	0.0	0.0	2	2	0
fam14204	2	2	2	2.0	0.0	0.0	2	2	0
fam14205	2	2	2	2.0	0.0	0.0	2	2	0
fam14206	2	2	2	2.0	0.0	0.0	2	2	0
fam14207	2	2	2	2.0	0.0	0.0	2	2	0
fam14208	2	2	2	2.0	0.0	0.0	2	2	0
fam14209	2	2	2	2.0	0.0	0.0	2	2	0
fam14210	2	2	2	2.0	0.0	0.0	2	2	0
fam14211	2	2	2	2.0	0.0	0.0	2	2	0
fam14212	2	2	2	2.0	0.0	0.0	2	2	0
fam14213	2	2	2	2.0	0.0	0.0	2	2	0
fam14214	2	2	2	2.0	0.0	0.0	2	2	0
fam14215	2	2	2	2.0	0.0	0.0	2	2	0
fam14216	2	2	2	2.0	0.0	0.0	2	2	0
fam14217	2	2	2	2.0	0.0	0.0	2	2	0
fam14218	2	2	2	2.0	0.0	0.0	2	2	0
fam14219	2	2	2	2.0	0.0	0.0	2	2	0
fam14220	2	2	2	2.0	0.0	0.0	2	2	0
fam14221	2	2	2	2.0	0.0	0.0	2	2	0
fam14222	2	2	2	2.0	0.0	0.0	2	2	0
fam14223	2	2	2	2.0	0.0	0.0	2	2	0
fam14224	2	2	2	2.0	0.0	0.0	2	2	0
fam14225	2	2	2	2.0	0.0	0.0	2	2	0
fam14226	2	2	2	2.0	0.0	0.0	2	2	0
fam14227	2	2	2	2.0	0.0	0.0	2	2	0
fam14228	2	2	2	2.0	0.0	0.0	2	2	0
fam14229	2	2	2	2.0	0.0	0.0	2	2	0
fam14230	2	2	2	2.0	0.0	0.0	2	2	0
fam14231	2	2	2	2.0	0.0	0.0	2	2	0
fam14232	2	2	2	2.0	0.0	0.0	2	2	0
fam14233	2	2	2	2.0	0.0	0.0	2	2	0
fam14234	2	2	2	2.0	0.0	0.0	2	2	0
fam14235	2	2	2	2.0	0.0	0.0	2	2	0
fam14236	2	2	2	2.0	0.0	0.0	2	2	0
fam14237	2	2	2	2.0	0.0	0.0	2	2	0
fam14238	2	2	2	2.0	0.0	0.0	2	2	0
fam14239	2	2	2	2.0	0.0	0.0	2	2	0
fam14240	2	2	2	2.0	0.0	0.0	2	2	0
fam14241	2	2	2	2.0	0.0	0.0	2	2	0
fam14242	2	2	2	2.0	0.0	0.0	2	2	0
fam14243	2	2	2	2.0	0.0	0.0	2	2	0
fam14244	2	2	2	2.0	0.0	0.0	2	2	0
fam14245	2	2	2	2.0	0.0	0.0	2	2	0
fam14246	2	2	2	2.0	0.0	0.0	2	2	0
fam14247	2	2	2	2.0	0.0	0.0	2	2	0
fam14248	2	2	2	2.0	0.0	0.0	2	2	0
fam14249	2	2	2	2.0	0.0	0.0	2	2	0
fam14250	2	2	2	2.0	0.0	0.0	2	2	0
fam14251	2	2	2	2.0	0.0	0.0	2	2	0
fam14252	2	2	2	2.0	0.0	0.0	2	2	0
fam14253	2	2	2	2.0	0.0	0.0	2	2	0
fam14254	2	2	2	2.0	0.0	0.0	2	2	0
fam14255	2	2	2	2.0	0.0	0.0	2	2	0
fam14256	2	2	2	2.0	0.0	0.0	2	2	0
fam14257	2	2	2	2.0	0.0	0.0	2	2	0
fam14258	2	2	2	2.0	0.0	0.0	2	2	0
fam14259	2	2	2	2.0	0.0	0.0	2	2	0
fam14260	2	2	2	2.0	0.0	0.0	2	2	0
fam14261	2	2	2	2.0	0.0	0.0	2	2	0
fam14262	2	2	2	2.0	0.0	0.0	2	2	0
fam14263	2	2	2	2.0	0.0	0.0	2	2	0
fam14264	2	2	2	2.0	0.0	0.0	2	2	0
fam14265	2	2	2	2.0	0.0	0.0	2	2	0
fam14266	2	2	2	2.0	0.0	0.0	2	2	0
fam14267	2	2	2	2.0	0.0	0.0	2	2	0
fam14268	2	2	2	2.0	0.0	0.0	2	2	0
fam14269	2	2	2	2.0	0.0	0.0	2	2	0
fam14270	2	2	2	2.0	0.0	0.0	2	2	0
fam14271	2	2	2	2.0	0.0	0.0	2	2	0
fam14272	2	2	2	2.0	0.0	0.0	2	2	0
fam14273	2	2	2	2.0	0.0	0.0	2	2	0
fam14274	2	2	2	2.0	0.0	0.0	2	2	0
fam14275	2	2	2	2.0	0.0	0.0	2	2	0
fam14276	2	2	2	2.0	0.0	0.0	2	2	0
fam14277	2	2	2	2.0	0.0	0.0	2	2	0
fam14278	2	2	2	2.0	0.0	0.0	2	2	0
fam14279	2	2	2	2.0	0.0	0.0	2	2	0
fam14280	2	2	2	2.0	0.0	0.0	2	2	0
fam14281	2	2	2	2.0	0.0	0.0	2	2	0
fam14282	2	2	2	2.0	0.0	0.0	2	2	0
fam14283	2	2	2	2.0	0.0	0.0	2	2	0
fam14284	2	2	2	2.0	0.0	0.0	2	2	0
fam14285	2	2	2	2.0	0.0	0.0	2	2	0
fam14286	2	2	2	2.0	0.0	0.0	2	2	0
fam14287	2	2	2	2.0	0.0	0.0	2	2	0
fam14288	2	2	2	2.0	0.0	0.0	2	2	0
fam14289	2	2	2	2.0	0.0	0.0	2	2	0
fam14290	2	2	2	2.0	0.0	0.0	2	2	0
fam14291	2	2	2	2.0	0.0	0.0	2	2	0
fam14292	2	2	2	2.0	0.0	0.0	2	2	0
fam14293	2	2	2	2.0	0.0	0.0	2	2	0
fam14294	2	2	2	2.0	0.0	0.0	2	2	0
fam14295	2	2	2	2.0	0.0	0.0	2	2	0
fam14296	2	2	2	2.0	0.0	0.0	2	2	0
fam14297	2	2	2	2.0	0.0	0.0	2	2	0
fam14298	2	2	2	2.0	0.0	0.0	2	2	0
fam14299	2	2	2	2.0	0.0	0.0	2	2	0
fam14300	2	2	2	2.0	0.0	0.0	2	2	0
fam14301	2	2	2	2.0	0.0	0.0	2	2	0
fam14302	2	2	2	2.0	0.0	0.0	2	2	0
fam14303	2	2	2	2.0	0.0	0.0	2	2	0
fam14304	2	2	2	2.0	0.0	0.0	2	2	0
fam14305	2	2	2	2.0	0.0	0.0	2	2	0
fam14306	2	2	2	2.0	0.0	0.0	2	2	0
fam14307	2	2	2	2.0	0.0	0.0	2	2	0
fam14308	2	2	2	2.0	0.0	0.0	2	2	0
fam14309	2	2	2	2.0	0.0	0.0	2	2	0
fam14310	2	2	2	2.0	0.0	0.0	2	2	0
fam14311	2	2	2	2.0	0.0	0.0	2	2	0
fam14312	2	2	2	2.0	0.0	0.0	2	2	0
fam14313	2	2	2	2.0	0.0	0.0	2	2	0
fam14314	2	2	2	2.0	0.0	0.0	2	2	0
fam14315	2	2	2	2.0	0.0	0.0	2	2	0
fam14316	2	2	2	2.0	0.0	0.0	2	2	0
fam14317	2	2	2	2.0	0.0	0.0	2	2	0
fam14318	2	2	2	2.0	0.0	0.0	2	2	0
fam14319	2	2	2	2.0	0.0	0.0	2	2	0
fam14320	2	2	2	2.0	0.0	0.0	2	2	0
fam14321	2	2	2	2.0	0.0	0.0	2	2	0
fam14322	2	2	2	2.0	0.0	0.0	2	2	0
fam14323	2	2	2	2.0	0.0	0.0	2	2	0
fam14324	2	2	2	2.0	0.0	0.0	2	2	0
fam14325	2	2	2	2.0	0.0	0.0	2	2	0
fam14326	2	2	2	2.0	0.0	0.0	2	2	0
fam14327	2	2	2	2.0	0.0	0.0	2	2	0
fam14328	2	2	2	2.0	0.0	0.0	2	2	0
fam14329	2	2	2	2.0	0.0	0.0	2	2	0
fam14330	2	2	2	2.0	0.0	0.0	2	2	0
fam14331	2	2	2	2.0	0.0	0.0	2	2	0
fam14332	2	2	2	2.0	0.0	0.0	2	2	0
fam14333	2	2	2	2.0	0.0	0.0	2	2	0
fam14334	2	2	2	2.0	0.0	0.0	2	2	0
fam14335	2	2	2	2.0	0.0	0.0	2	2	0
fam14336	2	2	2	2.0	0.0	0.0	2	2	0
fam14337	2	2	2	2.0	0.0	0.0	2	2	0
fam14338	2	2	2	2.0	0.0	0.0	2	2	0
fam14339	2	2	2	2.0	0.0	0.0	2	2	0
fam14340	2	2	2	2.0	0.0	0.0	2	2	0
fam14341	2	2	2	2.0	0.0	0.0	2	2	0
fam14342	2	2	2	2.0	0.0	0.0	2	2	0
fam14343	2	2	2	2.0	0.0	0.0	2	2	0
fam14344	2	2	2	2.0	0.0	0.0	2	2	0
fam14345	2	2	2	2.0	0.0	0.0	2	2	0
fam14346	2	2	2	2.0	0.0	0.0	2	2	0
fam14347	2	2	2	2.0	0.0	0.0	2	2	0
fam14348	2	2	2	2.0	0.0	0.0	2	2	0
fam14349	2	2	2	2.0	0.0	0.0	2	2	0
fam14350	2	2	2	2.0	0.0	0.0	2	2	0
fam14351	2	2	2	2.0	0.0	0.0	2	2	0
fam14352	2	2	2	2.0	0.0	0.0	2	2	0
fam14353	2	2	2	2.0	0.0	0.0	2	2	0
fam14354	2	2	2	2.0	0.0	0.0	2	2	0
fam14355	2	2	2	2.0	0.0	0.0	2	2	0
fam14356	2	2	2	2.0	0.0	0.0	2	2	0
fam14357	2	2	2	2.0	0.0	0.0	2	2	0
fam14358	2	2	2	2.0	0.0	0.0	2	2	0
fam14359	2	2	2	2.0	0.0	0.0	2	2	0
fam14360	2	2	2	2.0	0.0	0.0	2	2	0
fam14361	2	2	2	2.0	0.0	0.0	2	2	0
fam14362	2	2	2	2.0	0.0	0.0	2	2	0
fam14363	2	2	2	2.0	0.0	0.0	2	2	0
fam14364	2	2	2	2.0	0.0	0.0	2	2	0
fam14365	2	2	2	2.0	0.0	0.0	2	2	0
fam14366	2	2	2	2.0	0.0	0.0	2	2	0
fam14367	2	2	2	2.0	0.0	0.0	2	2	0
fam14368	2	2	2	2.0	0.0	0.0	2	2	0
fam14369	2	2	2	2.0	0.0	0.0	2	2	0
fam14370	2	2	2	2.0	0.0	0.0	2	2	0
fam14371	2	2	2	2.0	0.0	0.0	2	2	0
fam14372	2	2	2	2.0	0.0	0.0	2	2	0
fam14373	2	2	2	2.0	0.0	0.0	2	2	0
fam14374	2	2	2	2.0	0.0	0.0	2	2	0
fam14375	2	2	2	2.0	0.0	0.0	2	2	0
fam14376	2	2	2	2.0	0.0	0.0	2	2	0
fam14377	2	2	2	2.0	0.0	0.0	2	2	0
fam14378	2	2	2	2.0	0.0	0.0	2	2	0
fam14379	2	2	2	2.0	0.0	0.0	2	2	0
fam14380	2	2	2	2.0	0.0	0.0	2	2	0
fam14381	2	2	2	2.0	0.0	0.0	2	2	0
fam14382	2	2	2	2.0	0.0	0.0	2	2	0
fam14383	2	2	2	2.0	0.0	0.0	2	2	0
fam14384	2	2	2	2.0	0.0	0.0	2	2	0
fam14385	2	2	2	2.0	0.0	0.0	2	2	0
fam14386	2	2	2	2.0	0.0	0.0	2	2	0
fam14387	2	2	2	2.0	0.0	0.0	2	2	0
fam14388	2	2	2	2.0	0.0	0.0	2	2	0
fam14389	2	2	2	2.0	0.0	0.0	2	2	0
fam14390	2	2	2	2.0	0.0	0.0	2	2	0
fam14391	2	2	2	2.0	0.0	0.0	2	2	0
fam14392	2	2	2	2.0	0.0	0.0	2	2	0
fam14393	2	2	2	2.0	0.0	0.0	2	2	0
fam14394	2	2	2	2.0	0.0	0.0	2	2	0
fam14395	2	2	2	2.0	0.0	0.0	2	2	0
fam14396	2	2	2	2.0	0.0	0.0	2	2	0
fam14397	2	2	2	2.0	0.0	0.0	2	2	0
fam14398	2	2	2	2.0	0.0	0.0	2	2	0
fam14399	2	2	2	2.0	0.0	0.0	2	2	0
fam14400	2	2	2	2.0	0.0	0.0	2	2	0
fam14401	2	2	2	2.0	0.0	0.0	2	2	0
fam14402	2	2	2	2.0	0.0	0.0	2	2	0
fam14403	2	2	2	2.0	0.0	0.0	2	2	0
fam14404	2	2	2	2.0	0.0	0.0	2	2	0
fam14405	2	2	2	2.0	0.0	0.0	2	2	0
fam14406	2	2	2	2.0	0.0	0.0	2	2	0
fam14407	2	2	2	2.0	0.0	0.0	2	2	0
fam14408	2	2	2	2.0	0.0	0.0	2	2	0
fam14409	2	2	2	2.0	0.0	0.0	2	2	0
fam14410	2	2	2	2.0	0.0	0.0	2	2	0
fam14411	2	2	2	2.0	0.0	0.0	2	2	0
fam14412	2	2	2	2.0	0.0	0.0	2	2	0
fam14413	2	2	2	2.0	0.0	0.0	2	2	0
fam14414	2	2	2	2.0	0.0	0.0	2	2	0
fam14415	2	2	2	2.0	0.0	0.0	2	2	0
fam14416	2	2	2	2.0	0.0	0.0	2	2	0
fam14417	2	2	2	2.0	0.0	0.0	2	2	0
fam14418	2	2	2	2.0	0.0	0.0	2	2	0
fam14419	2	2	2	2.0	0.0	0.0	2	2	0
fam14420	2	2	2	2.0	0.0	0.0	2	2	0
fam14421	2	2	2	2.0	0.0	0.0	2	2	0
fam14422	2	2	2	2.0	0.0	0.0	2	2	0
fam14423	2	2	2	2.0	0.0	0.0	2	2	0
fam14424	2	2	2	2.0	0.0	0.0	2	2	0
fam14425	2	2	2	2.0	0.0	0.0	2	2	0
fam14426	2	2	2	2.0	0.0	0.0	2	2	0
fam14427	2	2	2	2.0	0.0	0.0	2	2	0
fam14428	2	2	2	2.0	0.0	0.0	2	2	0
fam14429	2	2	2	2.0	0.0	0.0	2	2	0
fam14430	2	2	2	2.0	0.0	0.0	2	2	0
fam14431	2	2	2	2.0	0.0	0.0	2	2	0
fam14432	2	2	2	2.0	0.0	0.0	2	2	0
fam14433	2	2	2	2.0	0.0	0.0	2	2	0
fam14434	2	2	2	2.0	0.0	0.0	2	2	0
fam14435	2	2	2	2.0	0.0	0.0	2	2	0
fam14436	2	2	2	2.0	0.0	0.0	2	2	0
fam14437	2	2	2	2.0	0.0	0.0	2	2	0
fam14438	2	2	2	2.0	0.0	0.0	2	2	0
fam14439	2	2	2	2.0	0.0	0.0	2	2	0
fam14440	2	2	2	2.0	0.0	0.0	2	2	0
fam14441	2	2	2	2.0	0.0	0.0	2	2	0
fam14442	2	2	2	2.0	0.0	0.0	2	2	0
fam14443	2	2	2	2.0	0.0	0.0	2	2	0
fam14444	2	2	2	2.0	0.0	0.0	2	2	0
fam14445	2	2	2	2.0	0.0	0.0	2	2	0
fam14446	2	2	2	2.0	0.0	0.0	2	2	0
fam14447	2	2	2	2.0	0.0	0.0	2	2	0
fam14448	2	2	2	2.0	0.0	0.0	2	2	0
fam14449	2	2	2	2.0	0.0	0.0	2	2	0
fam14450	2	2	2	2.0	0.0	0.0	2	2	0
fam14451	2	2	2	2.0	0.0	0.0	2	2	0
fam14452	2	2	2	2.0	0.0	0.0	2	2	0
fam14453	2	2	2	2.0	0.0	0.0	2	2	0
fam14454	2	2	2	2.0	0.0	0.0	2	2	0
fam14455	2	2	2	2.0	0.0	0.0	2	2	0
fam14456	2	2	2	2.0	0.0	0.0	2	2	0
fam14457	2	2	2	2.0	0.0	0.0	2	2	0
fam14458	2	2	2	2.0	0.0	0.0	2	2	0
fam14459	2	2	2	2.0	0.0	0.0	2	2	0
fam14460	2	2	2	2.0	0.0	0.0	2	2	0
fam14461	2	2	2	2.0	0.0	0.0	2	2	0
fam14462	2	2	2	2.0	0.0	0.0	2	2	0
fam14463	2	2	2	2.0	0.0	0.0	2	2	0
fam14464	2	2	2	2.0	0.0	0.0	2	2	0
fam14465	2	2	2	2.0	0.0	0.0	2	2	0
fam14466	2	2	2	2.0	0.0	0.0	2	2	0
fam14467	2	2	2	2.0	0.0	0.0	2	2	0
fam14468	2	2	2	2.0	0.0	0.0	2	2	0
fam14469	2	2	2	2.0	0.0	0.0	2	2	0
fam14470	2	2	2	2.0	0.0	0.0	2	2	0
fam14471	2	2	2	2.0	0.0	0.0	2	2	0
fam14472	2	2	2	2.0	0.0	0.0	2	2	0
fam14473	2	2	2	2.0	0.0	0.0	2	2	0
fam14474	2	2	2	2.0	0.0	0.0	2	2	0
fam14475	2	2	2	2.0	0.0	0.0	2	2	0
fam14476	2	2	2	2.0	0.0	0.0	2	2	0
fam14477	2	2	2	2.0	0.0	0.0	2	2	0
fam14478	2	2	2	2.0	0.0	0.0	2	2	0
fam14479	2	2	2	2.0	0.0	0.0	2	2	0
fam14480	2	2	2	2.0	0.0	0.0	2	2	0
fam14481	2	2	2	2.0	0.0	0.0	2	2	0
fam14482	2	2	2	2.0	0.0	0.0	2	2	0
fam14483	2	2	2	2.0	0.0	0.0	2	2	0
fam14484	2	2	2	2.0	0.0	0.0	2	2	0
fam14485	2	2	2	2.0	0.0	0.0	2	2	0
fam14486	2	2	2	2.0	0.0	0.0	2	2	0
fam14487	2	2	2	2.0	0.0	0.0	2	2	0
fam14488	2	2	2	2.0	0.0	0.0	2	2	0
fam14489	2	2	2	2.0	0.0	0.0	2	2	0
fam14490	2	2	2	2.0	0.0	0.0	2	2	0
fam14491	2	2	2	2.0	0.0	0.0	2	2	0
fam14492	2	2	2	2.0	0.0	0.0	2	2	0
fam14493	2	2	2	2.0	0.0	0.0	2	2	0
fam14494	2	2	2	2.0	0.0	0.0	2	2	0
fam14495	2	2	2	2.0	0.0	0.0	2	2	0
fam14496	2	2	2	2.0	0.0	0.0	2	2	0
fam14497	2	2	2	2.0	0.0	0.0	2	2	0
fam14498	2	2	2	2.0	0.0	0.0	2	2	0
fam14499	2	2	2	2.0	0.0	0.0	2	2	0
fam14500	2	2	2	2.0	0.0	0.0	2	2	0
fam14501	2	2	2	2.0	0.0	0.0	2	2	0
fam14502	2	2	2	2.0	0.0	0.0	2	2	0
fam14503	2	2	2	2.0	0.0	0.0	2	2	0
fam14504	2	2	2	2.0	0.0	0.0	2	2	0
fam14505	2	2	2	2.0	0.0	0.0	2	2	0
fam14506	2	2	2	2.0	0.0	0.0	2	2	0
fam14507	2	2	2	2.0	0.0	0.0	2	2	0
fam14508	2	2	2	2.0	0.0	0.0	2	2	0
fam14509	2	2	2	2.0	0.0	0.0	2	2	0
fam14510	2	2	2	2.0	0.0	0.0	2	2	0
fam14511	2	2	2	2.0	0.0	0.0	2	2	0
fam14512	2	2	2	2.0	0.0	0.0	2	2	0
fam14513	2	2	2	2.0	0.0	0.0	2	2	0
fam14514	2	2	2	2.0	0.0	0.0	2	2	0
fam14515	2	2	2	2.0	0.0	0.0	2	2	0
fam14516	2	2	2	2.0	0.0	0.0	2	2	0
fam14517	2	2	2	2.0	0.0	0.0	2	2	0
fam14518	2	2	2	2.0	0.0	0.0	2	2	0
fam14519	2	2	2	2.0	0.0	0.0	2	2	0
fam14520	2	2	2	2.0	0.0	0.0	2	2	0
fam14521	2	2	2	2.0	0.0	0.0	2	2	0
fam14522	2	2	2	2.0	0.0	0.0	2	2	0
fam14523	2	2	2	2.0	0.0	0.0	2	2	0
fam14524	2	2	2	2.0	0.0	0.0	2	2	0
fam14525	2	2	2	2.0	0.0	0.0	2	2	0
fam14526	2	2	2	2.0	0.0	0.0	2	2	0
fam14527	2	2	2	2.0	0.0	0.0	2	2	0
fam14528	2	2	2	2.0	0.0	0.0	2	2	0
fam14529	2	2	2	2.0	0.0	0.0	2	2	0
fam14530	2	2	2	2.0	0.0	0.0	2	2	0
fam14531	2	2	2	2.0	0.0	0.0	2	2	0
fam14532	2	2	2	2.0	0.0	0.0	2	2	0
fam14533	2	2	2	2.0	0.0	0.0	2	2	0
fam14534	2	2	2	2.0	0.0	0.0	2	2	0
fam14535	2	2	2	2.0	0.0	0.0	2	2	0
fam14536	2	2	2	2.0	0.0	0.0	2	2	0
fam14537	2	2	2	2.0	0.0	0.0	2	2	0
fam14538	2	2	2	2.0	0.0	0.0	2	2	0
fam14539	2	2	2	2.0	0.0	0.0	2	2	0
fam14540	2	2	2	2.0	0.0	0.0	2	2	0
fam14541	2	2	2	2.0	0.0	0.0	2	2	0
fam14542	2	2	2	2.0	0.0	0.0	2	2	0
fam14543	2	2	2	2.0	0.0	0.0	2	2	0
fam14544	2	2	2	2.0	0.0	0.0	2	2	0
fam14545	2	2	2	2.0	0.0	0.0	2	2	0
fam14546	2	2	2	2.0	0.0	0.0	2	2	0
fam14547	2	2	2	2.0	0.0	0.0	2	2	0
fam14548	2	2	2	2.0	0.0	0.0	2	2	0
fam14549	2	2	2	2.0	0.0	0.0	2	2	0
fam14550	2	2	2	2.0	0.0	0.0	2	2	0
fam14551	2	2	2	2.0	0.0	0.0	2	2	0
fam14552	2	2	2	2.0	0.0	0.0	2	2	0
fam14553	2	2	2	2.0	0.0	0.0	2	2	0
fam14554	2	2	2	2.0	0.0	0.0	2	2	0
fam14555	2	2	2	2.0	0.0	0.0	2	2	0
fam14556	2	2	2	2.0	0.0	0.0	2	2	0
fam14557	2	2	2	2.0	0.0	0.0	2	2	0
fam14558	2	2	2	2.0	0.0	0.0	2	2	0
fam14559	2	2	2	2.0	0.0	0.0	2	2	0
fam14560	2	2	2	2.0	0.0	0.0	2	2	0
fam14561	2	2	2	2.0	0.0	0.0	2	2	0
fam14562	2	2	2	2.0	0.0	0.0	2	2	0
fam14563	2	2	2	2.0	0.0	0.0	2	2	0
fam14564	2	2	2	2.0	0.0	0.0	2	2	0
fam14565	2	2	2	2.0	0.0	0.0	2	2	0
fam14566	2	2	2	2.0	0.0	0.0	2	2	0
fam14567	2	2	2	2.0	0.0	0.0	2	2	0
fam14568	2	2	2	2.0	0.0	0.0	2	2	0
fam14569	2	2	2	2.0	0.0	0.0	2	2	0
fam14570	2	2	2	2.0	0.0	0.0	2	2	0
fam14571	2	2	2	2.0	0.0	0.0	2	2	0
fam14572	2	2	2	2.0	0.0	0.0	2	2	0
fam14573	2	2	2	2.0	0.0	0.0	2	2	0
fam14574	2	2	2	2.0	0.0	0.0	2	2	0
fam14575	2	2	2	2.0	0.0	0.0	2	2	0
fam14576	2	2	2	2.0	0.0	0.0	2	2	0
fam14577	2	2	2	2.0	0.0	0.0	2	2	0
fam14578	2	2	2	2.0	0.0	0.0	2	2	0
fam14579	2	2	2	2.0	0.0	0.0	2	2	0
fam14580	2	2	2	2.0	0.0	0.0	2	2	0
fam14581	2	2	2	2.0	0.0	0.0	2	2	0
fam14582	2	2	2	2.0	0.0	0.0	2	2	0
fam14583	2	2	2	2.0	0.0	0.0	2	2	0
fam14584	2	2	2	2.0	0.0	0.0	2	2	0
fam14585	2	2	2	2.0	0.0	0.0	2	2	0
fam14586	2	2	2	2.0	0.0	0.0	2	2	0
fam14587	2	2	2	2.0	0.0	0.0	2	2	0
fam14588	2	2	2	2.0	0.0	0.0	2	2	0
fam14589	2	2	2	2.0	0.0	0.0	2	2	0
fam14590	2	2	2	2.0	0.0	0.0	2	2	0
fam14591	2	2	2	2.0	0.0	0.0	2	2	0
fam14592	2	2	2	2.0	0.0	0.0	2	2	0
fam14593	2	2	2	2.0	0.0	0.0	2	2	0
fam14594	2	2	2	2.0	0.0	0.0	2	2	0
fam14595	2	2	2	2.0	0.0	0.0	2	2	0
fam14596	2	2	2	2.0	0.0	0.0	2	2	0
fam14597	2	2	2	2.0	0.0	0.0	2	2	0
fam14598	2	2	2	2.0	0.0	0.0	2	2	0
fam14599	2	2	2	2.0	0.0	0.0	2	2	0
fam14600	2	2	2	2.0	0.0	0.0	2	2	0
fam14601	2	2	2	2.0	0.0	0.0	2	2	0
fam14602	2	2	2	2.0	0.0	0.0	2	2	0
fam14603	2	2	2	2.0	0.0	0.0	2	2	0
fam14604	2	2	2	2.0	0.0	0.0	2	2	0
fam14605	2	2	2	2.0	0.0	0.0	2	2	0
fam14606	2	2	2	2.0	0.0	0.0	2	2	0
fam14607	2	2	2	2.0	0.0	0.0	2	2	0
fam14608	2	2	2	2.0	0.0	0.0	2	2	0
fam14609	2	2	2	2.0	0.0	0.0	2	2	0
fam14610	2	2	2	2.0	0.0	0.0	2	2	0
fam14611	2	2	2	2.0	0.0	0.0	2	2	0
fam14612	2	2	2	2.0	0.0	0.0	2	2	0
fam14613	2	2	2	2.0	0.0	0.0	2	2	0
fam14614	2	2	2	2.0	0.0	0.0	2	2	0
fam14615	2	2	2	2.0	0.0	0.0	2	2	0
fam14616	2	2	2	2.0	0.0	0.0	2	2	0
fam14617	2	2	2	2.0	0.0	0.0	2	2	0
fam14618	2	2	2	2.0	0.0	0.0	2	2	0
fam14619	2	2	2	2.0	0.0	0.0	2	2	0
fam14620	2	2	2	2.0	0.0	0.0	2	2	0
fam14621	2	2	2	2.0	0.0	0.0	2	2	0
fam14622	2	2	2	2.0	0.0	0.0	2	2	0
fam14623	2	2	2	2.0	0.0	0.0	2	2	0
fam14624	2	2	2	2.0	0.0	0.0	2	2	0
fam14625	2	2	2	2.0	0.0	0.0	2	2	0
fam14626	2	2	2	2.0	0.0	0.0	2	2	0
fam14627	2	2	2	2.0	0.0	0.0	2	2	0
fam14628	2	2	2	2.0	0.0	0.0	2	2	0
fam14629	2	2	2	2.0	0.0	0.0	2	2	0
fam14630	2	2	2	2.0	0.0	0.0	2	2	0
fam14631	2	2	2	2.0	0.0	0.0	2	2	0
fam14632	2	2	2	2.0	0.0	0.0	2	2	0
fam14633	2	2	2	2.0	0.0	0.0	2	2	0
fam14634	2	2	2	2.0	0.0	0.0	2	2	0
fam14635	2	2	2	2.0	0.0	0.0	2	2	0
fam14636	2	2	2	2.0	0.0	0.0	2	2	0
fam14637	2	2	2	2.0	0.0	0.0	2	2	0
fam14638	2	2	2	2.0	0.0	0.0	2	2	0
fam14639	2	2	2	2.0	0.0	0.0	2	2	0
fam14640	2	2	2	2.0	0.0	0.0	2	2	0
fam14641	2	2	2	2.0	0.0	0.0	2	2	0
fam14642	2	2	2	2.0	0.0	0.0	2	2	0
fam14643	2	2	2	2.0	0.0	0.0	2	2	0
fam14644	2	2	2	2.0	0.0	0.0	2	2	0
fam14645	2	2	2	2.0	0.0	0.0	2	2	0
fam14646	2	2	2	2.0	0.0	0.0	2	2	0
fam14647	2	2	2	2.0	0.0	0.0	2	2	0
fam14648	2	2	2	2.0	0.0	0.0	2	2	0
fam14649	2	2	2	2.0	0.0	0.0	2	2	0
fam14650	2	2	2	2.0	0.0	0.0	2	2	0
fam14651	2	2	2	2.0	0.0	0.0	2	2	0
fam14652	2	2	2	2.0	0.0	0.0	2	2	0
fam14653	2	2	2	2.0	0.0	0.0	2	2	0
fam14654	2	2	2	2.0	0.0	0.0	2	2	0
fam14655	2	2	2	2.0	0.0	0.0	2	2	0
fam14656	2	2	2	2.0	0.0	0.0	2	2	0
fam14657	2	2	2	2.0	0.0	0.0	2	2	0
fam14658	2	2	2	2.0	0.0	0.0	2	2	0
fam14659	2	2	2	2.0	0.0	0.0	2	2	0
fam14660	2	2	2	2.0	0.0	0.0	2	2	0
fam14661	2	2	2	2.0	0.0	0.0	2	2	0
fam14662	2	2	2	2.0	0.0	0.0	2	2	0
fam14663	2	2	2	2.0	0.0	0.0	2	2	0
fam14664	2	2	2	2.0	0.0	0.0	2	2	0
fam14665	2	2	2	2.0	0.0	0.0	2	2	0
fam14666	2	2	2	2.0	0.0	0.0	2	2	0
fam14667	2	2	2	2.0	0.0	0.0	2	2	0
fam14668	2	2	2	2.0	0.0	0.0	2	2	0
fam14669	2	2	2	2.0	0.0	0.0	2	2	0
fam14670	2	2	2	2.0	0.0	0.0	2	2	0
fam14671	2	2	2	2.0	0.0	0.0	2	2	0
fam14672	2	2	2	2.0	0.0	0.0	2	2	0
fam14673	2	2	2	2.0	0.0	0.0	2	2	0
fam14674	2	2	2	2.0	0.0	0.0	2	2	0
fam14675	2	2	2	2.0	0.0	0.0	2	2	0
fam14676	2	2	2	2.0	0.0	0.0	2	2	0
fam14677	2	2	2	2.0	0.0	0.0	2	2	0
fam14678	2	2	2	2.0	0.0	0.0	2	2	0
fam14679	2	2	2	2.0	0.0	0.0	2	2	0
fam14680	2	2	2	2.0	0.0	0.0	2	2	0
fam14681	2	2	2	2.0	0.0	0.0	2	2	0
fam14682	2	2	2	2.0	0.0	0.0	2	2	0
fam14683	2	2	2	2.0	0.0	0.0	2	2	0
fam14684	2	2	2	2.0	0.0	0.0	2	2	0
fam14685	2	2	2	2.0	0.0	0.0	2	2	0
fam14686	2	2	2	2.0	0.0	0.0	2	2	0
fam14687	2	2	2	2.0	0.0	0.0	2	2	0
fam14688	2	2	2	2.0	0.0	0.0	2	2	0
fam14689	2	2	2	2.0	0.0	0.0	2	2	0
fam14690	2	2	2	2.0	0.0	0.0	2	2	0
fam14691	2	2	2	2.0	0.0	0.0	2	2	0
fam14692	2	2	2	2.0	0.0	0.0	2	2	0
fam14693	2	2	2	2.0	0.0	0.0	2	2	0
fam14694	2	2	2	2.0	0.0	0.0	2	2	0
fam14695	2	2	2	2.0	0.0	0.0	2	2	0
fam14696	2	2	2	2.0	0.0	0.0	2	2	0
fam14697	2	2	2	2.0	0.0	0.0	2	2	0
fam14698	2	2	2	2.0	0.0	0.0	2	2	0
fam14699	2	2	2	2.0	0.0	0.0	2	2	0
fam14700	2	2	2	2.0	0.0	0.0	2	2	0
fam14701	2	2	2	2.0	0.0	0.0	2	2	0
fam14702	2	2	2	2.0	0.0	0.0	2	2	0
fam14703	2	2	2	2.0	0.0	0.0	2	2	0
fam14704	2	2	2	2.0	0.0	0.0	2	2	0
fam14705	2	2	2	2.0	0.0	0.0	2	2	0
fam14706	2	2	2	2.0	0.0	0.0	2	2	0
fam14707	2	2	2	2.0	0.0	0.0	2	2	0
fam14708	2	2	2	2.0	0.0	0.0	2	2	0
fam14709	2	2	2	2.0	0.0	0.0	2	2	0
fam14710	2	2	2	2.0	0.0	0.0	2	2	0
fam14711	2	2	2	2.0	0.0	0.0	2	2	0
fam14712	2	2	2	2.0	0.0	0.0	2	2	0
fam14713	2	2	2	2.0	0.0	0.0	2	2	0
fam14714	2	2	2	2.0	0.0	0.0	2	2	0
fam14715	2	2	2	2.0	0.0	0.0	2	2	0
fam14716	2	2	2	2.0	0.0	0.0	2	2	0
fam14717	2	2	2	2.0	0.0	0.0	2	2	0
fam14718	2	2	2	2.0	0.0	0.0	2	2	0
fam14719	2	2	2	2.0	0.0	0.0	2	2	0
fam14720	2	2	2	2.0	0.0	0.0	2	2	0
fam14721	2	2	2	2.0	0.0	0.0	2	2	0
fam14722	2	2	2	2.0	0.0	0.0	2	2	0
fam14723	2	2	2	2.0	0.0	0.0	2	2	0
fam14724	2	2	2	2.0	0.0	0.0	2	2	0
fam14725	2	2	2	2.0	0.0	0.0	2	2	0
fam14726	2	2	2	2.0	0.0	0.0	2	2	0
fam14727	2	2	2	2.0	0.0	0.0	2	2	0
fam14728	2	2	2	2.0	0.0	0.0	2	2	0
fam14729	2	2	2	2.0	0.0	0.0	2	2	0
fam14730	2	2	2	2.0	0.0	0.0	2	2	0
fam14731	2	2	2	2.0	0.0	0.0	2	2	0
fam14732	2	2	2	2.0	0.0	0.0	2	2	0
fam14733	2	2	2	2.0	0.0	0.0	2	2	0
fam14734	2	2	2	2.0	0.0	0.0	2	2	0
fam14735	2	2	2	2.0	0.0	0.0	2	2	0
fam14736	2	2	2	2.0	0.0	0.0	2	2	0
fam14737	2	2	2	2.0	0.0	0.0	2	2	0
fam14738	2	2	2	2.0	0.0	0.0	2	2	0
fam14739	2	2	2	2.0	0.0	0.0	2	2	0
fam14740	2	2	2	2.0	0.0	0.0	2	2	0
fam14741	2	2	2	2.0	0.0	0.0	2	2	0
fam14742	2	2	2	2.0	0.0	0.0	2	2	0
fam14743	2	2	2	2.0	0.0	0.0	2	2	0
fam14744	2	2	2	2.0	0.0	0.0	2	2	0
fam14745	2	2	2	2.0	0.0	0.0	2	2	0
fam14746	2	2	2	2.0	0.0	0.0	2	2	0
fam14747	2	2	2	2.0	0.0	0.0	2	2	0
fam14748	2	2	2	2.0	0.0	0.0	2	2	0
fam14749	2	2	2	2.0	0.0	0.0	2	2	0
fam14750	2	2	2	2.0	0.0	0.0	2	2	0
fam14751	2	2	2	2.0	0.0	0.0	2	2	0
fam14752	2	2	2	2.0	0.0	0.0	2	2	0
fam14753	2	2	2	2.0	0.0	0.0	2	2	0
fam14754	2	2	2	2.0	0.0	0.0	2	2	0
fam14755	2	2	2	2.0	0.0	0.0	2	2	0
fam14756	2	2	2	2.0	0.0	0.0	2	2	0
fam14757	2	2	2	2.0	0.0	0.0	2	2	0
fam14758	2	2	2	2.0	0.0	0.0	2	2	0
fam14759	2	2	2	2.0	0.0	0.0	2	2	0
fam14760	2	2	2	2.0	0.0	0.0	2	2	0
fam14761	2	2	2	2.0	0.0	0.0	2	2	0
fam14762	2	2	2	2.0	0.0	0.0	2	2	0
fam14763	2	2	2	2.0	0.0	0.0	2	2	0
fam14764	2	2	2	2.0	0.0	0.0	2	2	0
fam14765	2	2	2	2.0	0.0	0.0	2	2	0
fam14766	2	2	2	2.0	0.0	0.0	2	2	0
fam14767	2	2	2	2.0	0.0	0.0	2	2	0
fam14768	2	2	2	2.0	0.0	0.0	2	2	0
fam14769	2	2	2	2.0	0.0	0.0	2	2	0
fam14770	2	2	2	2.0	0.0	0.0	2	2	0
fam14771	2	2	2	2.0	0.0	0.0	2	2	0
fam14772	2	2	2	2.0	0.0	0.0	2	2	0
fam14773	2	2	2	2.0	0.0	0.0	2	2	0
fam14774	2	2	2	2.0	0.0	0.0	2	2	0
fam14775	2	2	2	2.0	0.0	0.0	2	2	0
fam14776	2	2	2	2.0	0.0	0.0	2	2	0
fam14777	2	2	2	2.0	0.0	0.0	2	2	0
fam14778	2	2	2	2.0	0.0	0.0	2	2	0
fam14779	2	2	2	2.0	0.0	0.0	2	2	0
fam14780	2	2	2	2.0	0.0	0.0	2	2	0
fam14781	2	2	2	2.0	0.0	0.0	2	2	0
fam14782	2	2	2	2.0	0.0	0.0	2	2	0
fam14783	2	2	2	2.0	0.0	0.0	2	2	0
fam14784	2	2	2	2.0	0.0	0.0	2	2	0
fam14785	2	2	2	2.0	0.0	0.0	2	2	0
fam14786	2	2	2	2.0	0.0	0.0	2	2	0
fam14787	2	2	2	2.0	0.0	0.0	2	2	0
fam14788	2	2	2	2.0	0.0	0.0	2	2	0
fam14789	2	2	2	2.0	0.0	0.0	2	2	0
fam14790	2	2	2	2.0	0.0	0.0	2	2	0
fam14791	2	2	2	2.0	0.0	0.0	2	2	0
fam14792	2	2	2	2.0	0.0	0.0	2	2	0
fam14793	2	2	2	2.0	0.0	0.0	2	2	0
fam14794	2	2	2	2.0	0.0	0.0	2	2	0
fam14795	2	2	2	2.0	0.0	0.0	2	2	0
fam14796	2	2	2	2.0	0.0	0.0	2	2	0
fam14797	2	2	2	2.0	0.0	0.0	2	2	0
fam14798	2	2	2	2.0	0.0	0.0	2	2	0
fam14799	2	2	2	2.0	0.0	0.0	2	2	0
fam14800	2	2	2	2.0	0.0	0.0	2	2	0
fam14801	2	2	2	2.0	0.0	0.0	2	2	0
fam14802	2	2	2	2.0	0.0	0.0	2	2	0
fam14803	2	2	2	2.0	0.0	0.0	2	2	0
fam14804	2	2	2	2.0	0.0	0.0	2	2	0
fam14805	2	2	2	2.0	0.0	0.0	2	2	0
fam14806	2	2	2	2.0	0.0	0.0	2	2	0
fam14807	2	2	2	2.0	0.0	0.0	2	2	0
fam14808	2	2	2	2.0	0.0	0.0	2	2	0
fam14809	2	2	2	2.0	0.0	0.0	2	2	0
fam14810	2	2	2	2.0	0.0	0.0	2	2	0
fam14811	2	2	2	2.0	0.0	0.0	2	2	0
fam14812	2	2	2	2.0	0.0	0.0	2	2	0
fam14813	2	2	2	2.0	0.0	0.0	2	2	0
fam14814	2	2	2	2.0	0.0	0.0	2	2	0
fam14815	2	2	2	2.0	0.0	0.0	2	2	0
fam14816	2	2	2	2.0	0.0	0.0	2	2	0
fam14817	2	2	2	2.0	0.0	0.0	2	2	0
fam14818	2	2	2	2.0	0.0	0.0	2	2	0
fam14819	2	2	2	2.0	0.0	0.0	2	2	0
fam14820	2	2	2	2.0	0.0	0.0	2	2	0
fam14821	2	2	2	2.0	0.0	0.0	2	2	0
fam14822	2	2	2	2.0	0.0	0.0	2	2	0
fam14823	2	2	2	2.0	0.0	0.0	2	2	0
fam14824	2	2	2	2.0	0.0	0.0	2	2	0
fam14825	2	2	2	2.0	0.0	0.0	2	2	0
fam14826	2	2	2	2.0	0.0	0.0	2	2	0
fam14827	2	2	2	2.0	0.0	0.0	2	2	0
fam14828	2	2	2	2.0	0.0	0.0	2	2	0
fam14829	2	2	2	2.0	0.0	0.0	2	2	0
fam14830	2	2	2	2.0	0.0	0.0	2	2	0
fam14831	2	2	2	2.0	0.0	0.0	2	2	0
fam14832	2	2	2	2.0	0.0	0.0	2	2	0
fam14833	2	2	2	2.0	0.0	0.0	2	2	0
fam14834	2	2	2	2.0	0.0	0.0	2	2	0
fam14835	2	2	2	2.0	0.0	0.0	2	2	0
fam14836	2	2	2	2.0	0.0	0.0	2	2	0
fam14837	2	2	2	2.0	0.0	0.0	2	2	0
fam14838	2	2	2	2.0	0.0	0.0	2	2	0
fam14839	2	2	2	2.0	0.0	0.0	2	2	0
fam14840	2	2	2	2.0	0.0	0.0	2	2	0
fam14841	2	2	2	2.0	0.0	0.0	2	2	0
fam14842	2	2	2	2.0	0.0	0.0	2	2	0
fam14843	2	2	2	2.0	0.0	0.0	2	2	0
fam14844	2	2	2	2.0	0.0	0.0	2	2	0
fam14845	2	2	2	2.0	0.0	0.0	2	2	0
fam14846	2	2	2	2.0	0.0	0.0	2	2	0
fam14847	2	2	2	2.0	0.0	0.0	2	2	0
fam14848	2	2	2	2.0	0.0	0.0	2	2	0
fam14849	2	2	2	2.0	0.0	0.0	2	2	0
fam14850	2	2	2	2.0	0.0	0.0	2	2	0
fam14851	2	2	2	2.0	0.0	0.0	2	2	0
fam14852	2	2	2	2.0	0.0	0.0	2	2	0
fam14853	2	2	2	2.0	0.0	0.0	2	2	0
fam14854	2	2	2	2.0	0.0	0.0	2	2	0
fam14855	2	2	2	2.0	0.0	0.0	2	2	0
fam14856	2	2	2	2.0	0.0	0.0	2	2	0
fam14857	2	2	2	2.0	0.0	0.0	2	2	0
fam14858	2	2	2	2.0	0.0	0.0	2	2	0
fam14859	2	2	2	2.0	0.0	0.0	2	2	0
fam14860	2	2	2	2.0	0.0	0.0	2	2	0
fam14861	2	2	2	2.0	0.0	0.0	2	2	0
fam14862	2	2	2	2.0	0.0	0.0	2	2	0
fam14863	2	2	2	2.0	0.0	0.0	2	2	0
fam14864	2	2	2	2.0	0.0	0.0	2	2	0
fam14865	2	2	2	2.0	0.0	0.0	2	2	0
fam14866	2	2	2	2.0	0.0	0.0	2	2	0
fam14867	2	2	2	2.0	0.0	0.0	2	2	0
fam14868	2	2	2	2.0	0.0	0.0	2	2	0
fam14869	2	2	2	2.0	0.0	0.0	2	2	0
fam14870	2	2	2	2.0	0.0	0.0	2	2	0
fam14871	2	2	2	2.0	0.0	0.0	2	2	0
fam14872	2	2	2	2.0	0.0	0.0	2	2	0
fam14873	2	2	2	2.0	0.0	0.0	2	2	0
fam14874	2	2	2	2.0	0.0	0.0	2	2	0
fam14875	2	2	2	2.0	0.0	0.0	2	2	0
fam14876	2	2	2	2.0	0.0	0.0	2	2	0
fam14877	2	2	2	2.0	0.0	0.0	2	2	0
fam14878	2	2	2	2.0	0.0	0.0	2	2	0
fam14879	2	2	2	2.0	0.0	0.0	2	2	0
fam14880	2	2	2	2.0	0.0	0.0	2	2	0
fam14881	2	2	2	2.0	0.0	0.0	2	2	0
fam14882	2	2	2	2.0	0.0	0.0	2	2	0
fam14883	2	2	2	2.0	0.0	0.0	2	2	0
fam14884	2	2	2	2.0	0.0	0.0	2	2	0
fam14885	2	2	2	2.0	0.0	0.0	2	2	0
fam14886	2	2	2	2.0	0.0	0.0	2	2	0
fam14887	2	2	2	2.0	0.0	0.0	2	2	0
fam14888	2	2	2	2.0	0.0	0.0	2	2	0
fam14889	2	2	2	2.0	0.0	0.0	2	2	0
fam14890	2	2	2	2.0	0.0	0.0	2	2	0
fam14891	2	2	2	2.0	0.0	0.0	2	2	0
fam14892	2	2	2	2.0	0.0	0.0	2	2	0
fam14893	2	2	2	2.0	0.0	0.0	2	2	0
fam14894	2	2	2	2.0	0.0	0.0	2	2	0
fam14895	2	2	2	2.0	0.0	0.0	2	2	0
fam14896	2	2	2	2.0	0.0	0.0	2	2	0
fam14897	2	2	2	2.0	0.0	0.0	2	2	0
fam14898	2	2	2	2.0	0.0	0.0	2	2	0
fam14899	2	2	2	2.0	0.0	0.0	2	2	0
fam14900	2	2	2	2.0	0.0	0.0	2	2	0
fam14901	2	2	2	2.0	0.0	0.0	2	2	0
fam14902	2	2	2	2.0	0.0	0.0	2	2	0
fam14903	2	2	2	2.0	0.0	0.0	2	2	0
fam14904	2	2	2	2.0	0.0	0.0	2	2	0
fam14905	2	2	2	2.0	0.0	0.0	2	2	0
fam14906	2	2	2	2.0	0.0	0.0	2	2	0
fam14907	2	2	2	2.0	0.0	0.0	2	2	0
fam14908	2	2	2	2.0	0.0	0.0	2	2	0
fam14909	2	2	2	2.0	0.0	0.0	2	2	0
fam14910	2	2	2	2.0	0.0	0.0	2	2	0
fam14911	2	2	2	2.0	0.0	0.0	2	2	0
fam14912	2	2	2	2.0	0.0	0.0	2	2	0
fam14913	2	2	2	2.0	0.0	0.0	2	2	0
fam14914	2	2	2	2.0	0.0	0.0	2	2	0
fam14915	2	2	2	2.0	0.0	0.0	2	2	0
fam14916	2	2	2	2.0	0.0	0.0	2	2	0
fam14917	2	2	2	2.0	0.0	0.0	2	2	0
fam14918	2	2	2	2.0	0.0	0.0	2	2	0
fam14919	2	2	2	2.0	0.0	0.0	2	2	0
fam14920	2	2	2	2.0	0.0	0.0	2	2	0
fam14921	2	2	2	2.0	0.0	0.0	2	2	0
fam14922	2	2	2	2.0	0.0	0.0	2	2	0
fam14923	2	2	2	2.0	0.0	0.0	2	2	0
fam14924	2	2	2	2.0	0.0	0.0	2	2	0
fam14925	2	2	2	2.0	0.0	0.0	2	2	0
fam14926	2	2	2	2.0	0.0	0.0	2	2	0
fam14927	2	2	2	2.0	0.0	0.0	2	2	0
fam14928	2	2	2	2.0	0.0	0.0	2	2	0
fam14929	2	2	2	2.0	0.0	0.0	2	2	0
fam14930	2	2	2	2.0	0.0	0.0	2	2	0
fam14931	2	2	2	2.0	0.0	0.0	2	2	0
fam14932	2	2	2	2.0	0.0	0.0	2	2	0
fam14933	2	2	2	2.0	0.0	0.0	2	2	0
fam14934	2	2	2	2.0	0.0	0.0	2	2	0
fam14935	2	2	2	2.0	0.0	0.0	2	2	0
fam14936	2	2	2	2.0	0.0	0.0	2	2	0
fam14937	2	2	2	2.0	0.0	0.0	2	2	0
fam14938	2	2	2	2.0	0.0	0.0	2	2	0
fam14939	2	2	2	2.0	0.0	0.0	2	2	0
fam14940	2	2	2	2.0	0.0	0.0	2	2	0
fam14941	2	2	2	2.0	0.0	0.0	2	2	0
fam14942	2	2	2	2.0	0.0	0.0	2	2	0
fam14943	2	2	2	2.0	0.0	0.0	2	2	0
fam14944	2	2	2	2.0	0.0	0.0	2	2	0
fam14945	2	2	2	2.0	0.0	0.0	2	2	0
fam14946	2	2	2	2.0	0.0	0.0	2	2	0
fam14947	2	2	2	2.0	0.0	0.0	2	2	0
fam14948	2	2	2	2.0	0.0	0.0	2	2	0
fam14949	2	2	2	2.0	0.0	0.0	2	2	0
fam14950	2	2	2	2.0	0.0	0.0	2	2	0
fam14951	2	2	2	2.0	0.0	0.0	2	2	0
fam14952	2	2	2	2.0	0.0	0.0	2	2	0
fam14953	2	2	2	2.0	0.0	0.0	2	2	0
fam14954	2	2	2	2.0	0.0	0.0	2	2	0
fam14955	2	2	2	2.0	0.0	0.0	2	2	0
fam14956	2	2	2	2.0	0.0	0.0	2	2	0
fam14957	2	2	2	2.0	0.0	0.0	2	2	0
fam14958	2	2	2	2.0	0.0	0.0	2	2	0
fam14959	2	2	2	2.0	0.0	0.0	2	2	0
fam14960	2	2	2	2.0	0.0	0.0	2	2	0
fam14961	2	2	2	2.0	0.0	0.0	2	2	0
fam14962	2	2	2	2.0	0.0	0.0	2	2	0
fam14963	2	2	2	2.0	0.0	0.0	2	2	0
fam14964	2	2	2	2.0	0.0	0.0	2	2	0
fam14965	2	2	2	2.0	0.0	0.0	2	2	0
fam14966	2	2	2	2.0	0.0	0.0	2	2	0
fam14967	2	2	2	2.0	0.0	0.0	2	2	0
fam14968	2	2	2	2.0	0.0	0.0	2	2	0
fam14969	2	2	2	2.0	0.0	0.0	2	2	0
fam14970	2	2	2	2.0	0.0	0.0	2	2	0
fam14971	2	2	2	2.0	0.0	0.0	2	2	0
fam14972	2	2	2	2.0	0.0	0.0	2	2	0
fam14973	2	2	2	2.0	0.0	0.0	2	2	0
fam14974	2	2	2	2.0	0.0	0.0	2	2	0
fam14975	2	2	2	2.0	0.0	0.0	2	2	0
fam14976	2	2	2	2.0	0.0	0.0	2	2	0
fam14977	2	2	2	2.0	0.0	0.0	2	2	0
fam14978	2	2	2	2.0	0.0	0.0	2	2	0
fam14979	2	2	2	2.0	0.0	0.0	2	2	0
fam14980	2	2	2	2.0	0.0	0.0	2	2	0
fam14981	2	2	2	2.0	0.0	0.0	2	2	0
fam14982	2	2	2	2.0	0.0	0.0	2	2	0
fam14983	2	2	2	2.0	0.0	0.0	2	2	0
fam14984	2	2	2	2.0	0.0	0.0	2	2	0
fam14985	2	2	2	2.0	0.0	0.0	2	2	0
fam14986	2	2	2	2.0	0.0	0.0	2	2	0
fam14987	2	2	2	2.0	0.0	0.0	2	2	0
fam14988	2	2	2	2.0	0.0	0.0	2	2	0
fam14989	2	2	2	2.0	0.0	0.0	2	2	0
fam14990	2	2	2	2.0	0.0	0.0	2	2	0
fam14991	2	2	2	2.0	0.0	0.0	2	2	0
fam14992	2	2	2	2.0	0.0	0.0	2	2	0
fam14993	2	2	2	2.0	0.0	0.0	2	2	0
fam14994	2	2	2	2.0	0.0	0.0	2	2	0
fam14995	2	2	2	2.0	0.0	0.0	2	2	0
fam14996	2	2	2	2.0	0.0	0.0	2	2	0
fam14997	2	2	2	2.0	0.0	0.0	2	2	0
fam14998	2	2	2	2.0	0.0	0.0	2	2	0
fam14999	2	2	2	2.0	0.0	0.0	2	2	0
fam15000	2	2	2	2.0	0.0	0.0	2	2	0
fam15001	2	2	2	2.0	0.0	0.0	2	2	0
fam15002	2	2	2	2.0	0.0	0.0	2	2	0
fam15003	2	2	2	2.0	0.0	0.0	2	2	0
fam15004	2	2	2	2.0	0.0	0.0	2	2	0
fam15005	2	2	2	2.0	0.0	0.0	2	2	0
fam15006	2	2	2	2.0	0.0	0.0	2	2	0
fam15007	2	2	2	2.0	0.0	0.0	2	2	0
fam15008	2	2	2	2.0	0.0	0.0	2	2	0
fam15009	2	2	2	2.0	0.0	0.0	2	2	0
fam15010	2	2	2	2.0	0.0	0.0	2	2	0
fam15011	2	2	2	2.0	0.0	0.0	2	2	0
fam15012	2	2	2	2.0	0.0	0.0	2	2	0
fam15013	2	2	2	2.0	0.0	0.0	2	2	0
fam15014	2	2	2	2.0	0.0	0.0	2	2	0
fam15015	2	2	2	2.0	0.0	0.0	2	2	0
fam15016	2	2	2	2.0	0.0	0.0	2	2	0
fam15017	2	2	2	2.0	0.0	0.0	2	2	0
fam15018	2	2	2	2.0	0.0	0.0	2	2	0
fam15019	2	2	2	2.0	0.0	0.0	2	2	0
fam15020	2	2	2	2.0	0.0	0.0	2	2	0
fam15021	2	2	2	2.0	0.0	0.0	2	2	0
fam15022	2	2	2	2.0	0.0	0.0	2	2	0
fam15023	2	2	2	2.0	0.0	0.0	2	2	0
fam15024	2	2	2	2.0	0.0	0.0	2	2	0
fam15025	2	2	2	2.0	0.0	0.0	2	2	0
fam15026	2	2	2	2.0	0.0	0.0	2	2	0
fam15027	2	2	2	2.0	0.0	0.0	2	2	0
fam15028	2	2	2	2.0	0.0	0.0	2	2	0
fam15029	2	2	2	2.0	0.0	0.0	2	2	0
fam15030	2	2	2	2.0	0.0	0.0	2	2	0
fam15031	2	2	2	2.0	0.0	0.0	2	2	0
fam15032	2	2	2	2.0	0.0	0.0	2	2	0
fam15033	2	2	2	2.0	0.0	0.0	2	2	0
fam15034	2	2	2	2.0	0.0	0.0	2	2	0
fam15035	2	2	2	2.0	0.0	0.0	2	2	0
fam15036	2	2	2	2.0	0.0	0.0	2	2	0
fam15037	2	2	2	2.0	0.0	0.0	2	2	0
fam15038	2	2	2	2.0	0.0	0.0	2	2	0
fam15039	2	2	2	2.0	0.0	0.0	2	2	0
fam15040	2	2	2	2.0	0.0	0.0	2	2	0
fam15041	2	2	2	2.0	0.0	0.0	2	2	0
fam15042	2	2	2	2.0	0.0	0.0	2	2	0
fam15043	2	2	2	2.0	0.0	0.0	2	2	0
fam15044	2	2	2	2.0	0.0	0.0	2	2	0
fam15045	2	2	2	2.0	0.0	0.0	2	2	0
fam15046	2	2	2	2.0	0.0	0.0	2	2	0
fam15047	2	2	2	2.0	0.0	0.0	2	2	0
fam15048	2	2	2	2.0	0.0	0.0	2	2	0
fam15049	2	2	2	2.0	0.0	0.0	2	2	0
fam15050	2	2	2	2.0	0.0	0.0	2	2	0
fam15051	2	2	2	2.0	0.0	0.0	2	2	0
fam15052	2	2	2	2.0	0.0	0.0	2	2	0
fam15053	2	2	2	2.0	0.0	0.0	2	2	0
fam15054	2	2	2	2.0	0.0	0.0	2	2	0
fam15055	2	2	2	2.0	0.0	0.0	2	2	0
fam15056	2	2	2	2.0	0.0	0.0	2	2	0
fam15057	2	2	2	2.0	0.0	0.0	2	2	0
fam15058	2	2	2	2.0	0.0	0.0	2	2	0
fam15059	2	2	2	2.0	0.0	0.0	2	2	0
fam15060	2	2	2	2.0	0.0	0.0	2	2	0
fam15061	2	2	2	2.0	0.0	0.0	2	2	0
fam15062	2	2	2	2.0	0.0	0.0	2	2	0
fam15063	2	2	2	2.0	0.0	0.0	2	2	0
fam15064	2	2	2	2.0	0.0	0.0	2	2	0
fam15065	2	2	2	2.0	0.0	0.0	2	2	0
fam15066	2	2	2	2.0	0.0	0.0	2	2	0
fam15067	2	2	2	2.0	0.0	0.0	2	2	0
fam15068	2	2	2	2.0	0.0	0.0	2	2	0
fam15069	2	2	2	2.0	0.0	0.0	2	2	0
fam15070	2	2	2	2.0	0.0	0.0	2	2	0
fam15071	2	2	2	2.0	0.0	0.0	2	2	0
fam15072	2	2	2	2.0	0.0	0.0	2	2	0
fam15073	2	2	2	2.0	0.0	0.0	2	2	0
fam15074	2	2	2	2.0	0.0	0.0	2	2	0
fam15075	2	2	2	2.0	0.0	0.0	2	2	0
fam15076	2	2	2	2.0	0.0	0.0	2	2	0
fam15077	2	2	2	2.0	0.0	0.0	2	2	0
fam15078	2	2	2	2.0	0.0	0.0	2	2	0
fam15079	2	2	2	2.0	0.0	0.0	2	2	0
fam15080	2	2	2	2.0	0.0	0.0	2	2	0
fam15081	2	2	2	2.0	0.0	0.0	2	2	0
fam15082	2	2	2	2.0	0.0	0.0	2	2	0
fam15083	2	2	2	2.0	0.0	0.0	2	2	0
fam15084	2	2	2	2.0	0.0	0.0	2	2	0
fam15085	2	2	2	2.0	0.0	0.0	2	2	0
fam15086	2	2	2	2.0	0.0	0.0	2	2	0
fam15087	2	2	2	2.0	0.0	0.0	2	2	0
fam15088	2	2	2	2.0	0.0	0.0	2	2	0
fam15089	2	2	2	2.0	0.0	0.0	2	2	0
fam15090	2	2	2	2.0	0.0	0.0	2	2	0
fam15091	2	2	2	2.0	0.0	0.0	2	2	0
fam15092	2	2	2	2.0	0.0	0.0	2	2	0
fam15093	2	2	2	2.0	0.0	0.0	2	2	0
fam15094	2	2	2	2.0	0.0	0.0	2	2	0
fam15095	2	2	2	2.0	0.0	0.0	2	2	0
fam15096	2	2	2	2.0	0.0	0.0	2	2	0
fam15097	2	2	2	2.0	0.0	0.0	2	2	0
fam15098	2	2	2	2.0	0.0	0.0	2	2	0
fam15099	2	2	2	2.0	0.0	0.0	2	2	0
fam15100	2	2	2	2.0	0.0	0.0	2	2	0
fam15101	2	2	2	2.0	0.0	0.0	2	2	0
fam15102	2	2	2	2.0	0.0	0.0	2	2	0
fam15103	2	2	2	2.0	0.0	0.0	2	2	0
fam15104	2	2	2	2.0	0.0	0.0	2	2	0
fam15105	2	2	2	2.0	0.0	0.0	2	2	0
fam15106	2	2	2	2.0	0.0	0.0	2	2	0
fam15107	2	2	2	2.0	0.0	0.0	2	2	0
fam15108	2	2	2	2.0	0.0	0.0	2	2	0
fam15109	2	2	2	2.0	0.0	0.0	2	2	0
fam15110	2	2	2	2.0	0.0	0.0	2	2	0
fam15111	2	2	2	2.0	0.0	0.0	2	2	0
fam15112	2	2	2	2.0	0.0	0.0	2	2	0
fam15113	2	2	2	2.0	0.0	0.0	2	2	0
fam15114	2	2	2	2.0	0.0	0.0	2	2	0
fam15115	2	2	2	2.0	0.0	0.0	2	2	0
fam15116	2	2	2	2.0	0.0	0.0	2	2	0
fam15117	2	2	2	2.0	0.0	0.0	2	2	0
fam15118	2	2	2	2.0	0.0	0.0	2	2	0
fam15119	2	2	2	2.0	0.0	0.0	2	2	0
fam15120	2	2	2	2.0	0.0	0.0	2	2	0
fam15121	2	2	2	2.0	0.0	0.0	2	2	0
fam15122	2	2	2	2.0	0.0	0.0	2	2	0
fam15123	2	2	2	2.0	0.0	0.0	2	2	0
fam15124	2	2	2	2.0	0.0	0.0	2	2	0
fam15125	2	2	2	2.0	0.0	0.0	2	2	0
fam15126	2	2	2	2.0	0.0	0.0	2	2	0
fam15127	2	2	2	2.0	0.0	0.0	2	2	0
fam15128	2	2	2	2.0	0.0	0.0	2	2	0
fam15129	2	2	2	2.0	0.0	0.0	2	2	0
fam15130	2	2	2	2.0	0.0	0.0	2	2	0
fam15131	2	2	2	2.0	0.0	0.0	2	2	0
fam15132	2	2	2	2.0	0.0	0.0	2	2	0
fam15133	2	2	2	2.0	0.0	0.0	2	2	0
fam15134	2	2	2	2.0	0.0	0.0	2	2	0
fam15135	2	2	2	2.0	0.0	0.0	2	2	0
fam15136	2	2	2	2.0	0.0	0.0	2	2	0
fam15137	2	2	2	2.0	0.0	0.0	2	2	0
fam15138	2	2	2	2.0	0.0	0.0	2	2	0
fam15139	2	2	2	2.0	0.0	0.0	2	2	0
fam15140	2	2	2	2.0	0.0	0.0	2	2	0
fam15141	2	2	2	2.0	0.0	0.0	2	2	0
fam15142	2	2	2	2.0	0.0	0.0	2	2	0
fam15143	2	2	2	2.0	0.0	0.0	2	2	0
fam15144	2	2	2	2.0	0.0	0.0	2	2	0
fam15145	2	2	2	2.0	0.0	0.0	2	2	0
fam15146	2	2	2	2.0	0.0	0.0	2	2	0
fam15147	2	2	2	2.0	0.0	0.0	2	2	0
fam15148	2	2	2	2.0	0.0	0.0	2	2	0
fam15149	2	2	2	2.0	0.0	0.0	2	2	0
fam15150	2	2	2	2.0	0.0	0.0	2	2	0
fam15151	2	2	2	2.0	0.0	0.0	2	2	0
fam15152	2	2	2	2.0	0.0	0.0	2	2	0
fam15153	2	2	2	2.0	0.0	0.0	2	2	0
fam15154	2	2	2	2.0	0.0	0.0	2	2	0
fam15155	2	2	2	2.0	0.0	0.0	2	2	0
fam15156	2	2	2	2.0	0.0	0.0	2	2	0
fam15157	2	2	2	2.0	0.0	0.0	2	2	0
fam15158	2	2	2	2.0	0.0	0.0	2	2	0
fam15159	2	2	2	2.0	0.0	0.0	2	2	0
fam15160	2	2	2	2.0	0.0	0.0	2	2	0
fam15161	2	2	2	2.0	0.0	0.0	2	2	0
fam15162	2	2	2	2.0	0.0	0.0	2	2	0
fam15163	2	2	2	2.0	0.0	0.0	2	2	0
fam15164	2	2	2	2.0	0.0	0.0	2	2	0
fam15165	2	2	2	2.0	0.0	0.0	2	2	0
fam15166	2	2	2	2.0	0.0	0.0	2	2	0
fam15167	2	2	2	2.0	0.0	0.0	2	2	0
fam15168	2	2	2	2.0	0.0	0.0	2	2	0
fam15169	2	2	2	2.0	0.0	0.0	2	2	0
fam15170	2	2	2	2.0	0.0	0.0	2	2	0
fam15171	2	2	2	2.0	0.0	0.0	2	2	0
fam15172	2	2	2	2.0	0.0	0.0	2	2	0
fam15173	2	2	2	2.0	0.0	0.0	2	2	0
fam15174	2	2	2	2.0	0.0	0.0	2	2	0
fam15175	2	2	2	2.0	0.0	0.0	2	2	0
fam15176	2	2	2	2.0	0.0	0.0	2	2	0
fam15177	2	2	2	2.0	0.0	0.0	2	2	0
fam15178	2	2	2	2.0	0.0	0.0	2	2	0
fam15179	2	2	2	2.0	0.0	0.0	2	2	0
fam15180	2	2	2	2.0	0.0	0.0	2	2	0
fam15181	2	2	2	2.0	0.0	0.0	2	2	0
fam15182	2	2	2	2.0	0.0	0.0	2	2	0
fam15183	2	2	2	2.0	0.0	0.0	2	2	0
fam15184	2	2	2	2.0	0.0	0.0	2	2	0
fam15185	2	2	2	2.0	0.0	0.0	2	2	0
fam15186	2	2	2	2.0	0.0	0.0	2	2	0
fam15187	2	2	2	2.0	0.0	0.0	2	2	0
fam15188	2	2	2	2.0	0.0	0.0	2	2	0
fam15189	2	2	2	2.0	0.0	0.0	2	2	0
fam15190	2	2	2	2.0	0.0	0.0	2	2	0
fam15191	2	2	2	2.0	0.0	0.0	2	2	0
fam15192	2	2	2	2.0	0.0	0.0	2	2	0
fam15193	2	2	2	2.0	0.0	0.0	2	2	0
fam15194	2	2	2	2.0	0.0	0.0	2	2	0
fam15195	2	2	2	2.0	0.0	0.0	2	2	0
fam15196	2	2	2	2.0	0.0	0.0	2	2	0
fam15197	2	2	2	2.0	0.0	0.0	2	2	0
fam15198	2	2	2	2.0	0.0	0.0	2	2	0
fam15199	2	2	2	2.0	0.0	0.0	2	2	0
fam15200	2	2	2	2.0	0.0	0.0	2	2	0
fam15201	2	2	2	2.0	0.0	0.0	2	2	0
fam15202	2	2	2	2.0	0.0	0.0	2	2	0
fam15203	2	2	2	2.0	0.0	0.0	2	2	0
fam15204	2	2	2	2.0	0.0	0.0	2	2	0
fam15205	2	2	2	2.0	0.0	0.0	2	2	0
fam15206	2	2	2	2.0	0.0	0.0	2	2	0
fam15207	2	2	2	2.0	0.0	0.0	2	2	0
fam15208	2	2	2	2.0	0.0	0.0	2	2	0
fam15209	2	2	2	2.0	0.0	0.0	2	2	0
fam15210	2	2	2	2.0	0.0	0.0	2	2	0
fam15211	2	2	2	2.0	0.0	0.0	2	2	0
fam15212	2	2	2	2.0	0.0	0.0	2	2	0
fam15213	2	2	2	2.0	0.0	0.0	2	2	0
fam15214	2	2	2	2.0	0.0	0.0	2	2	0
fam15215	2	2	2	2.0	0.0	0.0	2	2	0
fam15216	2	2	2	2.0	0.0	0.0	2	2	0
fam15217	2	2	2	2.0	0.0	0.0	2	2	0
fam15218	2	2	2	2.0	0.0	0.0	2	2	0
fam15219	2	2	2	2.0	0.0	0.0	2	2	0
fam15220	2	2	2	2.0	0.0	0.0	2	2	0
fam15221	2	2	2	2.0	0.0	0.0	2	2	0
fam15222	2	2	2	2.0	0.0	0.0	2	2	0
fam15223	2	2	2	2.0	0.0	0.0	2	2	0
fam15224	2	2	2	2.0	0.0	0.0	2	2	0
fam15225	2	2	2	2.0	0.0	0.0	2	2	0
fam15226	2	2	2	2.0	0.0	0.0	2	2	0
fam15227	2	2	2	2.0	0.0	0.0	2	2	0
fam15228	2	2	2	2.0	0.0	0.0	2	2	0
fam15229	2	2	2	2.0	0.0	0.0	2	2	0
fam15230	2	2	2	2.0	0.0	0.0	2	2	0
fam15231	2	2	2	2.0	0.0	0.0	2	2	0
fam15232	2	2	2	2.0	0.0	0.0	2	2	0
fam15233	2	2	2	2.0	0.0	0.0	2	2	0
fam15234	2	2	2	2.0	0.0	0.0	2	2	0
fam15235	2	2	2	2.0	0.0	0.0	2	2	0
fam15236	2	2	2	2.0	0.0	0.0	2	2	0
fam15237	2	2	2	2.0	0.0	0.0	2	2	0
fam15238	2	2	2	2.0	0.0	0.0	2	2	0
fam15239	2	2	2	2.0	0.0	0.0	2	2	0
fam15240	2	2	2	2.0	0.0	0.0	2	2	0
fam15241	2	2	2	2.0	0.0	0.0	2	2	0
fam15242	2	2	2	2.0	0.0	0.0	2	2	0
fam15243	2	2	2	2.0	0.0	0.0	2	2	0
fam15244	2	2	2	2.0	0.0	0.0	2	2	0
fam15245	2	2	2	2.0	0.0	0.0	2	2	0
fam15246	2	2	2	2.0	0.0	0.0	2	2	0
fam15247	2	2	2	2.0	0.0	0.0	2	2	0
fam15248	2	2	2	2.0	0.0	0.0	2	2	0
fam15249	2	2	2	2.0	0.0	0.0	2	2	0
fam15250	2	2	2	2.0	0.0	0.0	2	2	0
fam15251	2	2	2	2.0	0.0	0.0	2	2	0
fam15252	2	2	2	2.0	0.0	0.0	2	2	0
fam15253	2	2	2	2.0	0.0	0.0	2	2	0
fam15254	2	2	2	2.0	0.0	0.0	2	2	0
fam15255	2	2	2	2.0	0.0	0.0	2	2	0
fam15256	2	2	2	2.0	0.0	0.0	2	2	0
fam15257	2	2	2	2.0	0.0	0.0	2	2	0
fam15258	2	2	2	2.0	0.0	0.0	2	2	0
fam15259	2	2	2	2.0	0.0	0.0	2	2	0
fam15260	2	2	2	2.0	0.0	0.0	2	2	0
fam15261	2	2	2	2.0	0.0	0.0	2	2	0
fam15262	2	2	2	2.0	0.0	0.0	2	2	0
fam15263	2	2	2	2.0	0.0	0.0	2	2	0
fam15264	2	2	2	2.0	0.0	0.0	2	2	0
fam15265	2	2	2	2.0	0.0	0.0	2	2	0
fam15266	2	2	2	2.0	0.0	0.0	2	2	0
fam15267	2	2	2	2.0	0.0	0.0	2	2	0
fam15268	2	2	2	2.0	0.0	0.0	2	2	0
fam15269	2	2	2	2.0	0.0	0.0	2	2	0
fam15270	2	2	2	2.0	0.0	0.0	2	2	0
fam15271	2	2	2	2.0	0.0	0.0	2	2	0
fam15272	2	2	2	2.0	0.0	0.0	2	2	0
fam15273	2	2	2	2.0	0.0	0.0	2	2	0
fam15274	2	2	2	2.0	0.0	0.0	2	2	0
fam15275	2	2	2	2.0	0.0	0.0	2	2	0
fam15276	2	2	2	2.0	0.0	0.0	2	2	0
fam15277	2	2	2	2.0	0.0	0.0	2	2	0
fam15278	2	2	2	2.0	0.0	0.0	2	2	0
fam15279	2	2	2	2.0	0.0	0.0	2	2	0
fam15280	2	2	2	2.0	0.0	0.0	2	2	0
fam15281	2	2	2	2.0	0.0	0.0	2	2	0
fam15282	2	2	2	2.0	0.0	0.0	2	2	0
fam15283	2	2	2	2.0	0.0	0.0	2	2	0
fam15284	2	2	2	2.0	0.0	0.0	2	2	0
fam15285	2	2	2	2.0	0.0	0.0	2	2	0
fam15286	2	2	2	2.0	0.0	0.0	2	2	0
fam15287	2	2	2	2.0	0.0	0.0	2	2	0
fam15288	2	2	2	2.0	0.0	0.0	2	2	0
fam15289	2	2	2	2.0	0.0	0.0	2	2	0
fam15290	2	2	2	2.0	0.0	0.0	2	2	0
fam15291	2	2	2	2.0	0.0	0.0	2	2	0
fam15292	2	2	2	2.0	0.0	0.0	2	2	0
fam15293	2	2	2	2.0	0.0	0.0	2	2	0
fam15294	2	2	2	2.0	0.0	0.0	2	2	0
fam15295	2	2	2	2.0	0.0	0.0	2	2	0
fam15296	2	2	2	2.0	0.0	0.0	2	2	0
fam15297	2	2	2	2.0	0.0	0.0	2	2	0
fam15298	2	2	2	2.0	0.0	0.0	2	2	0
fam15299	2	2	2	2.0	0.0	0.0	2	2	0
fam15300	2	2	2	2.0	0.0	0.0	2	2	0
fam15301	2	2	2	2.0	0.0	0.0	2	2	0
fam15302	2	2	2	2.0	0.0	0.0	2	2	0
fam15303	2	2	2	2.0	0.0	0.0	2	2	0
fam15304	2	2	2	2.0	0.0	0.0	2	2	0
fam15305	2	2	2	2.0	0.0	0.0	2	2	0
fam15306	2	2	2	2.0	0.0	0.0	2	2	0
fam15307	2	2	2	2.0	0.0	0.0	2	2	0
fam15308	2	2	2	2.0	0.0	0.0	2	2	0
fam15309	2	2	2	2.0	0.0	0.0	2	2	0
fam15310	2	2	2	2.0	0.0	0.0	2	2	0
fam15311	2	2	2	2.0	0.0	0.0	2	2	0
fam15312	2	2	2	2.0	0.0	0.0	2	2	0
fam15313	2	2	2	2.0	0.0	0.0	2	2	0
fam15314	2	2	2	2.0	0.0	0.0	2	2	0
fam15315	2	2	2	2.0	0.0	0.0	2	2	0
fam15316	2	2	2	2.0	0.0	0.0	2	2	0
fam15317	2	2	2	2.0	0.0	0.0	2	2	0
fam15318	2	2	2	2.0	0.0	0.0	2	2	0
fam15319	2	2	2	2.0	0.0	0.0	2	2	0
fam15320	2	2	2	2.0	0.0	0.0	2	2	0
fam15321	2	2	2	2.0	0.0	0.0	2	2	0
fam15322	2	2	2	2.0	0.0	0.0	2	2	0
fam15323	2	2	2	2.0	0.0	0.0	2	2	0
fam15324	2	2	2	2.0	0.0	0.0	2	2	0
fam15325	2	2	2	2.0	0.0	0.0	2	2	0
fam15326	2	2	2	2.0	0.0	0.0	2	2	0
fam15327	2	2	2	2.0	0.0	0.0	2	2	0
fam15328	2	2	2	2.0	0.0	0.0	2	2	0
fam15329	2	2	2	2.0	0.0	0.0	2	2	0
fam15330	2	2	2	2.0	0.0	0.0	2	2	0
fam15331	2	2	2	2.0	0.0	0.0	2	2	0
fam15332	2	2	2	2.0	0.0	0.0	2	2	0
fam15333	2	2	2	2.0	0.0	0.0	2	2	0
fam15334	2	2	2	2.0	0.0	0.0	2	2	0
fam15335	2	2	2	2.0	0.0	0.0	2	2	0
fam15336	2	2	2	2.0	0.0	0.0	2	2	0
fam15337	2	2	2	2.0	0.0	0.0	2	2	0
fam15338	2	2	2	2.0	0.0	0.0	2	2	0
fam15339	2	2	2	2.0	0.0	0.0	2	2	0
fam15340	2	2	2	2.0	0.0	0.0	2	2	0
fam15341	2	2	2	2.0	0.0	0.0	2	2	0
fam15342	2	2	2	2.0	0.0	0.0	2	2	0
fam15343	2	2	2	2.0	0.0	0.0	2	2	0
fam15344	2	2	2	2.0	0.0	0.0	2	2	0
fam15345	2	2	2	2.0	0.0	0.0	2	2	0
fam15346	2	2	2	2.0	0.0	0.0	2	2	0
fam15347	2	2	2	2.0	0.0	0.0	2	2	0
fam15348	2	2	2	2.0	0.0	0.0	2	2	0
fam15349	2	2	2	2.0	0.0	0.0	2	2	0
fam15350	2	2	2	2.0	0.0	0.0	2	2	0
fam15351	2	2	2	2.0	0.0	0.0	2	2	0
fam15352	2	2	2	2.0	0.0	0.0	2	2	0
fam15353	2	2	2	2.0	0.0	0.0	2	2	0
fam15354	2	2	2	2.0	0.0	0.0	2	2	0
fam15355	2	2	2	2.0	0.0	0.0	2	2	0
fam15356	2	2	2	2.0	0.0	0.0	2	2	0
fam15357	2	2	2	2.0	0.0	0.0	2	2	0
fam15358	2	2	2	2.0	0.0	0.0	2	2	0
fam15359	2	2	2	2.0	0.0	0.0	2	2	0
fam15360	2	2	2	2.0	0.0	0.0	2	2	0
fam15361	2	2	2	2.0	0.0	0.0	2	2	0
fam15362	2	2	2	2.0	0.0	0.0	2	2	0
fam15363	2	2	2	2.0	0.0	0.0	2	2	0
fam15364	2	2	2	2.0	0.0	0.0	2	2	0
fam15365	2	2	2	2.0	0.0	0.0	2	2	0
fam15366	2	2	2	2.0	0.0	0.0	2	2	0
fam15367	2	2	2	2.0	0.0	0.0	2	2	0
fam15368	2	2	2	2.0	0.0	0.0	2	2	0
fam15369	2	2	2	2.0	0.0	0.0	2	2	0
fam15370	2	2	2	2.0	0.0	0.0	2	2	0
fam15371	2	2	2	2.0	0.0	0.0	2	2	0
fam15372	2	2	2	2.0	0.0	0.0	2	2	0
fam15373	2	2	2	2.0	0.0	0.0	2	2	0
fam15374	2	2	2	2.0	0.0	0.0	2	2	0
fam15375	2	2	2	2.0	0.0	0.0	2	2	0
fam15376	2	2	2	2.0	0.0	0.0	2	2	0
fam15377	2	2	2	2.0	0.0	0.0	2	2	0
fam15378	2	2	2	2.0	0.0	0.0	2	2	0
fam15379	2	2	2	2.0	0.0	0.0	2	2	0
fam15380	2	2	2	2.0	0.0	0.0	2	2	0
fam15381	2	2	2	2.0	0.0	0.0	2	2	0
fam15382	2	2	2	2.0	0.0	0.0	2	2	0
fam15383	2	2	2	2.0	0.0	0.0	2	2	0
fam15384	2	2	2	2.0	0.0	0.0	2	2	0
fam15385	2	2	2	2.0	0.0	0.0	2	2	0
fam15386	2	2	2	2.0	0.0	0.0	2	2	0
fam15387	2	2	2	2.0	0.0	0.0	2	2	0
fam15388	2	2	2	2.0	0.0	0.0	2	2	0
fam15389	2	2	2	2.0	0.0	0.0	2	2	0
fam15390	2	2	2	2.0	0.0	0.0	2	2	0
fam15391	2	2	2	2.0	0.0	0.0	2	2	0
fam15392	2	2	2	2.0	0.0	0.0	2	2	0
fam15393	2	2	2	2.0	0.0	0.0	2	2	0
fam15394	2	2	2	2.0	0.0	0.0	2	2	0
fam15395	2	2	2	2.0	0.0	0.0	2	2	0
fam15396	2	2	2	2.0	0.0	0.0	2	2	0
fam15397	2	2	2	2.0	0.0	0.0	2	2	0
fam15398	2	2	2	2.0	0.0	0.0	2	2	0
fam15399	2	2	2	2.0	0.0	0.0	2	2	0
fam15400	2	2	2	2.0	0.0	0.0	2	2	0
fam15401	2	2	2	2.0	0.0	0.0	2	2	0
fam15402	2	2	2	2.0	0.0	0.0	2	2	0
fam15403	2	2	2	2.0	0.0	0.0	2	2	0
fam15404	2	2	2	2.0	0.0	0.0	2	2	0
fam15405	2	2	2	2.0	0.0	0.0	2	2	0
fam15406	2	2	2	2.0	0.0	0.0	2	2	0
fam15407	2	2	2	2.0	0.0	0.0	2	2	0
fam15408	2	2	2	2.0	0.0	0.0	2	2	0
fam15409	2	2	2	2.0	0.0	0.0	2	2	0
fam15410	2	2	2	2.0	0.0	0.0	2	2	0
fam15411	2	2	2	2.0	0.0	0.0	2	2	0
fam15412	2	2	2	2.0	0.0	0.0	2	2	0
fam15413	2	2	2	2.0	0.0	0.0	2	2	0
fam15414	2	2	2	2.0	0.0	0.0	2	2	0
fam15415	2	2	2	2.0	0.0	0.0	2	2	0
fam15416	2	2	2	2.0	0.0	0.0	2	2	0
fam15417	2	2	2	2.0	0.0	0.0	2	2	0
fam15418	2	2	2	2.0	0.0	0.0	2	2	0
fam15419	2	2	2	2.0	0.0	0.0	2	2	0
fam15420	2	2	2	2.0	0.0	0.0	2	2	0
fam15421	2	2	2	2.0	0.0	0.0	2	2	0
fam15422	2	2	2	2.0	0.0	0.0	2	2	0
fam15423	2	2	2	2.0	0.0	0.0	2	2	0
fam15424	2	2	2	2.0	0.0	0.0	2	2	0
fam15425	2	2	2	2.0	0.0	0.0	2	2	0
fam15426	2	2	2	2.0	0.0	0.0	2	2	0
fam15427	2	2	2	2.0	0.0	0.0	2	2	0
fam15428	2	2	2	2.0	0.0	0.0	2	2	0
fam15429	2	2	2	2.0	0.0	0.0	2	2	0
fam15430	2	2	2	2.0	0.0	0.0	2	2	0
fam15431	2	2	2	2.0	0.0	0.0	2	2	0
fam15432	2	2	2	2.0	0.0	0.0	2	2	0
fam15433	2	2	2	2.0	0.0	0.0	2	2	0
fam15434	2	2	2	2.0	0.0	0.0	2	2	0
fam15435	2	2	2	2.0	0.0	0.0	2	2	0
fam15436	2	2	2	2.0	0.0	0.0	2	2	0
fam15437	2	2	2	2.0	0.0	0.0	2	2	0
fam15438	2	2	2	2.0	0.0	0.0	2	2	0
fam15439	2	2	2	2.0	0.0	0.0	2	2	0
fam15440	2	2	2	2.0	0.0	0.0	2	2	0
fam15441	2	2	2	2.0	0.0	0.0	2	2	0
fam15442	2	2	2	2.0	0.0	0.0	2	2	0
fam15443	2	2	2	2.0	0.0	0.0	2	2	0
fam15444	2	2	2	2.0	0.0	0.0	2	2	0
fam15445	2	2	2	2.0	0.0	0.0	2	2	0
fam15446	2	2	2	2.0	0.0	0.0	2	2	0
fam15447	2	2	2	2.0	0.0	0.0	2	2	0
fam15448	2	2	2	2.0	0.0	0.0	2	2	0
fam15449	2	2	2	2.0	0.0	0.0	2	2	0
fam15450	2	2	2	2.0	0.0	0.0	2	2	0
fam15451	2	2	2	2.0	0.0	0.0	2	2	0
fam15452	2	2	2	2.0	0.0	0.0	2	2	0
fam15453	2	2	2	2.0	0.0	0.0	2	2	0
fam15454	2	2	2	2.0	0.0	0.0	2	2	0
fam15455	2	2	2	2.0	0.0	0.0	2	2	0
fam15456	2	2	2	2.0	0.0	0.0	2	2	0
fam15457	2	2	2	2.0	0.0	0.0	2	2	0
fam15458	2	2	2	2.0	0.0	0.0	2	2	0
fam15459	2	2	2	2.0	0.0	0.0	2	2	0
fam15460	2	2	2	2.0	0.0	0.0	2	2	0
fam15461	2	2	2	2.0	0.0	0.0	2	2	0
fam15462	2	2	2	2.0	0.0	0.0	2	2	0
fam15463	2	2	2	2.0	0.0	0.0	2	2	0
fam15464	2	2	2	2.0	0.0	0.0	2	2	0
fam15465	2	2	2	2.0	0.0	0.0	2	2	0
fam15466	2	2	2	2.0	0.0	0.0	2	2	0
fam15467	2	2	2	2.0	0.0	0.0	2	2	0
fam15468	2	2	2	2.0	0.0	0.0	2	2	0
fam15469	2	2	2	2.0	0.0	0.0	2	2	0
fam15470	2	2	2	2.0	0.0	0.0	2	2	0
fam15471	2	2	2	2.0	0.0	0.0	2	2	0
fam15472	2	2	2	2.0	0.0	0.0	2	2	0
fam15473	2	2	2	2.0	0.0	0.0	2	2	0
fam15474	2	2	2	2.0	0.0	0.0	2	2	0
fam15475	2	2	2	2.0	0.0	0.0	2	2	0
fam15476	2	2	2	2.0	0.0	0.0	2	2	0
fam15477	2	2	2	2.0	0.0	0.0	2	2	0
fam15478	2	2	2	2.0	0.0	0.0	2	2	0
fam15479	2	2	2	2.0	0.0	0.0	2	2	0
fam15480	2	2	2	2.0	0.0	0.0	2	2	0
fam15481	2	2	2	2.0	0.0	0.0	2	2	0
fam15482	2	2	2	2.0	0.0	0.0	2	2	0
fam15483	2	2	2	2.0	0.0	0.0	2	2	0
fam15484	2	2	2	2.0	0.0	0.0	2	2	0
fam15485	2	2	2	2.0	0.0	0.0	2	2	0
fam15486	2	2	2	2.0	0.0	0.0	2	2	0
fam15487	2	2	2	2.0	0.0	0.0	2	2	0
fam15488	2	2	2	2.0	0.0	0.0	2	2	0
fam15489	2	2	2	2.0	0.0	0.0	2	2	0
fam15490	2	2	2	2.0	0.0	0.0	2	2	0
fam15491	2	2	2	2.0	0.0	0.0	2	2	0
fam15492	2	2	2	2.0	0.0	0.0	2	2	0
fam15493	2	2	2	2.0	0.0	0.0	2	2	0
fam15494	2	2	2	2.0	0.0	0.0	2	2	0
fam15495	2	2	2	2.0	0.0	0.0	2	2	0
fam15496	2	2	2	2.0	0.0	0.0	2	2	0
fam15497	2	2	2	2.0	0.0	0.0	2	2	0
fam15498	2	2	2	2.0	0.0	0.0	2	2	0
fam15499	2	2	2	2.0	0.0	0.0	2	2	0
fam15500	2	2	2	2.0	0.0	0.0	2	2	0
fam15501	2	2	2	2.0	0.0	0.0	2	2	0
fam15502	2	2	2	2.0	0.0	0.0	2	2	0
fam15503	2	2	2	2.0	0.0	0.0	2	2	0
fam15504	2	2	2	2.0	0.0	0.0	2	2	0
fam15505	2	2	2	2.0	0.0	0.0	2	2	0
fam15506	2	2	2	2.0	0.0	0.0	2	2	0
fam15507	2	2	2	2.0	0.0	0.0	2	2	0
fam15508	2	2	2	2.0	0.0	0.0	2	2	0
fam15509	2	2	2	2.0	0.0	0.0	2	2	0
fam15510	2	2	2	2.0	0.0	0.0	2	2	0
fam15511	2	2	2	2.0	0.0	0.0	2	2	0
fam15512	2	2	2	2.0	0.0	0.0	2	2	0
fam15513	2	2	2	2.0	0.0	0.0	2	2	0
fam15514	2	2	2	2.0	0.0	0.0	2	2	0
fam15515	2	2	2	2.0	0.0	0.0	2	2	0
fam15516	2	2	2	2.0	0.0	0.0	2	2	0
fam15517	2	2	2	2.0	0.0	0.0	2	2	0
fam15518	2	2	2	2.0	0.0	0.0	2	2	0
fam15519	2	2	2	2.0	0.0	0.0	2	2	0
fam15520	2	2	2	2.0	0.0	0.0	2	2	0
fam15521	2	2	2	2.0	0.0	0.0	2	2	0
fam15522	2	2	2	2.0	0.0	0.0	2	2	0
fam15523	2	2	2	2.0	0.0	0.0	2	2	0
fam15524	2	2	2	2.0	0.0	0.0	2	2	0
fam15525	2	2	2	2.0	0.0	0.0	2	2	0
fam15526	2	2	2	2.0	0.0	0.0	2	2	0
fam15527	2	2	2	2.0	0.0	0.0	2	2	0
fam15528	2	2	2	2.0	0.0	0.0	2	2	0
fam15529	2	2	2	2.0	0.0	0.0	2	2	0
fam15530	2	2	2	2.0	0.0	0.0	2	2	0
fam15531	2	2	2	2.0	0.0	0.0	2	2	0
fam15532	2	2	2	2.0	0.0	0.0	2	2	0
fam15533	2	2	2	2.0	0.0	0.0	2	2	0
fam15534	2	2	2	2.0	0.0	0.0	2	2	0
fam15535	2	2	2	2.0	0.0	0.0	2	2	0
fam15536	2	2	2	2.0	0.0	0.0	2	2	0
fam15537	2	2	2	2.0	0.0	0.0	2	2	0
fam15538	2	2	2	2.0	0.0	0.0	2	2	0
fam15539	2	2	2	2.0	0.0	0.0	2	2	0
fam15540	2	2	2	2.0	0.0	0.0	2	2	0
fam15541	2	2	2	2.0	0.0	0.0	2	2	0
fam15542	2	2	2	2.0	0.0	0.0	2	2	0
fam15543	2	2	2	2.0	0.0	0.0	2	2	0
fam15544	2	2	2	2.0	0.0	0.0	2	2	0
fam15545	2	2	2	2.0	0.0	0.0	2	2	0
fam15546	2	2	2	2.0	0.0	0.0	2	2	0
fam15547	2	2	2	2.0	0.0	0.0	2	2	0
fam15548	2	2	2	2.0	0.0	0.0	2	2	0
fam15549	2	2	2	2.0	0.0	0.0	2	2	0
fam15550	2	2	2	2.0	0.0	0.0	2	2	0
fam15551	2	2	2	2.0	0.0	0.0	2	2	0
fam15552	2	2	2	2.0	0.0	0.0	2	2	0
fam15553	2	2	2	2.0	0.0	0.0	2	2	0
fam15554	2	2	2	2.0	0.0	0.0	2	2	0
fam15555	2	2	2	2.0	0.0	0.0	2	2	0
fam15556	2	2	2	2.0	0.0	0.0	2	2	0
fam15557	2	2	2	2.0	0.0	0.0	2	2	0
fam15558	2	2	2	2.0	0.0	0.0	2	2	0
fam15559	2	2	2	2.0	0.0	0.0	2	2	0
fam15560	2	2	2	2.0	0.0	0.0	2	2	0
fam15561	2	2	2	2.0	0.0	0.0	2	2	0
fam15562	2	2	2	2.0	0.0	0.0	2	2	0
fam15563	2	2	2	2.0	0.0	0.0	2	2	0
fam15564	2	2	2	2.0	0.0	0.0	2	2	0
fam15565	2	2	2	2.0	0.0	0.0	2	2	0
fam15566	2	2	2	2.0	0.0	0.0	2	2	0
fam15567	2	2	2	2.0	0.0	0.0	2	2	0
fam15568	2	2	2	2.0	0.0	0.0	2	2	0
fam15569	2	2	2	2.0	0.0	0.0	2	2	0
fam15570	2	2	2	2.0	0.0	0.0	2	2	0
fam15571	2	2	2	2.0	0.0	0.0	2	2	0
fam15572	2	2	2	2.0	0.0	0.0	2	2	0
fam15573	2	2	2	2.0	0.0	0.0	2	2	0
fam15574	2	2	2	2.0	0.0	0.0	2	2	0
fam15575	2	2	2	2.0	0.0	0.0	2	2	0
fam15576	2	2	2	2.0	0.0	0.0	2	2	0
fam15577	2	2	2	2.0	0.0	0.0	2	2	0
fam15578	2	2	2	2.0	0.0	0.0	2	2	0
fam15579	2	2	2	2.0	0.0	0.0	2	2	0
fam15580	2	2	2	2.0	0.0	0.0	2	2	0
fam15581	2	2	2	2.0	0.0	0.0	2	2	0
fam15582	2	2	2	2.0	0.0	0.0	2	2	0
fam15583	2	2	2	2.0	0.0	0.0	2	2	0
fam15584	2	2	2	2.0	0.0	0.0	2	2	0
fam15585	2	2	2	2.0	0.0	0.0	2	2	0
fam15586	2	2	2	2.0	0.0	0.0	2	2	0
fam15587	2	2	2	2.0	0.0	0.0	2	2	0
fam15588	2	2	2	2.0	0.0	0.0	2	2	0
fam15589	2	2	2	2.0	0.0	0.0	2	2	0
fam15590	2	2	2	2.0	0.0	0.0	2	2	0
fam15591	2	2	2	2.0	0.0	0.0	2	2	0
fam15592	2	2	2	2.0	0.0	0.0	2	2	0
fam15593	2	2	2	2.0	0.0	0.0	2	2	0
fam15594	2	2	2	2.0	0.0	0.0	2	2	0
fam15595	2	2	2	2.0	0.0	0.0	2	2	0
fam15596	2	2	2	2.0	0.0	0.0	2	2	0
fam15597	2	2	2	2.0	0.0	0.0	2	2	0
fam15598	2	2	2	2.0	0.0	0.0	2	2	0
fam15599	2	2	2	2.0	0.0	0.0	2	2	0
fam15600	2	2	2	2.0	0.0	0.0	2	2	0
fam15601	2	2	2	2.0	0.0	0.0	2	2	0
fam15602	2	2	2	2.0	0.0	0.0	2	2	0
fam15603	2	2	2	2.0	0.0	0.0	2	2	0
fam15604	2	2	2	2.0	0.0	0.0	2	2	0
fam15605	2	2	2	2.0	0.0	0.0	2	2	0
fam15606	2	2	2	2.0	0.0	0.0	2	2	0
fam15607	2	2	2	2.0	0.0	0.0	2	2	0
fam15608	2	2	2	2.0	0.0	0.0	2	2	0
fam15609	2	2	2	2.0	0.0	0.0	2	2	0
fam15610	2	2	2	2.0	0.0	0.0	2	2	0
fam15611	2	2	2	2.0	0.0	0.0	2	2	0
fam15612	2	2	2	2.0	0.0	0.0	2	2	0
fam15613	2	2	2	2.0	0.0	0.0	2	2	0
fam15614	2	2	2	2.0	0.0	0.0	2	2	0
fam15615	2	2	2	2.0	0.0	0.0	2	2	0
fam15616	2	2	2	2.0	0.0	0.0	2	2	0
fam15617	2	2	2	2.0	0.0	0.0	2	2	0
fam15618	2	2	2	2.0	0.0	0.0	2	2	0
fam15619	2	2	2	2.0	0.0	0.0	2	2	0
fam15620	2	2	2	2.0	0.0	0.0	2	2	0
fam15621	2	2	2	2.0	0.0	0.0	2	2	0
fam15622	2	2	2	2.0	0.0	0.0	2	2	0
fam15623	2	2	2	2.0	0.0	0.0	2	2	0
fam15624	2	2	2	2.0	0.0	0.0	2	2	0
fam15625	2	2	2	2.0	0.0	0.0	2	2	0
fam15626	2	2	2	2.0	0.0	0.0	2	2	0
fam15627	2	2	2	2.0	0.0	0.0	2	2	0
fam15628	2	2	2	2.0	0.0	0.0	2	2	0
fam15629	2	2	2	2.0	0.0	0.0	2	2	0
fam15630	2	2	2	2.0	0.0	0.0	2	2	0
fam15631	2	2	2	2.0	0.0	0.0	2	2	0
fam15632	2	2	2	2.0	0.0	0.0	2	2	0
fam15633	2	2	2	2.0	0.0	0.0	2	2	0
fam15634	2	2	2	2.0	0.0	0.0	2	2	0
fam15635	2	2	2	2.0	0.0	0.0	2	2	0
fam15636	2	2	2	2.0	0.0	0.0	2	2	0
fam15637	2	2	2	2.0	0.0	0.0	2	2	0
fam15638	2	2	2	2.0	0.0	0.0	2	2	0
fam15639	2	2	2	2.0	0.0	0.0	2	2	0
fam15640	2	2	2	2.0	0.0	0.0	2	2	0
fam15641	2	2	2	2.0	0.0	0.0	2	2	0
fam15642	2	2	2	2.0	0.0	0.0	2	2	0
fam15643	2	2	2	2.0	0.0	0.0	2	2	0
fam15644	2	2	2	2.0	0.0	0.0	2	2	0
fam15645	2	2	2	2.0	0.0	0.0	2	2	0
fam15646	2	2	2	2.0	0.0	0.0	2	2	0
fam15647	2	2	2	2.0	0.0	0.0	2	2	0
fam15648	2	2	2	2.0	0.0	0.0	2	2	0
fam15649	2	2	2	2.0	0.0	0.0	2	2	0
fam15650	2	2	2	2.0	0.0	0.0	2	2	0
fam15651	2	2	2	2.0	0.0	0.0	2	2	0
fam15652	2	2	2	2.0	0.0	0.0	2	2	0
fam15653	2	2	2	2.0	0.0	0.0	2	2	0
fam15654	2	2	2	2.0	0.0	0.0	2	2	0
fam15655	2	2	2	2.0	0.0	0.0	2	2	0
fam15656	2	2	2	2.0	0.0	0.0	2	2	0
fam15657	2	2	2	2.0	0.0	0.0	2	2	0
fam15658	2	2	2	2.0	0.0	0.0	2	2	0
fam15659	2	2	2	2.0	0.0	0.0	2	2	0
fam15660	2	2	2	2.0	0.0	0.0	2	2	0
fam15661	2	2	2	2.0	0.0	0.0	2	2	0
fam15662	2	2	2	2.0	0.0	0.0	2	2	0
fam15663	2	2	2	2.0	0.0	0.0	2	2	0
fam15664	2	2	2	2.0	0.0	0.0	2	2	0
fam15665	2	2	2	2.0	0.0	0.0	2	2	0
fam15666	2	2	2	2.0	0.0	0.0	2	2	0
fam15667	2	2	2	2.0	0.0	0.0	2	2	0
fam15668	2	2	2	2.0	0.0	0.0	2	2	0
fam15669	2	2	2	2.0	0.0	0.0	2	2	0
fam15670	2	2	2	2.0	0.0	0.0	2	2	0
fam15671	2	2	2	2.0	0.0	0.0	2	2	0
fam15672	2	2	2	2.0	0.0	0.0	2	2	0
fam15673	2	2	2	2.0	0.0	0.0	2	2	0
fam15674	2	2	2	2.0	0.0	0.0	2	2	0
fam15675	2	2	2	2.0	0.0	0.0	2	2	0
fam15676	2	2	2	2.0	0.0	0.0	2	2	0
fam15677	2	2	2	2.0	0.0	0.0	2	2	0
fam15678	2	2	2	2.0	0.0	0.0	2	2	0
fam15679	2	2	2	2.0	0.0	0.0	2	2	0
fam15680	2	2	2	2.0	0.0	0.0	2	2	0
fam15681	2	2	2	2.0	0.0	0.0	2	2	0
fam15682	2	2	2	2.0	0.0	0.0	2	2	0
fam15683	2	2	2	2.0	0.0	0.0	2	2	0
fam15684	2	2	2	2.0	0.0	0.0	2	2	0
fam15685	2	2	2	2.0	0.0	0.0	2	2	0
fam15686	2	2	2	2.0	0.0	0.0	2	2	0
fam15687	2	2	2	2.0	0.0	0.0	2	2	0
fam15688	2	2	2	2.0	0.0	0.0	2	2	0
fam15689	2	2	2	2.0	0.0	0.0	2	2	0
fam15690	2	2	2	2.0	0.0	0.0	2	2	0
fam15691	2	2	2	2.0	0.0	0.0	2	2	0
fam15692	2	2	2	2.0	0.0	0.0	2	2	0
fam15693	2	2	2	2.0	0.0	0.0	2	2	0
fam15694	2	2	2	2.0	0.0	0.0	2	2	0
fam15695	2	2	2	2.0	0.0	0.0	2	2	0
fam15696	2	2	2	2.0	0.0	0.0	2	2	0
fam15697	2	2	2	2.0	0.0	0.0	2	2	0
fam15698	2	2	2	2.0	0.0	0.0	2	2	0
fam15699	2	2	2	2.0	0.0	0.0	2	2	0
fam15700	2	2	2	2.0	0.0	0.0	2	2	0
fam15701	2	2	2	2.0	0.0	0.0	2	2	0
fam15702	2	2	2	2.0	0.0	0.0	2	2	0
fam15703	2	2	2	2.0	0.0	0.0	2	2	0
fam15704	2	2	2	2.0	0.0	0.0	2	2	0
fam15705	2	2	2	2.0	0.0	0.0	2	2	0
fam15706	2	2	2	2.0	0.0	0.0	2	2	0
fam15707	2	2	2	2.0	0.0	0.0	2	2	0
fam15708	2	2	2	2.0	0.0	0.0	2	2	0
fam15709	2	2	2	2.0	0.0	0.0	2	2	0
fam15710	2	2	2	2.0	0.0	0.0	2	2	0
fam15711	2	2	2	2.0	0.0	0.0	2	2	0
fam15712	2	2	2	2.0	0.0	0.0	2	2	0
fam15713	2	2	2	2.0	0.0	0.0	2	2	0
fam15714	2	2	2	2.0	0.0	0.0	2	2	0
fam15715	2	2	2	2.0	0.0	0.0	2	2	0
fam15716	2	2	2	2.0	0.0	0.0	2	2	0
fam15717	2	2	2	2.0	0.0	0.0	2	2	0
fam15718	2	2	2	2.0	0.0	0.0	2	2	0
fam15719	2	2	2	2.0	0.0	0.0	2	2	0
fam15720	2	2	2	2.0	0.0	0.0	2	2	0
fam15721	2	2	2	2.0	0.0	0.0	2	2	0
fam15722	2	2	2	2.0	0.0	0.0	2	2	0
fam15723	2	2	2	2.0	0.0	0.0	2	2	0
fam15724	2	2	2	2.0	0.0	0.0	2	2	0
fam15725	2	2	2	2.0	0.0	0.0	2	2	0
fam15726	2	2	2	2.0	0.0	0.0	2	2	0
fam15727	2	2	2	2.0	0.0	0.0	2	2	0
fam15728	2	2	2	2.0	0.0	0.0	2	2	0
fam15729	2	2	2	2.0	0.0	0.0	2	2	0
fam15730	2	2	2	2.0	0.0	0.0	2	2	0
fam15731	2	2	2	2.0	0.0	0.0	2	2	0
fam15732	2	2	2	2.0	0.0	0.0	2	2	0
fam15733	2	2	2	2.0	0.0	0.0	2	2	0
fam15734	2	2	2	2.0	0.0	0.0	2	2	0
fam15735	2	2	2	2.0	0.0	0.0	2	2	0
fam15736	2	2	2	2.0	0.0	0.0	2	2	0
fam15737	2	2	2	2.0	0.0	0.0	2	2	0
fam15738	2	2	2	2.0	0.0	0.0	2	2	0
fam15739	2	2	2	2.0	0.0	0.0	2	2	0
fam15740	2	2	2	2.0	0.0	0.0	2	2	0
fam15741	2	2	2	2.0	0.0	0.0	2	2	0
fam15742	2	2	2	2.0	0.0	0.0	2	2	0
fam15743	2	2	2	2.0	0.0	0.0	2	2	0
fam15744	2	2	2	2.0	0.0	0.0	2	2	0
fam15745	2	2	2	2.0	0.0	0.0	2	2	0
fam15746	2	2	2	2.0	0.0	0.0	2	2	0
fam15747	2	2	2	2.0	0.0	0.0	2	2	0
fam15748	2	2	2	2.0	0.0	0.0	2	2	0
fam15749	2	2	2	2.0	0.0	0.0	2	2	0
fam15750	2	2	2	2.0	0.0	0.0	2	2	0
fam15751	2	2	2	2.0	0.0	0.0	2	2	0
fam15752	2	2	2	2.0	0.0	0.0	2	2	0
fam15753	2	2	2	2.0	0.0	0.0	2	2	0
fam15754	2	2	2	2.0	0.0	0.0	2	2	0
fam15755	2	2	2	2.0	0.0	0.0	2	2	0
fam15756	2	2	2	2.0	0.0	0.0	2	2	0
fam15757	2	2	2	2.0	0.0	0.0	2	2	0
fam15758	2	2	2	2.0	0.0	0.0	2	2	0
fam15759	2	2	2	2.0	0.0	0.0	2	2	0
fam15760	2	2	2	2.0	0.0	0.0	2	2	0
fam15761	2	2	2	2.0	0.0	0.0	2	2	0
fam15762	2	2	2	2.0	0.0	0.0	2	2	0
fam15763	2	2	2	2.0	0.0	0.0	2	2	0
fam15764	2	2	2	2.0	0.0	0.0	2	2	0
fam15765	2	2	2	2.0	0.0	0.0	2	2	0
fam15766	2	2	2	2.0	0.0	0.0	2	2	0
fam15767	2	2	2	2.0	0.0	0.0	2	2	0
fam15768	2	2	2	2.0	0.0	0.0	2	2	0
fam15769	2	2	2	2.0	0.0	0.0	2	2	0
fam15770	2	2	2	2.0	0.0	0.0	2	2	0
fam15771	2	2	2	2.0	0.0	0.0	2	2	0
fam15772	2	2	2	2.0	0.0	0.0	2	2	0
fam15773	2	2	2	2.0	0.0	0.0	2	2	0
fam15774	2	2	2	2.0	0.0	0.0	2	2	0
fam15775	2	2	2	2.0	0.0	0.0	2	2	0
fam15776	2	2	2	2.0	0.0	0.0	2	2	0
fam15777	2	2	2	2.0	0.0	0.0	2	2	0
fam15778	2	2	2	2.0	0.0	0.0	2	2	0
fam15779	2	2	2	2.0	0.0	0.0	2	2	0
fam15780	2	2	2	2.0	0.0	0.0	2	2	0
fam15781	2	2	2	2.0	0.0	0.0	2	2	0
fam15782	2	2	2	2.0	0.0	0.0	2	2	0
fam15783	2	2	2	2.0	0.0	0.0	2	2	0
fam15784	2	2	2	2.0	0.0	0.0	2	2	0
fam15785	2	2	2	2.0	0.0	0.0	2	2	0
fam15786	2	2	2	2.0	0.0	0.0	2	2	0
fam15787	2	2	2	2.0	0.0	0.0	2	2	0
fam15788	2	2	2	2.0	0.0	0.0	2	2	0
fam15789	2	2	2	2.0	0.0	0.0	2	2	0
fam15790	2	2	2	2.0	0.0	0.0	2	2	0
fam15791	2	2	2	2.0	0.0	0.0	2	2	0
fam15792	2	2	2	2.0	0.0	0.0	2	2	0
fam15793	2	2	2	2.0	0.0	0.0	2	2	0
fam15794	2	2	2	2.0	0.0	0.0	2	2	0
fam15795	2	2	2	2.0	0.0	0.0	2	2	0
fam15796	2	2	2	2.0	0.0	0.0	2	2	0
fam15797	2	2	2	2.0	0.0	0.0	2	2	0
fam15798	2	2	2	2.0	0.0	0.0	2	2	0
fam15799	2	2	2	2.0	0.0	0.0	2	2	0
fam15800	2	2	2	2.0	0.0	0.0	2	2	0
fam15801	2	2	2	2.0	0.0	0.0	2	2	0
fam15802	2	2	2	2.0	0.0	0.0	2	2	0
fam15803	2	2	2	2.0	0.0	0.0	2	2	0
fam15804	2	2	2	2.0	0.0	0.0	2	2	0
fam15805	2	2	2	2.0	0.0	0.0	2	2	0
fam15806	2	2	2	2.0	0.0	0.0	2	2	0
fam15807	2	2	2	2.0	0.0	0.0	2	2	0
fam15808	2	2	2	2.0	0.0	0.0	2	2	0
fam15809	2	2	2	2.0	0.0	0.0	2	2	0
fam15810	2	2	2	2.0	0.0	0.0	2	2	0
fam15811	2	2	2	2.0	0.0	0.0	2	2	0
fam15812	2	2	2	2.0	0.0	0.0	2	2	0
fam15813	2	2	2	2.0	0.0	0.0	2	2	0
fam15814	2	2	2	2.0	0.0	0.0	2	2	0
fam15815	2	2	2	2.0	0.0	0.0	2	2	0
fam15816	2	2	2	2.0	0.0	0.0	2	2	0
fam15817	2	2	2	2.0	0.0	0.0	2	2	0
fam15818	2	2	2	2.0	0.0	0.0	2	2	0
fam15819	2	2	2	2.0	0.0	0.0	2	2	0
fam15820	2	2	2	2.0	0.0	0.0	2	2	0
fam15821	2	2	2	2.0	0.0	0.0	2	2	0
fam15822	2	2	2	2.0	0.0	0.0	2	2	0
fam15823	2	2	2	2.0	0.0	0.0	2	2	0
fam15824	2	2	2	2.0	0.0	0.0	2	2	0
fam15825	2	2	2	2.0	0.0	0.0	2	2	0
fam15826	2	2	2	2.0	0.0	0.0	2	2	0
fam15827	2	2	2	2.0	0.0	0.0	2	2	0
fam15828	2	2	2	2.0	0.0	0.0	2	2	0
fam15829	2	2	2	2.0	0.0	0.0	2	2	0
fam15830	2	2	2	2.0	0.0	0.0	2	2	0
fam15831	2	2	2	2.0	0.0	0.0	2	2	0
fam15832	2	2	2	2.0	0.0	0.0	2	2	0
fam15833	2	2	2	2.0	0.0	0.0	2	2	0
fam15834	2	2	2	2.0	0.0	0.0	2	2	0
fam15835	2	2	2	2.0	0.0	0.0	2	2	0
fam15836	2	2	2	2.0	0.0	0.0	2	2	0
fam15837	2	2	2	2.0	0.0	0.0	2	2	0
fam15838	2	2	2	2.0	0.0	0.0	2	2	0
fam15839	2	2	2	2.0	0.0	0.0	2	2	0
fam15840	2	2	2	2.0	0.0	0.0	2	2	0
fam15841	2	2	2	2.0	0.0	0.0	2	2	0
fam15842	2	2	2	2.0	0.0	0.0	2	2	0
fam15843	2	2	2	2.0	0.0	0.0	2	2	0
fam15844	2	2	2	2.0	0.0	0.0	2	2	0
fam15845	2	2	2	2.0	0.0	0.0	2	2	0
fam15846	2	2	2	2.0	0.0	0.0	2	2	0
fam15847	2	2	2	2.0	0.0	0.0	2	2	0
fam15848	2	2	2	2.0	0.0	0.0	2	2	0
fam15849	2	2	2	2.0	0.0	0.0	2	2	0
fam15850	2	2	2	2.0	0.0	0.0	2	2	0
fam15851	2	2	2	2.0	0.0	0.0	2	2	0
fam15852	2	2	2	2.0	0.0	0.0	2	2	0
fam15853	2	2	2	2.0	0.0	0.0	2	2	0
fam15854	2	2	2	2.0	0.0	0.0	2	2	0
fam15855	2	2	2	2.0	0.0	0.0	2	2	0
fam15856	2	2	2	2.0	0.0	0.0	2	2	0
fam15857	2	2	2	2.0	0.0	0.0	2	2	0
fam15858	2	2	2	2.0	0.0	0.0	2	2	0
fam15859	2	2	2	2.0	0.0	0.0	2	2	0
fam15860	2	2	2	2.0	0.0	0.0	2	2	0
fam15861	2	2	2	2.0	0.0	0.0	2	2	0
fam15862	2	2	2	2.0	0.0	0.0	2	2	0
fam15863	2	2	2	2.0	0.0	0.0	2	2	0
fam15864	2	2	2	2.0	0.0	0.0	2	2	0
fam15865	2	2	2	2.0	0.0	0.0	2	2	0
fam15866	2	2	2	2.0	0.0	0.0	2	2	0
fam15867	2	2	2	2.0	0.0	0.0	2	2	0
fam15868	2	2	2	2.0	0.0	0.0	2	2	0
fam15869	2	2	2	2.0	0.0	0.0	2	2	0
fam15870	2	2	2	2.0	0.0	0.0	2	2	0
fam15871	2	2	2	2.0	0.0	0.0	2	2	0
fam15872	2	2	2	2.0	0.0	0.0	2	2	0
fam15873	2	2	2	2.0	0.0	0.0	2	2	0
fam15874	2	2	2	2.0	0.0	0.0	2	2	0
fam15875	2	2	2	2.0	0.0	0.0	2	2	0
fam15876	2	2	2	2.0	0.0	0.0	2	2	0
fam15877	2	2	2	2.0	0.0	0.0	2	2	0
fam15878	2	2	2	2.0	0.0	0.0	2	2	0
fam15879	2	2	2	2.0	0.0	0.0	2	2	0
fam15880	2	2	2	2.0	0.0	0.0	2	2	0
fam15881	2	2	2	2.0	0.0	0.0	2	2	0
fam15882	2	2	2	2.0	0.0	0.0	2	2	0
fam15883	2	2	2	2.0	0.0	0.0	2	2	0
fam15884	2	2	2	2.0	0.0	0.0	2	2	0
fam15885	2	2	2	2.0	0.0	0.0	2	2	0
fam15886	2	2	2	2.0	0.0	0.0	2	2	0
fam15887	2	2	2	2.0	0.0	0.0	2	2	0
fam15888	2	2	2	2.0	0.0	0.0	2	2	0
fam15889	2	2	2	2.0	0.0	0.0	2	2	0
fam15890	2	2	2	2.0	0.0	0.0	2	2	0
fam15891	2	2	2	2.0	0.0	0.0	2	2	0
fam15892	2	2	2	2.0	0.0	0.0	2	2	0
fam15893	2	2	2	2.0	0.0	0.0	2	2	0
fam15894	2	2	2	2.0	0.0	0.0	2	2	0
fam15895	2	2	2	2.0	0.0	0.0	2	2	0
fam15896	2	2	2	2.0	0.0	0.0	2	2	0
fam15897	2	2	2	2.0	0.0	0.0	2	2	0
fam15898	2	2	2	2.0	0.0	0.0	2	2	0
fam15899	2	2	2	2.0	0.0	0.0	2	2	0
fam15900	2	2	2	2.0	0.0	0.0	2	2	0
fam15901	2	2	2	2.0	0.0	0.0	2	2	0
fam15902	2	2	2	2.0	0.0	0.0	2	2	0
fam15903	2	2	2	2.0	0.0	0.0	2	2	0
fam15904	2	2	2	2.0	0.0	0.0	2	2	0
fam15905	2	2	2	2.0	0.0	0.0	2	2	0
fam15906	2	2	2	2.0	0.0	0.0	2	2	0
fam15907	2	2	2	2.0	0.0	0.0	2	2	0
fam15908	2	2	2	2.0	0.0	0.0	2	2	0
fam15909	2	2	2	2.0	0.0	0.0	2	2	0
fam15910	2	2	2	2.0	0.0	0.0	2	2	0
fam15911	2	2	2	2.0	0.0	0.0	2	2	0
fam15912	2	2	2	2.0	0.0	0.0	2	2	0
fam15913	2	2	2	2.0	0.0	0.0	2	2	0
fam15914	2	2	2	2.0	0.0	0.0	2	2	0
fam15915	2	2	2	2.0	0.0	0.0	2	2	0
fam15916	2	2	2	2.0	0.0	0.0	2	2	0
fam15917	2	2	2	2.0	0.0	0.0	2	2	0
fam15918	2	2	2	2.0	0.0	0.0	2	2	0
fam15919	2	2	2	2.0	0.0	0.0	2	2	0
fam15920	2	2	2	2.0	0.0	0.0	2	2	0
fam15921	2	2	2	2.0	0.0	0.0	2	2	0
fam15922	2	2	2	2.0	0.0	0.0	2	2	0
fam15923	2	2	2	2.0	0.0	0.0	2	2	0
fam15924	2	2	2	2.0	0.0	0.0	2	2	0
fam15925	2	2	2	2.0	0.0	0.0	2	2	0
fam15926	2	2	2	2.0	0.0	0.0	2	2	0
fam15927	2	2	2	2.0	0.0	0.0	2	2	0
fam15928	2	2	2	2.0	0.0	0.0	2	2	0
fam15929	2	2	2	2.0	0.0	0.0	2	2	0
fam15930	2	2	2	2.0	0.0	0.0	2	2	0
fam15931	2	2	2	2.0	0.0	0.0	2	2	0
fam15932	2	2	2	2.0	0.0	0.0	2	2	0
fam15933	2	2	2	2.0	0.0	0.0	2	2	0
fam15934	2	2	2	2.0	0.0	0.0	2	2	0
fam15935	2	2	2	2.0	0.0	0.0	2	2	0
fam15936	2	2	2	2.0	0.0	0.0	2	2	0
fam15937	2	2	2	2.0	0.0	0.0	2	2	0
fam15938	2	2	2	2.0	0.0	0.0	2	2	0
fam15939	2	2	2	2.0	0.0	0.0	2	2	0
fam15940	2	2	2	2.0	0.0	0.0	2	2	0
fam15941	2	2	2	2.0	0.0	0.0	2	2	0
fam15942	2	2	2	2.0	0.0	0.0	2	2	0
fam15943	2	2	2	2.0	0.0	0.0	2	2	0
fam15944	2	2	2	2.0	0.0	0.0	2	2	0
fam15945	2	2	2	2.0	0.0	0.0	2	2	0
fam15946	2	2	2	2.0	0.0	0.0	2	2	0
fam15947	2	2	2	2.0	0.0	0.0	2	2	0
fam15948	2	2	2	2.0	0.0	0.0	2	2	0
fam15949	2	2	2	2.0	0.0	0.0	2	2	0
fam15950	2	2	2	2.0	0.0	0.0	2	2	0
fam15951	2	2	2	2.0	0.0	0.0	2	2	0
fam15952	2	2	2	2.0	0.0	0.0	2	2	0
fam15953	2	2	2	2.0	0.0	0.0	2	2	0
fam15954	2	2	2	2.0	0.0	0.0	2	2	0
fam15955	2	2	2	2.0	0.0	0.0	2	2	0
fam15956	2	2	2	2.0	0.0	0.0	2	2	0
fam15957	2	2	2	2.0	0.0	0.0	2	2	0
fam15958	2	2	2	2.0	0.0	0.0	2	2	0
fam15959	2	2	2	2.0	0.0	0.0	2	2	0
fam15960	2	2	2	2.0	0.0	0.0	2	2	0
fam15961	2	2	2	2.0	0.0	0.0	2	2	0
fam15962	2	2	2	2.0	0.0	0.0	2	2	0
fam15963	2	2	2	2.0	0.0	0.0	2	2	0
fam15964	2	2	2	2.0	0.0	0.0	2	2	0
fam15965	2	2	2	2.0	0.0	0.0	2	2	0
fam15966	2	2	2	2.0	0.0	0.0	2	2	0
fam15967	2	2	2	2.0	0.0	0.0	2	2	0
fam15968	2	2	2	2.0	0.0	0.0	2	2	0
fam15969	2	2	2	2.0	0.0	0.0	2	2	0
fam15970	2	2	2	2.0	0.0	0.0	2	2	0
fam15971	2	2	2	2.0	0.0	0.0	2	2	0
fam15972	2	2	2	2.0	0.0	0.0	2	2	0
fam15973	2	2	2	2.0	0.0	0.0	2	2	0
fam15974	2	2	2	2.0	0.0	0.0	2	2	0
fam15975	2	2	2	2.0	0.0	0.0	2	2	0
fam15976	2	2	2	2.0	0.0	0.0	2	2	0
fam15977	2	2	2	2.0	0.0	0.0	2	2	0
fam15978	2	2	2	2.0	0.0	0.0	2	2	0
fam15979	2	2	2	2.0	0.0	0.0	2	2	0
fam15980	2	2	2	2.0	0.0	0.0	2	2	0
fam15981	2	2	2	2.0	0.0	0.0	2	2	0
fam15982	2	2	2	2.0	0.0	0.0	2	2	0
fam15983	2	2	2	2.0	0.0	0.0	2	2	0
fam15984	2	2	2	2.0	0.0	0.0	2	2	0
fam15985	2	2	2	2.0	0.0	0.0	2	2	0
fam15986	2	2	2	2.0	0.0	0.0	2	2	0
fam15987	2	2	2	2.0	0.0	0.0	2	2	0
fam15988	2	2	2	2.0	0.0	0.0	2	2	0
fam15989	2	2	2	2.0	0.0	0.0	2	2	0
fam15990	2	2	2	2.0	0.0	0.0	2	2	0
fam15991	2	2	2	2.0	0.0	0.0	2	2	0
fam15992	2	2	2	2.0	0.0	0.0	2	2	0
fam15993	2	2	2	2.0	0.0	0.0	2	2	0
fam15994	2	2	2	2.0	0.0	0.0	2	2	0
fam15995	2	2	2	2.0	0.0	0.0	2	2	0
fam15996	2	2	2	2.0	0.0	0.0	2	2	0
fam15997	2	2	2	2.0	0.0	0.0	2	2	0
fam15998	2	2	2	2.0	0.0	0.0	2	2	0
fam15999	2	2	2	2.0	0.0	0.0	2	2	0
fam16000	2	2	2	2.0	0.0	0.0	2	2	0
fam16001	2	2	2	2.0	0.0	0.0	2	2	0
fam16002	2	2	2	2.0	0.0	0.0	2	2	0
fam16003	2	2	2	2.0	0.0	0.0	2	2	0
fam16004	2	2	2	2.0	0.0	0.0	2	2	0
fam16005	2	2	2	2.0	0.0	0.0	2	2	0
fam16006	2	2	2	2.0	0.0	0.0	2	2	0
fam16007	2	2	2	2.0	0.0	0.0	2	2	0
fam16008	2	2	2	2.0	0.0	0.0	2	2	0
fam16009	2	2	2	2.0	0.0	0.0	2	2	0
fam16010	2	2	2	2.0	0.0	0.0	2	2	0
fam16011	2	2	2	2.0	0.0	0.0	2	2	0
fam16012	2	2	2	2.0	0.0	0.0	2	2	0
fam16013	2	2	2	2.0	0.0	0.0	2	2	0
fam16014	2	2	2	2.0	0.0	0.0	2	2	0
fam16015	2	2	2	2.0	0.0	0.0	2	2	0
fam16016	2	2	2	2.0	0.0	0.0	2	2	0
fam16017	2	2	2	2.0	0.0	0.0	2	2	0
fam16018	2	2	2	2.0	0.0	0.0	2	2	0
fam16019	2	2	2	2.0	0.0	0.0	2	2	0
fam16020	2	2	2	2.0	0.0	0.0	2	2	0
fam16021	2	2	2	2.0	0.0	0.0	2	2	0
fam16022	2	2	2	2.0	0.0	0.0	2	2	0
fam16023	2	2	2	2.0	0.0	0.0	2	2	0
fam16024	2	2	2	2.0	0.0	0.0	2	2	0
fam16025	2	2	2	2.0	0.0	0.0	2	2	0
fam16026	2	2	2	2.0	0.0	0.0	2	2	0
fam16027	2	2	2	2.0	0.0	0.0	2	2	0
fam16028	2	2	2	2.0	0.0	0.0	2	2	0
fam16029	2	2	2	2.0	0.0	0.0	2	2	0
fam16030	2	2	2	2.0	0.0	0.0	2	2	0
fam16031	2	2	2	2.0	0.0	0.0	2	2	0
fam16032	2	2	2	2.0	0.0	0.0	2	2	0
fam16033	2	2	2	2.0	0.0	0.0	2	2	0
fam16034	2	2	2	2.0	0.0	0.0	2	2	0
fam16035	2	2	2	2.0	0.0	0.0	2	2	0
fam16036	2	2	2	2.0	0.0	0.0	2	2	0
fam16037	2	2	2	2.0	0.0	0.0	2	2	0
fam16038	2	2	2	2.0	0.0	0.0	2	2	0
fam16039	2	2	2	2.0	0.0	0.0	2	2	0
fam16040	2	2	2	2.0	0.0	0.0	2	2	0
fam16041	2	2	2	2.0	0.0	0.0	2	2	0
fam16042	2	2	2	2.0	0.0	0.0	2	2	0
fam16043	2	2	2	2.0	0.0	0.0	2	2	0
fam16044	2	2	2	2.0	0.0	0.0	2	2	0
fam16045	2	2	2	2.0	0.0	0.0	2	2	0
fam16046	2	2	2	2.0	0.0	0.0	2	2	0
fam16047	2	2	2	2.0	0.0	0.0	2	2	0
fam16048	2	2	2	2.0	0.0	0.0	2	2	0
fam16049	2	2	2	2.0	0.0	0.0	2	2	0
fam16050	2	2	2	2.0	0.0	0.0	2	2	0
fam16051	2	2	2	2.0	0.0	0.0	2	2	0
fam16052	2	2	2	2.0	0.0	0.0	2	2	0
fam16053	2	2	2	2.0	0.0	0.0	2	2	0
fam16054	2	2	2	2.0	0.0	0.0	2	2	0
fam16055	2	2	2	2.0	0.0	0.0	2	2	0
fam16056	2	2	2	2.0	0.0	0.0	2	2	0
fam16057	2	2	2	2.0	0.0	0.0	2	2	0
fam16058	2	2	2	2.0	0.0	0.0	2	2	0
fam16059	2	2	2	2.0	0.0	0.0	2	2	0
fam16060	2	2	2	2.0	0.0	0.0	2	2	0
fam16061	2	2	2	2.0	0.0	0.0	2	2	0
fam16062	2	2	2	2.0	0.0	0.0	2	2	0
fam16063	2	2	2	2.0	0.0	0.0	2	2	0
fam16064	2	2	2	2.0	0.0	0.0	2	2	0
fam16065	2	2	2	2.0	0.0	0.0	2	2	0
fam16066	2	2	2	2.0	0.0	0.0	2	2	0
fam16067	2	2	2	2.0	0.0	0.0	2	2	0
fam16068	2	2	2	2.0	0.0	0.0	2	2	0
fam16069	2	2	2	2.0	0.0	0.0	2	2	0
fam16070	2	2	2	2.0	0.0	0.0	2	2	0
fam16071	2	2	2	2.0	0.0	0.0	2	2	0
fam16072	2	2	2	2.0	0.0	0.0	2	2	0
fam16073	2	2	2	2.0	0.0	0.0	2	2	0
fam16074	2	2	2	2.0	0.0	0.0	2	2	0
fam16075	2	2	2	2.0	0.0	0.0	2	2	0
fam16076	2	2	2	2.0	0.0	0.0	2	2	0
fam16077	2	2	2	2.0	0.0	0.0	2	2	0
fam16078	2	2	2	2.0	0.0	0.0	2	2	0
fam16079	2	2	2	2.0	0.0	0.0	2	2	0
fam16080	2	2	2	2.0	0.0	0.0	2	2	0
fam16081	2	2	2	2.0	0.0	0.0	2	2	0
fam16082	2	2	2	2.0	0.0	0.0	2	2	0
fam16083	2	2	2	2.0	0.0	0.0	2	2	0
fam16084	2	2	2	2.0	0.0	0.0	2	2	0
fam16085	2	2	2	2.0	0.0	0.0	2	2	0
fam16086	2	2	2	2.0	0.0	0.0	2	2	0
fam16087	2	2	2	2.0	0.0	0.0	2	2	0
fam16088	2	2	2	2.0	0.0	0.0	2	2	0
fam16089	2	2	2	2.0	0.0	0.0	2	2	0
fam16090	2	2	2	2.0	0.0	0.0	2	2	0
fam16091	2	2	2	2.0	0.0	0.0	2	2	0
fam16092	2	2	2	2.0	0.0	0.0	2	2	0
fam16093	2	2	2	2.0	0.0	0.0	2	2	0
fam16094	2	2	2	2.0	0.0	0.0	2	2	0
fam16095	2	2	2	2.0	0.0	0.0	2	2	0
fam16096	2	2	2	2.0	0.0	0.0	2	2	0
fam16097	2	2	2	2.0	0.0	0.0	2	2	0
fam16098	2	2	2	2.0	0.0	0.0	2	2	0
fam16099	2	2	2	2.0	0.0	0.0	2	2	0
fam16100	2	2	2	2.0	0.0	0.0	2	2	0
fam16101	2	2	2	2.0	0.0	0.0	2	2	0
fam16102	2	2	2	2.0	0.0	0.0	2	2	0
fam16103	2	2	2	2.0	0.0	0.0	2	2	0
fam16104	2	2	2	2.0	0.0	0.0	2	2	0
fam16105	2	2	2	2.0	0.0	0.0	2	2	0
fam16106	2	2	2	2.0	0.0	0.0	2	2	0
fam16107	2	2	2	2.0	0.0	0.0	2	2	0
fam16108	2	2	2	2.0	0.0	0.0	2	2	0
fam16109	2	2	2	2.0	0.0	0.0	2	2	0
fam16110	2	2	2	2.0	0.0	0.0	2	2	0
fam16111	2	2	2	2.0	0.0	0.0	2	2	0
fam16112	2	2	2	2.0	0.0	0.0	2	2	0
fam16113	2	2	2	2.0	0.0	0.0	2	2	0
fam16114	2	2	2	2.0	0.0	0.0	2	2	0
fam16115	2	2	2	2.0	0.0	0.0	2	2	0
fam16116	2	2	2	2.0	0.0	0.0	2	2	0
fam16117	2	2	2	2.0	0.0	0.0	2	2	0
fam16118	2	2	2	2.0	0.0	0.0	2	2	0
fam16119	2	2	2	2.0	0.0	0.0	2	2	0
fam16120	2	2	2	2.0	0.0	0.0	2	2	0
fam16121	2	2	2	2.0	0.0	0.0	2	2	0
fam16122	2	2	2	2.0	0.0	0.0	2	2	0
fam16123	2	2	2	2.0	0.0	0.0	2	2	0
fam16124	2	2	2	2.0	0.0	0.0	2	2	0
fam16125	2	2	2	2.0	0.0	0.0	2	2	0
fam16126	2	2	2	2.0	0.0	0.0	2	2	0
fam16127	2	2	2	2.0	0.0	0.0	2	2	0
fam16128	2	2	2	2.0	0.0	0.0	2	2	0
fam16129	2	2	2	2.0	0.0	0.0	2	2	0
fam16130	2	2	2	2.0	0.0	0.0	2	2	0
fam16131	2	2	2	2.0	0.0	0.0	2	2	0
fam16132	2	2	2	2.0	0.0	0.0	2	2	0
fam16133	2	2	2	2.0	0.0	0.0	2	2	0
fam16134	2	2	2	2.0	0.0	0.0	2	2	0
fam16135	2	2	2	2.0	0.0	0.0	2	2	0
fam16136	2	2	2	2.0	0.0	0.0	2	2	0
fam16137	2	2	2	2.0	0.0	0.0	2	2	0
fam16138	2	2	2	2.0	0.0	0.0	2	2	0
fam16139	2	2	2	2.0	0.0	0.0	2	2	0
fam16140	2	2	2	2.0	0.0	0.0	2	2	0
fam16141	2	2	2	2.0	0.0	0.0	2	2	0
fam16142	2	2	2	2.0	0.0	0.0	2	2	0
fam16143	2	2	2	2.0	0.0	0.0	2	2	0
fam16144	2	2	2	2.0	0.0	0.0	2	2	0
fam16145	2	2	2	2.0	0.0	0.0	2	2	0
fam16146	2	2	2	2.0	0.0	0.0	2	2	0
fam16147	2	2	2	2.0	0.0	0.0	2	2	0
fam16148	2	2	2	2.0	0.0	0.0	2	2	0
fam16149	2	2	2	2.0	0.0	0.0	2	2	0
fam16150	2	2	2	2.0	0.0	0.0	2	2	0
fam16151	2	2	2	2.0	0.0	0.0	2	2	0
fam16152	2	2	2	2.0	0.0	0.0	2	2	0
fam16153	2	2	2	2.0	0.0	0.0	2	2	0
fam16154	2	2	2	2.0	0.0	0.0	2	2	0
fam16155	2	2	2	2.0	0.0	0.0	2	2	0
fam16156	2	2	2	2.0	0.0	0.0	2	2	0
fam16157	2	2	2	2.0	0.0	0.0	2	2	0
fam16158	2	2	2	2.0	0.0	0.0	2	2	0
fam16159	2	2	2	2.0	0.0	0.0	2	2	0
fam16160	2	2	2	2.0	0.0	0.0	2	2	0
fam16161	2	2	2	2.0	0.0	0.0	2	2	0
fam16162	2	2	2	2.0	0.0	0.0	2	2	0
fam16163	2	2	2	2.0	0.0	0.0	2	2	0
fam16164	2	2	2	2.0	0.0	0.0	2	2	0
fam16165	2	2	2	2.0	0.0	0.0	2	2	0
fam16166	2	2	2	2.0	0.0	0.0	2	2	0
fam16167	2	2	2	2.0	0.0	0.0	2	2	0
fam16168	2	2	2	2.0	0.0	0.0	2	2	0
fam16169	2	2	2	2.0	0.0	0.0	2	2	0
fam16170	2	2	2	2.0	0.0	0.0	2	2	0
fam16171	2	2	2	2.0	0.0	0.0	2	2	0
fam16172	2	2	2	2.0	0.0	0.0	2	2	0
fam16173	2	2	2	2.0	0.0	0.0	2	2	0
fam16174	2	2	2	2.0	0.0	0.0	2	2	0
fam16175	2	2	2	2.0	0.0	0.0	2	2	0
fam16176	2	2	2	2.0	0.0	0.0	2	2	0
fam16177	2	2	2	2.0	0.0	0.0	2	2	0
fam16178	2	2	2	2.0	0.0	0.0	2	2	0
fam16179	2	2	2	2.0	0.0	0.0	2	2	0
fam16180	2	2	2	2.0	0.0	0.0	2	2	0
fam16181	2	2	2	2.0	0.0	0.0	2	2	0
fam16182	2	2	2	2.0	0.0	0.0	2	2	0
fam16183	2	2	2	2.0	0.0	0.0	2	2	0
fam16184	2	2	2	2.0	0.0	0.0	2	2	0
fam16185	2	2	2	2.0	0.0	0.0	2	2	0
fam16186	2	2	2	2.0	0.0	0.0	2	2	0
fam16187	2	2	2	2.0	0.0	0.0	2	2	0
fam16188	2	2	2	2.0	0.0	0.0	2	2	0
fam16189	2	2	2	2.0	0.0	0.0	2	2	0
fam16190	2	2	2	2.0	0.0	0.0	2	2	0
fam16191	2	2	2	2.0	0.0	0.0	2	2	0
fam16192	2	2	2	2.0	0.0	0.0	2	2	0
fam16193	2	2	2	2.0	0.0	0.0	2	2	0
fam16194	2	2	2	2.0	0.0	0.0	2	2	0
fam16195	2	2	2	2.0	0.0	0.0	2	2	0
fam16196	2	2	2	2.0	0.0	0.0	2	2	0
fam16197	2	2	2	2.0	0.0	0.0	2	2	0
fam16198	2	2	2	2.0	0.0	0.0	2	2	0
fam16199	2	2	2	2.0	0.0	0.0	2	2	0
fam16200	2	2	2	2.0	0.0	0.0	2	2	0
fam16201	2	2	2	2.0	0.0	0.0	2	2	0
fam16202	2	2	2	2.0	0.0	0.0	2	2	0
fam16203	2	2	2	2.0	0.0	0.0	2	2	0
fam16204	2	2	2	2.0	0.0	0.0	2	2	0
fam16205	2	2	2	2.0	0.0	0.0	2	2	0
fam16206	2	2	2	2.0	0.0	0.0	2	2	0
fam16207	2	2	2	2.0	0.0	0.0	2	2	0
fam16208	2	2	2	2.0	0.0	0.0	2	2	0
fam16209	2	2	2	2.0	0.0	0.0	2	2	0
fam16210	2	2	2	2.0	0.0	0.0	2	2	0
fam16211	2	2	2	2.0	0.0	0.0	2	2	0
fam16212	2	2	2	2.0	0.0	0.0	2	2	0
fam16213	2	2	2	2.0	0.0	0.0	2	2	0
fam16214	2	2	2	2.0	0.0	0.0	2	2	0
fam16215	2	2	2	2.0	0.0	0.0	2	2	0
fam16216	2	2	2	2.0	0.0	0.0	2	2	0
fam16217	2	2	2	2.0	0.0	0.0	2	2	0
fam16218	2	2	2	2.0	0.0	0.0	2	2	0
fam16219	2	2	2	2.0	0.0	0.0	2	2	0
fam16220	2	2	2	2.0	0.0	0.0	2	2	0
fam16221	2	2	2	2.0	0.0	0.0	2	2	0
fam16222	2	2	2	2.0	0.0	0.0	2	2	0
fam16223	2	2	2	2.0	0.0	0.0	2	2	0
fam16224	2	2	2	2.0	0.0	0.0	2	2	0
fam16225	2	2	2	2.0	0.0	0.0	2	2	0
fam16226	2	2	2	2.0	0.0	0.0	2	2	0
fam16227	2	2	2	2.0	0.0	0.0	2	2	0
fam16228	2	2	2	2.0	0.0	0.0	2	2	0
fam16229	2	2	2	2.0	0.0	0.0	2	2	0
fam16230	2	2	2	2.0	0.0	0.0	2	2	0
fam16231	2	2	2	2.0	0.0	0.0	2	2	0
fam16232	2	2	2	2.0	0.0	0.0	2	2	0
fam16233	2	2	2	2.0	0.0	0.0	2	2	0
fam16234	2	2	2	2.0	0.0	0.0	2	2	0
fam16235	2	2	2	2.0	0.0	0.0	2	2	0
fam16236	2	2	2	2.0	0.0	0.0	2	2	0
fam16237	2	2	2	2.0	0.0	0.0	2	2	0
fam16238	2	2	2	2.0	0.0	0.0	2	2	0
fam16239	2	2	2	2.0	0.0	0.0	2	2	0
fam16240	2	2	2	2.0	0.0	0.0	2	2	0
fam16241	2	2	2	2.0	0.0	0.0	2	2	0
fam16242	2	2	2	2.0	0.0	0.0	2	2	0
fam16243	2	2	2	2.0	0.0	0.0	2	2	0
fam16244	2	2	2	2.0	0.0	0.0	2	2	0
fam16245	2	2	2	2.0	0.0	0.0	2	2	0
fam16246	2	2	2	2.0	0.0	0.0	2	2	0
fam16247	2	2	2	2.0	0.0	0.0	2	2	0
fam16248	2	2	2	2.0	0.0	0.0	2	2	0
fam16249	2	2	2	2.0	0.0	0.0	2	2	0
fam16250	2	2	2	2.0	0.0	0.0	2	2	0
fam16251	2	2	2	2.0	0.0	0.0	2	2	0
fam16252	2	2	2	2.0	0.0	0.0	2	2	0
fam16253	2	2	2	2.0	0.0	0.0	2	2	0
fam16254	2	2	2	2.0	0.0	0.0	2	2	0
fam16255	2	2	2	2.0	0.0	0.0	2	2	0
fam16256	2	2	2	2.0	0.0	0.0	2	2	0
fam16257	2	2	2	2.0	0.0	0.0	2	2	0
fam16258	2	2	2	2.0	0.0	0.0	2	2	0
fam16259	2	2	2	2.0	0.0	0.0	2	2	0
fam16260	2	2	2	2.0	0.0	0.0	2	2	0
fam16261	2	2	2	2.0	0.0	0.0	2	2	0
fam16262	2	2	2	2.0	0.0	0.0	2	2	0
fam16263	2	2	2	2.0	0.0	0.0	2	2	0
fam16264	2	2	2	2.0	0.0	0.0	2	2	0
fam16265	2	2	2	2.0	0.0	0.0	2	2	0
fam16266	2	2	2	2.0	0.0	0.0	2	2	0
fam16267	2	2	2	2.0	0.0	0.0	2	2	0
fam16268	2	2	2	2.0	0.0	0.0	2	2	0
fam16269	2	2	2	2.0	0.0	0.0	2	2	0
fam16270	2	2	2	2.0	0.0	0.0	2	2	0
fam16271	2	2	2	2.0	0.0	0.0	2	2	0
fam16272	2	2	2	2.0	0.0	0.0	2	2	0
fam16273	2	2	2	2.0	0.0	0.0	2	2	0
fam16274	2	2	2	2.0	0.0	0.0	2	2	0
fam16275	2	2	2	2.0	0.0	0.0	2	2	0
fam16276	2	2	2	2.0	0.0	0.0	2	2	0
fam16277	2	2	2	2.0	0.0	0.0	2	2	0
fam16278	2	2	2	2.0	0.0	0.0	2	2	0
fam16279	2	2	2	2.0	0.0	0.0	2	2	0
fam16280	2	2	2	2.0	0.0	0.0	2	2	0
fam16281	2	2	2	2.0	0.0	0.0	2	2	0
fam16282	2	2	2	2.0	0.0	0.0	2	2	0
fam16283	2	2	2	2.0	0.0	0.0	2	2	0
fam16284	2	2	2	2.0	0.0	0.0	2	2	0
fam16285	2	2	2	2.0	0.0	0.0	2	2	0
fam16286	2	2	2	2.0	0.0	0.0	2	2	0
fam16287	2	2	2	2.0	0.0	0.0	2	2	0
fam16288	2	2	2	2.0	0.0	0.0	2	2	0
fam16289	2	2	2	2.0	0.0	0.0	2	2	0
fam16290	2	2	2	2.0	0.0	0.0	2	2	0
fam16291	2	2	2	2.0	0.0	0.0	2	2	0
fam16292	2	2	2	2.0	0.0	0.0	2	2	0
fam16293	2	2	2	2.0	0.0	0.0	2	2	0
fam16294	2	2	2	2.0	0.0	0.0	2	2	0
fam16295	2	2	2	2.0	0.0	0.0	2	2	0
fam16296	2	2	2	2.0	0.0	0.0	2	2	0
fam16297	2	2	2	2.0	0.0	0.0	2	2	0
fam16298	2	2	2	2.0	0.0	0.0	2	2	0
fam16299	2	2	2	2.0	0.0	0.0	2	2	0
fam16300	2	2	2	2.0	0.0	0.0	2	2	0
fam16301	2	2	2	2.0	0.0	0.0	2	2	0
fam16302	2	2	2	2.0	0.0	0.0	2	2	0
fam16303	2	2	2	2.0	0.0	0.0	2	2	0
fam16304	2	2	2	2.0	0.0	0.0	2	2	0
fam16305	2	2	2	2.0	0.0	0.0	2	2	0
fam16306	2	2	2	2.0	0.0	0.0	2	2	0
fam16307	2	2	2	2.0	0.0	0.0	2	2	0
fam16308	2	2	2	2.0	0.0	0.0	2	2	0
fam16309	2	2	2	2.0	0.0	0.0	2	2	0
fam16310	2	2	2	2.0	0.0	0.0	2	2	0
fam16311	2	2	2	2.0	0.0	0.0	2	2	0
fam16312	2	2	2	2.0	0.0	0.0	2	2	0
fam16313	2	2	2	2.0	0.0	0.0	2	2	0
fam16314	2	2	2	2.0	0.0	0.0	2	2	0
fam16315	2	2	2	2.0	0.0	0.0	2	2	0
fam16316	2	2	2	2.0	0.0	0.0	2	2	0
fam16317	2	2	2	2.0	0.0	0.0	2	2	0
fam16318	2	2	2	2.0	0.0	0.0	2	2	0
fam16319	2	2	2	2.0	0.0	0.0	2	2	0
fam16320	2	2	2	2.0	0.0	0.0	2	2	0
fam16321	2	2	2	2.0	0.0	0.0	2	2	0
fam16322	2	2	2	2.0	0.0	0.0	2	2	0
fam16323	2	2	2	2.0	0.0	0.0	2	2	0
fam16324	2	2	2	2.0	0.0	0.0	2	2	0
fam16325	2	2	2	2.0	0.0	0.0	2	2	0
fam16326	2	2	2	2.0	0.0	0.0	2	2	0
fam16327	2	2	2	2.0	0.0	0.0	2	2	0
fam16328	2	2	2	2.0	0.0	0.0	2	2	0
fam16329	2	2	2	2.0	0.0	0.0	2	2	0
fam16330	2	2	2	2.0	0.0	0.0	2	2	0
fam16331	2	2	2	2.0	0.0	0.0	2	2	0
fam16332	2	2	2	2.0	0.0	0.0	2	2	0
fam16333	2	2	2	2.0	0.0	0.0	2	2	0
fam16334	2	2	2	2.0	0.0	0.0	2	2	0
fam16335	2	2	2	2.0	0.0	0.0	2	2	0
fam16336	2	2	2	2.0	0.0	0.0	2	2	0
fam16337	2	2	2	2.0	0.0	0.0	2	2	0
fam16338	2	2	2	2.0	0.0	0.0	2	2	0
fam16339	2	2	2	2.0	0.0	0.0	2	2	0
fam16340	2	2	2	2.0	0.0	0.0	2	2	0
fam16341	2	2	2	2.0	0.0	0.0	2	2	0
fam16342	2	2	2	2.0	0.0	0.0	2	2	0
fam16343	2	2	2	2.0	0.0	0.0	2	2	0
fam16344	2	2	2	2.0	0.0	0.0	2	2	0
fam16345	2	2	2	2.0	0.0	0.0	2	2	0
fam16346	2	2	2	2.0	0.0	0.0	2	2	0
fam16347	2	2	2	2.0	0.0	0.0	2	2	0
fam16348	2	2	2	2.0	0.0	0.0	2	2	0
fam16349	2	2	2	2.0	0.0	0.0	2	2	0
fam16350	2	2	2	2.0	0.0	0.0	2	2	0
fam16351	2	2	2	2.0	0.0	0.0	2	2	0
fam16352	2	2	2	2.0	0.0	0.0	2	2	0
fam16353	2	2	2	2.0	0.0	0.0	2	2	0
fam16354	2	2	2	2.0	0.0	0.0	2	2	0
fam16355	2	2	2	2.0	0.0	0.0	2	2	0
fam16356	2	2	2	2.0	0.0	0.0	2	2	0
fam16357	2	2	2	2.0	0.0	0.0	2	2	0
fam16358	2	2	2	2.0	0.0	0.0	2	2	0
fam16359	2	2	2	2.0	0.0	0.0	2	2	0
fam16360	2	2	2	2.0	0.0	0.0	2	2	0
fam16361	2	2	2	2.0	0.0	0.0	2	2	0
fam16362	2	2	2	2.0	0.0	0.0	2	2	0
fam16363	2	2	2	2.0	0.0	0.0	2	2	0
fam16364	2	2	2	2.0	0.0	0.0	2	2	0
fam16365	2	2	2	2.0	0.0	0.0	2	2	0
fam16366	2	2	2	2.0	0.0	0.0	2	2	0
fam16367	2	2	2	2.0	0.0	0.0	2	2	0
fam16368	2	2	2	2.0	0.0	0.0	2	2	0
fam16369	2	2	2	2.0	0.0	0.0	2	2	0
fam16370	2	2	2	2.0	0.0	0.0	2	2	0
fam16371	2	2	2	2.0	0.0	0.0	2	2	0
fam16372	2	2	2	2.0	0.0	0.0	2	2	0
fam16373	2	2	2	2.0	0.0	0.0	2	2	0
fam16374	2	2	2	2.0	0.0	0.0	2	2	0
fam16375	2	2	2	2.0	0.0	0.0	2	2	0
fam16376	2	2	2	2.0	0.0	0.0	2	2	0
fam16377	2	2	2	2.0	0.0	0.0	2	2	0
fam16378	2	2	2	2.0	0.0	0.0	2	2	0
fam16379	2	2	2	2.0	0.0	0.0	2	2	0
fam16380	2	2	2	2.0	0.0	0.0	2	2	0
fam16381	2	2	2	2.0	0.0	0.0	2	2	0
fam16382	2	2	2	2.0	0.0	0.0	2	2	0
fam16383	2	2	2	2.0	0.0	0.0	2	2	0
fam16384	2	2	2	2.0	0.0	0.0	2	2	0
fam16385	2	2	2	2.0	0.0	0.0	2	2	0
fam16386	2	2	2	2.0	0.0	0.0	2	2	0
fam16387	2	2	2	2.0	0.0	0.0	2	2	0
fam16388	2	2	2	2.0	0.0	0.0	2	2	0
fam16389	2	2	2	2.0	0.0	0.0	2	2	0
fam16390	2	2	2	2.0	0.0	0.0	2	2	0
fam16391	2	2	2	2.0	0.0	0.0	2	2	0
fam16392	2	2	2	2.0	0.0	0.0	2	2	0
fam16393	2	2	2	2.0	0.0	0.0	2	2	0
fam16394	2	2	2	2.0	0.0	0.0	2	2	0
fam16395	2	2	2	2.0	0.0	0.0	2	2	0
fam16396	2	2	2	2.0	0.0	0.0	2	2	0
fam16397	2	2	2	2.0	0.0	0.0	2	2	0
fam16398	2	2	2	2.0	0.0	0.0	2	2	0
fam16399	2	2	2	2.0	0.0	0.0	2	2	0
fam16400	2	2	2	2.0	0.0	0.0	2	2	0
fam16401	2	2	2	2.0	0.0	0.0	2	2	0
fam16402	2	2	2	2.0	0.0	0.0	2	2	0
fam16403	2	2	2	2.0	0.0	0.0	2	2	0
fam16404	2	2	2	2.0	0.0	0.0	2	2	0
fam16405	2	2	2	2.0	0.0	0.0	2	2	0
fam16406	2	2	2	2.0	0.0	0.0	2	2	0
fam16407	2	2	2	2.0	0.0	0.0	2	2	0
fam16408	2	2	2	2.0	0.0	0.0	2	2	0
fam16409	2	2	2	2.0	0.0	0.0	2	2	0
fam16410	2	2	2	2.0	0.0	0.0	2	2	0
fam16411	2	2	2	2.0	0.0	0.0	2	2	0
fam16412	2	2	2	2.0	0.0	0.0	2	2	0
fam16413	2	2	2	2.0	0.0	0.0	2	2	0
fam16414	2	2	2	2.0	0.0	0.0	2	2	0
fam16415	2	2	2	2.0	0.0	0.0	2	2	0
fam16416	2	2	2	2.0	0.0	0.0	2	2	0
fam16417	2	2	2	2.0	0.0	0.0	2	2	0
fam16418	2	2	2	2.0	0.0	0.0	2	2	0
fam16419	2	2	2	2.0	0.0	0.0	2	2	0
fam16420	2	2	2	2.0	0.0	0.0	2	2	0
fam16421	2	2	2	2.0	0.0	0.0	2	2	0
fam16422	2	2	2	2.0	0.0	0.0	2	2	0
fam16423	2	2	2	2.0	0.0	0.0	2	2	0
fam16424	2	2	2	2.0	0.0	0.0	2	2	0
fam16425	2	2	2	2.0	0.0	0.0	2	2	0
fam16426	2	2	2	2.0	0.0	0.0	2	2	0
fam16427	2	2	2	2.0	0.0	0.0	2	2	0
fam16428	2	2	2	2.0	0.0	0.0	2	2	0
fam16429	2	2	2	2.0	0.0	0.0	2	2	0
fam16430	2	2	2	2.0	0.0	0.0	2	2	0
fam16431	2	2	2	2.0	0.0	0.0	2	2	0
fam16432	2	2	2	2.0	0.0	0.0	2	2	0
fam16433	2	2	2	2.0	0.0	0.0	2	2	0
fam16434	2	2	2	2.0	0.0	0.0	2	2	0
fam16435	2	2	2	2.0	0.0	0.0	2	2	0
fam16436	2	2	2	2.0	0.0	0.0	2	2	0
fam16437	2	2	2	2.0	0.0	0.0	2	2	0
fam16438	2	2	2	2.0	0.0	0.0	2	2	0
fam16439	2	2	2	2.0	0.0	0.0	2	2	0
fam16440	2	2	2	2.0	0.0	0.0	2	2	0
fam16441	2	2	2	2.0	0.0	0.0	2	2	0
fam16442	2	2	2	2.0	0.0	0.0	2	2	0
fam16443	2	2	2	2.0	0.0	0.0	2	2	0
fam16444	2	2	2	2.0	0.0	0.0	2	2	0
fam16445	2	2	2	2.0	0.0	0.0	2	2	0
fam16446	2	2	2	2.0	0.0	0.0	2	2	0
fam16447	2	2	2	2.0	0.0	0.0	2	2	0
fam16448	2	2	2	2.0	0.0	0.0	2	2	0
fam16449	2	2	2	2.0	0.0	0.0	2	2	0
fam16450	2	2	2	2.0	0.0	0.0	2	2	0
fam16451	2	2	2	2.0	0.0	0.0	2	2	0
fam16452	2	2	2	2.0	0.0	0.0	2	2	0
fam16453	2	2	2	2.0	0.0	0.0	2	2	0
fam16454	2	2	2	2.0	0.0	0.0	2	2	0
fam16455	2	2	2	2.0	0.0	0.0	2	2	0
fam16456	2	2	2	2.0	0.0	0.0	2	2	0
fam16457	2	2	2	2.0	0.0	0.0	2	2	0
fam16458	2	2	2	2.0	0.0	0.0	2	2	0
fam16459	2	2	2	2.0	0.0	0.0	2	2	0
fam16460	2	2	2	2.0	0.0	0.0	2	2	0
fam16461	2	2	2	2.0	0.0	0.0	2	2	0
fam16462	2	2	2	2.0	0.0	0.0	2	2	0
fam16463	2	2	2	2.0	0.0	0.0	2	2	0
fam16464	2	2	2	2.0	0.0	0.0	2	2	0
fam16465	2	2	2	2.0	0.0	0.0	2	2	0
fam16466	2	2	2	2.0	0.0	0.0	2	2	0
fam16467	2	2	2	2.0	0.0	0.0	2	2	0
fam16468	2	2	2	2.0	0.0	0.0	2	2	0
fam16469	2	2	2	2.0	0.0	0.0	2	2	0
fam16470	2	2	2	2.0	0.0	0.0	2	2	0
fam16471	2	2	2	2.0	0.0	0.0	2	2	0
fam16472	2	2	2	2.0	0.0	0.0	2	2	0
fam16473	2	2	2	2.0	0.0	0.0	2	2	0
fam16474	2	2	2	2.0	0.0	0.0	2	2	0
fam16475	2	2	2	2.0	0.0	0.0	2	2	0
fam16476	2	2	2	2.0	0.0	0.0	2	2	0
fam16477	2	2	2	2.0	0.0	0.0	2	2	0
fam16478	2	2	2	2.0	0.0	0.0	2	2	0
fam16479	2	2	2	2.0	0.0	0.0	2	2	0
fam16480	2	2	2	2.0	0.0	0.0	2	2	0
fam16481	2	2	2	2.0	0.0	0.0	2	2	0
fam16482	2	2	2	2.0	0.0	0.0	2	2	0
fam16483	2	2	2	2.0	0.0	0.0	2	2	0
fam16484	2	2	2	2.0	0.0	0.0	2	2	0
fam16485	2	2	2	2.0	0.0	0.0	2	2	0
fam16486	2	2	2	2.0	0.0	0.0	2	2	0
fam16487	2	2	2	2.0	0.0	0.0	2	2	0
fam16488	2	2	2	2.0	0.0	0.0	2	2	0
fam16489	2	2	2	2.0	0.0	0.0	2	2	0
fam16490	2	2	2	2.0	0.0	0.0	2	2	0
fam16491	2	2	2	2.0	0.0	0.0	2	2	0
fam16492	2	2	2	2.0	0.0	0.0	2	2	0
fam16493	2	2	2	2.0	0.0	0.0	2	2	0
fam16494	2	2	2	2.0	0.0	0.0	2	2	0
fam16495	2	2	2	2.0	0.0	0.0	2	2	0
fam16496	2	2	2	2.0	0.0	0.0	2	2	0
fam16497	2	2	2	2.0	0.0	0.0	2	2	0
fam16498	2	2	2	2.0	0.0	0.0	2	2	0
fam16499	2	2	2	2.0	0.0	0.0	2	2	0
fam16500	2	2	2	2.0	0.0	0.0	2	2	0
fam16501	2	2	2	2.0	0.0	0.0	2	2	0
fam16502	2	2	2	2.0	0.0	0.0	2	2	0
fam16503	2	2	2	2.0	0.0	0.0	2	2	0
fam16504	2	2	2	2.0	0.0	0.0	2	2	0
fam16505	2	2	2	2.0	0.0	0.0	2	2	0
fam16506	2	2	2	2.0	0.0	0.0	2	2	0
fam16507	2	2	2	2.0	0.0	0.0	2	2	0
fam16508	2	2	2	2.0	0.0	0.0	2	2	0
fam16509	2	2	2	2.0	0.0	0.0	2	2	0
fam16510	2	2	2	2.0	0.0	0.0	2	2	0
fam16511	2	2	2	2.0	0.0	0.0	2	2	0
fam16512	2	2	2	2.0	0.0	0.0	2	2	0
fam16513	2	2	2	2.0	0.0	0.0	2	2	0
fam16514	2	2	2	2.0	0.0	0.0	2	2	0
fam16515	2	2	2	2.0	0.0	0.0	2	2	0
fam16516	2	2	2	2.0	0.0	0.0	2	2	0
fam16517	2	2	2	2.0	0.0	0.0	2	2	0
fam16518	2	2	2	2.0	0.0	0.0	2	2	0
fam16519	2	2	2	2.0	0.0	0.0	2	2	0
fam16520	2	2	2	2.0	0.0	0.0	2	2	0
fam16521	2	2	2	2.0	0.0	0.0	2	2	0
fam16522	2	2	2	2.0	0.0	0.0	2	2	0
fam16523	2	2	2	2.0	0.0	0.0	2	2	0
fam16524	2	2	2	2.0	0.0	0.0	2	2	0
fam16525	2	2	2	2.0	0.0	0.0	2	2	0
fam16526	2	2	2	2.0	0.0	0.0	2	2	0
fam16527	2	2	2	2.0	0.0	0.0	2	2	0
fam16528	2	2	2	2.0	0.0	0.0	2	2	0
fam16529	2	2	2	2.0	0.0	0.0	2	2	0
fam16530	2	2	2	2.0	0.0	0.0	2	2	0
fam16531	2	2	2	2.0	0.0	0.0	2	2	0
fam16532	2	2	2	2.0	0.0	0.0	2	2	0
fam16533	2	2	2	2.0	0.0	0.0	2	2	0
fam16534	2	2	2	2.0	0.0	0.0	2	2	0
fam16535	2	2	2	2.0	0.0	0.0	2	2	0
fam16536	2	2	2	2.0	0.0	0.0	2	2	0
fam16537	2	2	2	2.0	0.0	0.0	2	2	0
fam16538	2	2	2	2.0	0.0	0.0	2	2	0
fam16539	2	2	2	2.0	0.0	0.0	2	2	0
fam16540	2	2	2	2.0	0.0	0.0	2	2	0
fam16541	2	2	2	2.0	0.0	0.0	2	2	0
fam16542	2	2	2	2.0	0.0	0.0	2	2	0
fam16543	2	2	2	2.0	0.0	0.0	2	2	0
fam16544	2	2	2	2.0	0.0	0.0	2	2	0
fam16545	2	2	2	2.0	0.0	0.0	2	2	0
fam16546	2	2	2	2.0	0.0	0.0	2	2	0
fam16547	2	2	2	2.0	0.0	0.0	2	2	0
fam16548	2	2	2	2.0	0.0	0.0	2	2	0
fam16549	2	2	2	2.0	0.0	0.0	2	2	0
fam16550	2	2	2	2.0	0.0	0.0	2	2	0
fam16551	2	2	2	2.0	0.0	0.0	2	2	0
fam16552	2	2	2	2.0	0.0	0.0	2	2	0
fam16553	2	2	2	2.0	0.0	0.0	2	2	0
fam16554	2	2	2	2.0	0.0	0.0	2	2	0
fam16555	2	2	2	2.0	0.0	0.0	2	2	0
fam16556	2	2	2	2.0	0.0	0.0	2	2	0
fam16557	2	2	2	2.0	0.0	0.0	2	2	0
fam16558	2	2	2	2.0	0.0	0.0	2	2	0
fam16559	2	2	2	2.0	0.0	0.0	2	2	0
fam16560	2	2	2	2.0	0.0	0.0	2	2	0
fam16561	2	2	2	2.0	0.0	0.0	2	2	0
fam16562	2	2	2	2.0	0.0	0.0	2	2	0
fam16563	2	2	2	2.0	0.0	0.0	2	2	0
fam16564	2	2	2	2.0	0.0	0.0	2	2	0
fam16565	2	2	2	2.0	0.0	0.0	2	2	0
fam16566	2	2	2	2.0	0.0	0.0	2	2	0
fam16567	2	2	2	2.0	0.0	0.0	2	2	0
fam16568	2	2	2	2.0	0.0	0.0	2	2	0
fam16569	2	2	2	2.0	0.0	0.0	2	2	0
fam16570	2	2	2	2.0	0.0	0.0	2	2	0
fam16571	2	2	2	2.0	0.0	0.0	2	2	0
fam16572	2	2	2	2.0	0.0	0.0	2	2	0
fam16573	2	2	2	2.0	0.0	0.0	2	2	0
fam16574	2	2	2	2.0	0.0	0.0	2	2	0
fam16575	2	2	2	2.0	0.0	0.0	2	2	0
fam16576	2	2	2	2.0	0.0	0.0	2	2	0
fam16577	2	2	2	2.0	0.0	0.0	2	2	0
fam16578	2	2	2	2.0	0.0	0.0	2	2	0
fam16579	2	2	2	2.0	0.0	0.0	2	2	0
fam16580	2	2	2	2.0	0.0	0.0	2	2	0
fam16581	2	2	2	2.0	0.0	0.0	2	2	0
fam16582	2	2	2	2.0	0.0	0.0	2	2	0
fam16583	2	2	2	2.0	0.0	0.0	2	2	0
fam16584	2	2	2	2.0	0.0	0.0	2	2	0
fam16585	2	2	2	2.0	0.0	0.0	2	2	0
fam16586	2	2	2	2.0	0.0	0.0	2	2	0
fam16587	2	2	2	2.0	0.0	0.0	2	2	0
fam16588	2	2	2	2.0	0.0	0.0	2	2	0
fam16589	2	2	2	2.0	0.0	0.0	2	2	0
fam16590	2	2	2	2.0	0.0	0.0	2	2	0
fam16591	2	2	2	2.0	0.0	0.0	2	2	0
fam16592	2	2	2	2.0	0.0	0.0	2	2	0
fam16593	2	2	2	2.0	0.0	0.0	2	2	0
fam16594	2	2	2	2.0	0.0	0.0	2	2	0
fam16595	2	2	2	2.0	0.0	0.0	2	2	0
fam16596	2	2	2	2.0	0.0	0.0	2	2	0
fam16597	2	2	2	2.0	0.0	0.0	2	2	0
fam16598	2	2	2	2.0	0.0	0.0	2	2	0
fam16599	2	2	2	2.0	0.0	0.0	2	2	0
fam16600	2	2	2	2.0	0.0	0.0	2	2	0
fam16601	2	2	2	2.0	0.0	0.0	2	2	0
fam16602	2	2	2	2.0	0.0	0.0	2	2	0
fam16603	2	2	2	2.0	0.0	0.0	2	2	0
fam16604	2	2	2	2.0	0.0	0.0	2	2	0
fam16605	2	2	2	2.0	0.0	0.0	2	2	0
fam16606	2	2	2	2.0	0.0	0.0	2	2	0
fam16607	2	2	2	2.0	0.0	0.0	2	2	0
fam16608	2	2	2	2.0	0.0	0.0	2	2	0
fam16609	2	2	2	2.0	0.0	0.0	2	2	0
fam16610	2	2	2	2.0	0.0	0.0	2	2	0
fam16611	2	2	2	2.0	0.0	0.0	2	2	0
fam16612	2	2	2	2.0	0.0	0.0	2	2	0
fam16613	2	2	2	2.0	0.0	0.0	2	2	0
fam16614	2	2	2	2.0	0.0	0.0	2	2	0
fam16615	2	2	2	2.0	0.0	0.0	2	2	0
fam16616	2	2	2	2.0	0.0	0.0	2	2	0
fam16617	2	2	2	2.0	0.0	0.0	2	2	0
fam16618	2	2	2	2.0	0.0	0.0	2	2	0
fam16619	2	2	2	2.0	0.0	0.0	2	2	0
fam16620	2	2	2	2.0	0.0	0.0	2	2	0
fam16621	2	2	2	2.0	0.0	0.0	2	2	0
fam16622	2	2	2	2.0	0.0	0.0	2	2	0
fam16623	2	2	2	2.0	0.0	0.0	2	2	0
fam16624	2	2	2	2.0	0.0	0.0	2	2	0
fam16625	2	2	2	2.0	0.0	0.0	2	2	0
fam16626	2	2	2	2.0	0.0	0.0	2	2	0
fam16627	2	2	2	2.0	0.0	0.0	2	2	0
fam16628	2	2	2	2.0	0.0	0.0	2	2	0
fam16629	2	2	2	2.0	0.0	0.0	2	2	0
fam16630	2	2	2	2.0	0.0	0.0	2	2	0
fam16631	2	2	2	2.0	0.0	0.0	2	2	0
fam16632	2	2	2	2.0	0.0	0.0	2	2	0
fam16633	2	2	2	2.0	0.0	0.0	2	2	0
fam16634	2	2	2	2.0	0.0	0.0	2	2	0
fam16635	2	2	2	2.0	0.0	0.0	2	2	0
fam16636	2	2	2	2.0	0.0	0.0	2	2	0
fam16637	2	2	2	2.0	0.0	0.0	2	2	0
fam16638	2	2	2	2.0	0.0	0.0	2	2	0
fam16639	2	2	2	2.0	0.0	0.0	2	2	0
fam16640	2	2	2	2.0	0.0	0.0	2	2	0
fam16641	2	2	2	2.0	0.0	0.0	2	2	0
fam16642	2	2	2	2.0	0.0	0.0	2	2	0
fam16643	2	2	2	2.0	0.0	0.0	2	2	0
fam16644	2	2	2	2.0	0.0	0.0	2	2	0
fam16645	2	2	2	2.0	0.0	0.0	2	2	0
fam16646	2	2	2	2.0	0.0	0.0	2	2	0
fam16647	2	2	2	2.0	0.0	0.0	2	2	0
fam16648	2	2	2	2.0	0.0	0.0	2	2	0
fam16649	2	2	2	2.0	0.0	0.0	2	2	0
fam16650	2	2	2	2.0	0.0	0.0	2	2	0
fam16651	2	2	2	2.0	0.0	0.0	2	2	0
fam16652	2	2	2	2.0	0.0	0.0	2	2	0
fam16653	2	2	2	2.0	0.0	0.0	2	2	0
fam16654	2	2	2	2.0	0.0	0.0	2	2	0
fam16655	2	2	2	2.0	0.0	0.0	2	2	0
fam16656	2	2	2	2.0	0.0	0.0	2	2	0
fam16657	2	2	2	2.0	0.0	0.0	2	2	0
fam16658	2	2	2	2.0	0.0	0.0	2	2	0
fam16659	2	2	2	2.0	0.0	0.0	2	2	0
fam16660	2	2	2	2.0	0.0	0.0	2	2	0
fam16661	2	2	2	2.0	0.0	0.0	2	2	0
fam16662	2	2	2	2.0	0.0	0.0	2	2	0
fam16663	2	2	2	2.0	0.0	0.0	2	2	0
fam16664	2	2	2	2.0	0.0	0.0	2	2	0
fam16665	2	2	2	2.0	0.0	0.0	2	2	0
fam16666	2	2	2	2.0	0.0	0.0	2	2	0
fam16667	2	2	2	2.0	0.0	0.0	2	2	0
fam16668	2	2	2	2.0	0.0	0.0	2	2	0
fam16669	2	2	2	2.0	0.0	0.0	2	2	0
fam16670	2	2	2	2.0	0.0	0.0	2	2	0
fam16671	2	2	2	2.0	0.0	0.0	2	2	0
fam16672	2	2	2	2.0	0.0	0.0	2	2	0
fam16673	2	2	2	2.0	0.0	0.0	2	2	0
fam16674	2	2	2	2.0	0.0	0.0	2	2	0
fam16675	2	2	2	2.0	0.0	0.0	2	2	0
fam16676	2	2	2	2.0	0.0	0.0	2	2	0
fam16677	2	2	2	2.0	0.0	0.0	2	2	0
fam16678	2	2	2	2.0	0.0	0.0	2	2	0
fam16679	2	2	2	2.0	0.0	0.0	2	2	0
fam16680	2	2	2	2.0	0.0	0.0	2	2	0
fam16681	2	2	2	2.0	0.0	0.0	2	2	0
fam16682	2	2	2	2.0	0.0	0.0	2	2	0
fam16683	2	2	2	2.0	0.0	0.0	2	2	0
fam16684	2	2	2	2.0	0.0	0.0	2	2	0
fam16685	2	2	2	2.0	0.0	0.0	2	2	0
fam16686	2	2	2	2.0	0.0	0.0	2	2	0
fam16687	2	2	2	2.0	0.0	0.0	2	2	0
fam16688	2	2	2	2.0	0.0	0.0	2	2	0
fam16689	2	2	2	2.0	0.0	0.0	2	2	0
fam16690	2	2	2	2.0	0.0	0.0	2	2	0
fam16691	2	2	2	2.0	0.0	0.0	2	2	0
fam16692	2	2	2	2.0	0.0	0.0	2	2	0
fam16693	2	2	2	2.0	0.0	0.0	2	2	0
fam16694	2	2	2	2.0	0.0	0.0	2	2	0
fam16695	2	2	2	2.0	0.0	0.0	2	2	0
fam16696	2	2	2	2.0	0.0	0.0	2	2	0
fam16697	2	2	2	2.0	0.0	0.0	2	2	0
fam16698	2	2	2	2.0	0.0	0.0	2	2	0
fam16699	2	2	2	2.0	0.0	0.0	2	2	0
fam16700	2	2	2	2.0	0.0	0.0	2	2	0
fam16701	2	2	2	2.0	0.0	0.0	2	2	0
fam16702	2	2	2	2.0	0.0	0.0	2	2	0
fam16703	2	2	2	2.0	0.0	0.0	2	2	0
fam16704	2	2	2	2.0	0.0	0.0	2	2	0
fam16705	2	2	2	2.0	0.0	0.0	2	2	0
fam16706	2	2	2	2.0	0.0	0.0	2	2	0
fam16707	2	2	2	2.0	0.0	0.0	2	2	0
fam16708	2	2	2	2.0	0.0	0.0	2	2	0
fam16709	2	2	2	2.0	0.0	0.0	2	2	0
fam16710	2	2	2	2.0	0.0	0.0	2	2	0
fam16711	2	2	2	2.0	0.0	0.0	2	2	0
fam16712	2	2	2	2.0	0.0	0.0	2	2	0
fam16713	2	2	2	2.0	0.0	0.0	2	2	0
fam16714	2	2	2	2.0	0.0	0.0	2	2	0
fam16715	2	2	2	2.0	0.0	0.0	2	2	0
fam16716	2	2	2	2.0	0.0	0.0	2	2	0
fam16717	2	2	2	2.0	0.0	0.0	2	2	0
fam16718	2	2	2	2.0	0.0	0.0	2	2	0
fam16719	2	2	2	2.0	0.0	0.0	2	2	0
fam16720	2	2	2	2.0	0.0	0.0	2	2	0
fam16721	2	2	2	2.0	0.0	0.0	2	2	0
fam16722	2	2	2	2.0	0.0	0.0	2	2	0
fam16723	2	2	2	2.0	0.0	0.0	2	2	0
fam16724	2	2	2	2.0	0.0	0.0	2	2	0
fam16725	2	2	2	2.0	0.0	0.0	2	2	0
fam16726	2	2	2	2.0	0.0	0.0	2	2	0
fam16727	2	2	2	2.0	0.0	0.0	2	2	0
fam16728	2	2	2	2.0	0.0	0.0	2	2	0
fam16729	2	2	2	2.0	0.0	0.0	2	2	0
fam16730	2	2	2	2.0	0.0	0.0	2	2	0
fam16731	2	2	2	2.0	0.0	0.0	2	2	0
fam16732	2	2	2	2.0	0.0	0.0	2	2	0
fam16733	2	2	2	2.0	0.0	0.0	2	2	0
fam16734	2	2	2	2.0	0.0	0.0	2	2	0
fam16735	2	2	2	2.0	0.0	0.0	2	2	0
fam16736	2	2	2	2.0	0.0	0.0	2	2	0
fam16737	2	2	2	2.0	0.0	0.0	2	2	0
fam16738	2	2	2	2.0	0.0	0.0	2	2	0
fam16739	2	2	2	2.0	0.0	0.0	2	2	0
fam16740	2	2	2	2.0	0.0	0.0	2	2	0
fam16741	2	2	2	2.0	0.0	0.0	2	2	0
fam16742	2	2	2	2.0	0.0	0.0	2	2	0
fam16743	2	2	2	2.0	0.0	0.0	2	2	0
fam16744	2	2	2	2.0	0.0	0.0	2	2	0
fam16745	2	2	2	2.0	0.0	0.0	2	2	0
fam16746	2	2	2	2.0	0.0	0.0	2	2	0
fam16747	2	2	2	2.0	0.0	0.0	2	2	0
fam16748	2	2	2	2.0	0.0	0.0	2	2	0
fam16749	2	2	2	2.0	0.0	0.0	2	2	0
fam16750	2	2	2	2.0	0.0	0.0	2	2	0
fam16751	2	2	2	2.0	0.0	0.0	2	2	0
fam16752	2	2	2	2.0	0.0	0.0	2	2	0
fam16753	2	2	2	2.0	0.0	0.0	2	2	0
fam16754	2	2	2	2.0	0.0	0.0	2	2	0
fam16755	2	2	2	2.0	0.0	0.0	2	2	0
fam16756	2	2	2	2.0	0.0	0.0	2	2	0
fam16757	2	2	2	2.0	0.0	0.0	2	2	0
fam16758	2	2	2	2.0	0.0	0.0	2	2	0
fam16759	2	2	2	2.0	0.0	0.0	2	2	0
fam16760	2	2	2	2.0	0.0	0.0	2	2	0
fam16761	2	2	2	2.0	0.0	0.0	2	2	0
fam16762	2	2	2	2.0	0.0	0.0	2	2	0
fam16763	2	2	2	2.0	0.0	0.0	2	2	0
fam16764	2	2	2	2.0	0.0	0.0	2	2	0
fam16765	2	2	2	2.0	0.0	0.0	2	2	0
fam16766	2	2	2	2.0	0.0	0.0	2	2	0
fam16767	2	2	2	2.0	0.0	0.0	2	2	0
fam16768	2	2	2	2.0	0.0	0.0	2	2	0
fam16769	2	2	2	2.0	0.0	0.0	2	2	0
fam16770	2	2	2	2.0	0.0	0.0	2	2	0
fam16771	2	2	2	2.0	0.0	0.0	2	2	0
fam16772	2	2	2	2.0	0.0	0.0	2	2	0
fam16773	2	2	2	2.0	0.0	0.0	2	2	0
fam16774	2	2	2	2.0	0.0	0.0	2	2	0
fam16775	2	2	2	2.0	0.0	0.0	2	2	0
fam16776	2	2	2	2.0	0.0	0.0	2	2	0
fam16777	2	2	2	2.0	0.0	0.0	2	2	0
fam16778	2	2	2	2.0	0.0	0.0	2	2	0
fam16779	2	2	2	2.0	0.0	0.0	2	2	0
fam16780	2	2	2	2.0	0.0	0.0	2	2	0
fam16781	2	2	2	2.0	0.0	0.0	2	2	0
fam16782	2	2	2	2.0	0.0	0.0	2	2	0
fam16783	2	2	2	2.0	0.0	0.0	2	2	0
fam16784	2	2	2	2.0	0.0	0.0	2	2	0
fam16785	2	2	2	2.0	0.0	0.0	2	2	0
fam16786	2	2	2	2.0	0.0	0.0	2	2	0
fam16787	2	2	2	2.0	0.0	0.0	2	2	0
fam16788	2	2	2	2.0	0.0	0.0	2	2	0
fam16789	2	2	2	2.0	0.0	0.0	2	2	0
fam16790	2	2	2	2.0	0.0	0.0	2	2	0
fam16791	2	2	2	2.0	0.0	0.0	2	2	0
fam16792	2	2	2	2.0	0.0	0.0	2	2	0
fam16793	2	2	2	2.0	0.0	0.0	2	2	0
fam16794	2	2	2	2.0	0.0	0.0	2	2	0
fam16795	2	2	2	2.0	0.0	0.0	2	2	0
fam16796	2	2	2	2.0	0.0	0.0	2	2	0
fam16797	2	2	2	2.0	0.0	0.0	2	2	0
fam16798	2	2	2	2.0	0.0	0.0	2	2	0
fam16799	2	2	2	2.0	0.0	0.0	2	2	0
fam16800	2	2	2	2.0	0.0	0.0	2	2	0
fam16801	2	2	2	2.0	0.0	0.0	2	2	0
fam16802	2	2	2	2.0	0.0	0.0	2	2	0
fam16803	2	2	2	2.0	0.0	0.0	2	2	0
fam16804	2	2	2	2.0	0.0	0.0	2	2	0
fam16805	2	2	2	2.0	0.0	0.0	2	2	0
fam16806	2	2	2	2.0	0.0	0.0	2	2	0
fam16807	2	2	2	2.0	0.0	0.0	2	2	0
fam16808	2	2	2	2.0	0.0	0.0	2	2	0
fam16809	2	2	2	2.0	0.0	0.0	2	2	0
fam16810	2	2	2	2.0	0.0	0.0	2	2	0
fam16811	2	2	2	2.0	0.0	0.0	2	2	0
fam16812	2	2	2	2.0	0.0	0.0	2	2	0
fam16813	2	2	2	2.0	0.0	0.0	2	2	0
fam16814	2	2	2	2.0	0.0	0.0	2	2	0
fam16815	2	2	2	2.0	0.0	0.0	2	2	0
fam16816	2	2	2	2.0	0.0	0.0	2	2	0
fam16817	2	2	2	2.0	0.0	0.0	2	2	0
fam16818	2	2	2	2.0	0.0	0.0	2	2	0
fam16819	2	2	2	2.0	0.0	0.0	2	2	0
fam16820	2	2	2	2.0	0.0	0.0	2	2	0
fam16821	2	2	2	2.0	0.0	0.0	2	2	0
fam16822	2	2	2	2.0	0.0	0.0	2	2	0
fam16823	2	2	2	2.0	0.0	0.0	2	2	0
fam16824	2	2	2	2.0	0.0	0.0	2	2	0
fam16825	2	2	2	2.0	0.0	0.0	2	2	0
fam16826	2	2	2	2.0	0.0	0.0	2	2	0
fam16827	2	2	2	2.0	0.0	0.0	2	2	0
fam16828	2	2	2	2.0	0.0	0.0	2	2	0
fam16829	2	2	2	2.0	0.0	0.0	2	2	0
fam16830	2	2	2	2.0	0.0	0.0	2	2	0
fam16831	2	2	2	2.0	0.0	0.0	2	2	0
fam16832	2	2	2	2.0	0.0	0.0	2	2	0
fam16833	2	2	2	2.0	0.0	0.0	2	2	0
fam16834	2	2	2	2.0	0.0	0.0	2	2	0
fam16835	2	2	2	2.0	0.0	0.0	2	2	0
fam16836	2	2	2	2.0	0.0	0.0	2	2	0
fam16837	2	2	2	2.0	0.0	0.0	2	2	0
fam16838	2	2	2	2.0	0.0	0.0	2	2	0
fam16839	2	2	2	2.0	0.0	0.0	2	2	0
fam16840	2	2	2	2.0	0.0	0.0	2	2	0
fam16841	2	2	2	2.0	0.0	0.0	2	2	0
fam16842	2	2	2	2.0	0.0	0.0	2	2	0
fam16843	2	2	2	2.0	0.0	0.0	2	2	0
fam16844	2	2	2	2.0	0.0	0.0	2	2	0
fam16845	2	2	2	2.0	0.0	0.0	2	2	0
fam16846	2	2	2	2.0	0.0	0.0	2	2	0
fam16847	2	2	2	2.0	0.0	0.0	2	2	0
fam16848	2	2	2	2.0	0.0	0.0	2	2	0
fam16849	2	2	2	2.0	0.0	0.0	2	2	0
fam16850	2	2	2	2.0	0.0	0.0	2	2	0
fam16851	2	2	2	2.0	0.0	0.0	2	2	0
fam16852	2	2	2	2.0	0.0	0.0	2	2	0
fam16853	2	2	2	2.0	0.0	0.0	2	2	0
fam16854	2	2	2	2.0	0.0	0.0	2	2	0
fam16855	2	2	2	2.0	0.0	0.0	2	2	0
fam16856	2	2	2	2.0	0.0	0.0	2	2	0
fam16857	2	2	2	2.0	0.0	0.0	2	2	0
fam16858	2	2	2	2.0	0.0	0.0	2	2	0
fam16859	2	2	2	2.0	0.0	0.0	2	2	0
fam16860	2	2	2	2.0	0.0	0.0	2	2	0
fam16861	2	2	2	2.0	0.0	0.0	2	2	0
fam16862	2	2	2	2.0	0.0	0.0	2	2	0
fam16863	2	2	2	2.0	0.0	0.0	2	2	0
fam16864	2	2	2	2.0	0.0	0.0	2	2	0
fam16865	2	2	2	2.0	0.0	0.0	2	2	0
fam16866	2	2	2	2.0	0.0	0.0	2	2	0
fam16867	2	2	2	2.0	0.0	0.0	2	2	0
fam16868	2	2	2	2.0	0.0	0.0	2	2	0
fam16869	2	2	2	2.0	0.0	0.0	2	2	0
fam16870	2	2	2	2.0	0.0	0.0	2	2	0
fam16871	2	2	2	2.0	0.0	0.0	2	2	0
fam16872	2	2	2	2.0	0.0	0.0	2	2	0
fam16873	2	2	2	2.0	0.0	0.0	2	2	0
fam16874	2	2	2	2.0	0.0	0.0	2	2	0
fam16875	2	2	2	2.0	0.0	0.0	2	2	0
fam16876	2	2	2	2.0	0.0	0.0	2	2	0
fam16877	2	2	2	2.0	0.0	0.0	2	2	0
fam16878	2	2	2	2.0	0.0	0.0	2	2	0
fam16879	2	2	2	2.0	0.0	0.0	2	2	0
fam16880	2	2	2	2.0	0.0	0.0	2	2	0
fam16881	2	2	2	2.0	0.0	0.0	2	2	0
fam16882	2	2	2	2.0	0.0	0.0	2	2	0
fam16883	2	2	2	2.0	0.0	0.0	2	2	0
fam16884	2	2	2	2.0	0.0	0.0	2	2	0
fam16885	2	2	2	2.0	0.0	0.0	2	2	0
fam16886	2	2	2	2.0	0.0	0.0	2	2	0
fam16887	2	2	2	2.0	0.0	0.0	2	2	0
fam16888	2	2	2	2.0	0.0	0.0	2	2	0
fam16889	2	2	2	2.0	0.0	0.0	2	2	0
fam16890	2	2	2	2.0	0.0	0.0	2	2	0
fam16891	2	2	2	2.0	0.0	0.0	2	2	0
fam16892	2	2	2	2.0	0.0	0.0	2	2	0
fam16893	2	2	2	2.0	0.0	0.0	2	2	0
fam16894	2	2	2	2.0	0.0	0.0	2	2	0
fam16895	2	2	2	2.0	0.0	0.0	2	2	0
fam16896	2	2	2	2.0	0.0	0.0	2	2	0
fam16897	2	2	2	2.0	0.0	0.0	2	2	0
fam16898	2	2	2	2.0	0.0	0.0	2	2	0
fam16899	2	2	2	2.0	0.0	0.0	2	2	0
fam16900	2	2	2	2.0	0.0	0.0	2	2	0
fam16901	2	2	2	2.0	0.0	0.0	2	2	0
fam16902	2	2	2	2.0	0.0	0.0	2	2	0
fam16903	2	2	2	2.0	0.0	0.0	2	2	0
fam16904	2	2	2	2.0	0.0	0.0	2	2	0
fam16905	2	2	2	2.0	0.0	0.0	2	2	0
fam16906	2	2	2	2.0	0.0	0.0	2	2	0
fam16907	2	2	2	2.0	0.0	0.0	2	2	0
fam16908	2	2	2	2.0	0.0	0.0	2	2	0
fam16909	2	2	2	2.0	0.0	0.0	2	2	0
fam16910	2	2	2	2.0	0.0	0.0	2	2	0
fam16911	2	2	2	2.0	0.0	0.0	2	2	0
fam16912	2	2	2	2.0	0.0	0.0	2	2	0
fam16913	2	2	2	2.0	0.0	0.0	2	2	0
fam16914	2	2	2	2.0	0.0	0.0	2	2	0
fam16915	2	2	2	2.0	0.0	0.0	2	2	0
fam16916	2	2	2	2.0	0.0	0.0	2	2	0
fam16917	2	2	2	2.0	0.0	0.0	2	2	0
fam16918	2	2	2	2.0	0.0	0.0	2	2	0
fam16919	2	2	2	2.0	0.0	0.0	2	2	0
fam16920	2	2	2	2.0	0.0	0.0	2	2	0
fam16921	2	2	2	2.0	0.0	0.0	2	2	0
fam16922	2	2	2	2.0	0.0	0.0	2	2	0
fam16923	2	2	2	2.0	0.0	0.0	2	2	0
fam16924	2	2	2	2.0	0.0	0.0	2	2	0
fam16925	2	2	2	2.0	0.0	0.0	2	2	0
fam16926	2	2	2	2.0	0.0	0.0	2	2	0
fam16927	2	2	2	2.0	0.0	0.0	2	2	0
fam16928	2	2	2	2.0	0.0	0.0	2	2	0
fam16929	2	2	2	2.0	0.0	0.0	2	2	0
fam16930	2	2	2	2.0	0.0	0.0	2	2	0
fam16931	2	2	2	2.0	0.0	0.0	2	2	0
fam16932	2	2	2	2.0	0.0	0.0	2	2	0
fam16933	2	2	2	2.0	0.0	0.0	2	2	0
fam16934	2	2	2	2.0	0.0	0.0	2	2	0
fam16935	2	2	2	2.0	0.0	0.0	2	2	0
fam16936	2	2	2	2.0	0.0	0.0	2	2	0
fam16937	2	2	2	2.0	0.0	0.0	2	2	0
fam16938	2	2	2	2.0	0.0	0.0	2	2	0
fam16939	2	2	2	2.0	0.0	0.0	2	2	0
fam16940	2	2	2	2.0	0.0	0.0	2	2	0
fam16941	2	2	2	2.0	0.0	0.0	2	2	0
fam16942	2	2	2	2.0	0.0	0.0	2	2	0
fam16943	2	2	2	2.0	0.0	0.0	2	2	0
fam16944	2	2	2	2.0	0.0	0.0	2	2	0
fam16945	2	2	2	2.0	0.0	0.0	2	2	0
fam16946	2	2	2	2.0	0.0	0.0	2	2	0
fam16947	2	2	2	2.0	0.0	0.0	2	2	0
fam16948	2	2	2	2.0	0.0	0.0	2	2	0
fam16949	2	2	2	2.0	0.0	0.0	2	2	0
fam16950	2	2	2	2.0	0.0	0.0	2	2	0
fam16951	2	2	2	2.0	0.0	0.0	2	2	0
fam16952	2	2	2	2.0	0.0	0.0	2	2	0
fam16953	2	2	2	2.0	0.0	0.0	2	2	0
fam16954	2	2	2	2.0	0.0	0.0	2	2	0
fam16955	2	2	2	2.0	0.0	0.0	2	2	0
fam16956	2	2	2	2.0	0.0	0.0	2	2	0
fam16957	2	2	2	2.0	0.0	0.0	2	2	0
fam16958	2	2	2	2.0	0.0	0.0	2	2	0
fam16959	2	2	2	2.0	0.0	0.0	2	2	0
fam16960	2	2	2	2.0	0.0	0.0	2	2	0
fam16961	2	2	2	2.0	0.0	0.0	2	2	0
fam16962	2	2	2	2.0	0.0	0.0	2	2	0
fam16963	2	2	2	2.0	0.0	0.0	2	2	0
fam16964	2	2	2	2.0	0.0	0.0	2	2	0
fam16965	2	2	2	2.0	0.0	0.0	2	2	0
fam16966	2	2	2	2.0	0.0	0.0	2	2	0
fam16967	2	2	2	2.0	0.0	0.0	2	2	0
fam16968	2	2	2	2.0	0.0	0.0	2	2	0
fam16969	2	2	2	2.0	0.0	0.0	2	2	0
fam16970	2	2	2	2.0	0.0	0.0	2	2	0
fam16971	2	2	2	2.0	0.0	0.0	2	2	0
fam16972	2	2	2	2.0	0.0	0.0	2	2	0
fam16973	2	2	2	2.0	0.0	0.0	2	2	0
fam16974	2	2	2	2.0	0.0	0.0	2	2	0
fam16975	2	2	2	2.0	0.0	0.0	2	2	0
fam16976	2	2	2	2.0	0.0	0.0	2	2	0
fam16977	2	2	2	2.0	0.0	0.0	2	2	0
fam16978	2	2	2	2.0	0.0	0.0	2	2	0
fam16979	2	2	2	2.0	0.0	0.0	2	2	0
fam16980	2	2	2	2.0	0.0	0.0	2	2	0
fam16981	2	2	2	2.0	0.0	0.0	2	2	0
fam16982	2	2	2	2.0	0.0	0.0	2	2	0
fam16983	2	2	2	2.0	0.0	0.0	2	2	0
fam16984	2	2	2	2.0	0.0	0.0	2	2	0
fam16985	2	2	2	2.0	0.0	0.0	2	2	0
fam16986	2	2	2	2.0	0.0	0.0	2	2	0
fam16987	2	2	2	2.0	0.0	0.0	2	2	0
fam16988	2	2	2	2.0	0.0	0.0	2	2	0
fam16989	2	2	2	2.0	0.0	0.0	2	2	0
fam16990	2	2	2	2.0	0.0	0.0	2	2	0
fam16991	2	2	2	2.0	0.0	0.0	2	2	0
fam16992	2	2	2	2.0	0.0	0.0	2	2	0
fam16993	2	2	2	2.0	0.0	0.0	2	2	0
fam16994	2	2	2	2.0	0.0	0.0	2	2	0
fam16995	2	2	2	2.0	0.0	0.0	2	2	0
fam16996	2	2	2	2.0	0.0	0.0	2	2	0
fam16997	2	2	2	2.0	0.0	0.0	2	2	0
fam16998	2	2	2	2.0	0.0	0.0	2	2	0
fam16999	2	2	2	2.0	0.0	0.0	2	2	0
fam17000	2	2	2	2.0	0.0	0.0	2	2	0
fam17001	2	2	2	2.0	0.0	0.0	2	2	0
fam17002	2	2	2	2.0	0.0	0.0	2	2	0
fam17003	2	2	2	2.0	0.0	0.0	2	2	0
fam17004	2	2	2	2.0	0.0	0.0	2	2	0
fam17005	2	2	2	2.0	0.0	0.0	2	2	0
fam17006	2	2	2	2.0	0.0	0.0	2	2	0
fam17007	2	2	2	2.0	0.0	0.0	2	2	0
fam17008	2	2	2	2.0	0.0	0.0	2	2	0
fam17009	2	2	2	2.0	0.0	0.0	2	2	0
fam17010	2	2	2	2.0	0.0	0.0	2	2	0
fam17011	2	2	2	2.0	0.0	0.0	2	2	0
fam17012	2	2	2	2.0	0.0	0.0	2	2	0
fam17013	2	2	2	2.0	0.0	0.0	2	2	0
fam17014	2	2	2	2.0	0.0	0.0	2	2	0
fam17015	2	2	2	2.0	0.0	0.0	2	2	0
fam17016	2	2	2	2.0	0.0	0.0	2	2	0
fam17017	2	2	2	2.0	0.0	0.0	2	2	0
fam17018	2	2	2	2.0	0.0	0.0	2	2	0
fam17019	2	2	2	2.0	0.0	0.0	2	2	0
fam17020	2	2	2	2.0	0.0	0.0	2	2	0
fam17021	2	2	2	2.0	0.0	0.0	2	2	0
fam17022	2	2	2	2.0	0.0	0.0	2	2	0
fam17023	2	2	2	2.0	0.0	0.0	2	2	0
fam17024	2	2	2	2.0	0.0	0.0	2	2	0
fam17025	2	2	2	2.0	0.0	0.0	2	2	0
fam17026	2	2	2	2.0	0.0	0.0	2	2	0
fam17027	2	2	2	2.0	0.0	0.0	2	2	0
fam17028	2	2	2	2.0	0.0	0.0	2	2	0
fam17029	2	2	2	2.0	0.0	0.0	2	2	0
fam17030	2	2	2	2.0	0.0	0.0	2	2	0
fam17031	2	2	2	2.0	0.0	0.0	2	2	0
fam17032	2	2	2	2.0	0.0	0.0	2	2	0
fam17033	2	2	2	2.0	0.0	0.0	2	2	0
fam17034	2	2	2	2.0	0.0	0.0	2	2	0
fam17035	2	2	2	2.0	0.0	0.0	2	2	0
fam17036	2	2	2	2.0	0.0	0.0	2	2	0
fam17037	2	2	2	2.0	0.0	0.0	2	2	0
fam17038	2	2	2	2.0	0.0	0.0	2	2	0
fam17039	2	2	2	2.0	0.0	0.0	2	2	0
fam17040	2	2	2	2.0	0.0	0.0	2	2	0
fam17041	2	2	2	2.0	0.0	0.0	2	2	0
fam17042	2	2	2	2.0	0.0	0.0	2	2	0
fam17043	2	2	2	2.0	0.0	0.0	2	2	0
fam17044	2	2	2	2.0	0.0	0.0	2	2	0
fam17045	2	2	2	2.0	0.0	0.0	2	2	0
fam17046	2	2	2	2.0	0.0	0.0	2	2	0
fam17047	2	2	2	2.0	0.0	0.0	2	2	0
fam17048	2	2	2	2.0	0.0	0.0	2	2	0
fam17049	2	2	2	2.0	0.0	0.0	2	2	0
fam17050	2	2	2	2.0	0.0	0.0	2	2	0
fam17051	2	2	2	2.0	0.0	0.0	2	2	0
fam17052	2	2	2	2.0	0.0	0.0	2	2	0
fam17053	2	2	2	2.0	0.0	0.0	2	2	0
fam17054	2	2	2	2.0	0.0	0.0	2	2	0
fam17055	2	2	2	2.0	0.0	0.0	2	2	0
fam17056	2	2	2	2.0	0.0	0.0	2	2	0
fam17057	2	2	2	2.0	0.0	0.0	2	2	0
fam17058	2	2	2	2.0	0.0	0.0	2	2	0
fam17059	2	2	2	2.0	0.0	0.0	2	2	0
fam17060	2	2	2	2.0	0.0	0.0	2	2	0
fam17061	2	2	2	2.0	0.0	0.0	2	2	0
fam17062	2	2	2	2.0	0.0	0.0	2	2	0
fam17063	2	2	2	2.0	0.0	0.0	2	2	0
fam17064	2	2	2	2.0	0.0	0.0	2	2	0
fam17065	2	2	2	2.0	0.0	0.0	2	2	0
fam17066	2	2	2	2.0	0.0	0.0	2	2	0
fam17067	2	2	2	2.0	0.0	0.0	2	2	0
fam17068	2	2	2	2.0	0.0	0.0	2	2	0
fam17069	2	2	2	2.0	0.0	0.0	2	2	0
fam17070	2	2	2	2.0	0.0	0.0	2	2	0
fam17071	2	2	2	2.0	0.0	0.0	2	2	0
fam17072	2	2	2	2.0	0.0	0.0	2	2	0
fam17073	2	2	2	2.0	0.0	0.0	2	2	0
fam17074	2	2	2	2.0	0.0	0.0	2	2	0
fam17075	2	2	2	2.0	0.0	0.0	2	2	0
fam17076	2	2	2	2.0	0.0	0.0	2	2	0
fam17077	2	2	2	2.0	0.0	0.0	2	2	0
fam17078	2	2	2	2.0	0.0	0.0	2	2	0
fam17079	2	2	2	2.0	0.0	0.0	2	2	0
fam17080	2	2	2	2.0	0.0	0.0	2	2	0
fam17081	2	2	2	2.0	0.0	0.0	2	2	0
fam17082	2	2	2	2.0	0.0	0.0	2	2	0
fam17083	2	2	2	2.0	0.0	0.0	2	2	0
fam17084	2	2	2	2.0	0.0	0.0	2	2	0
fam17085	2	2	2	2.0	0.0	0.0	2	2	0
fam17086	2	2	2	2.0	0.0	0.0	2	2	0
fam17087	2	2	2	2.0	0.0	0.0	2	2	0
fam17088	2	2	2	2.0	0.0	0.0	2	2	0
fam17089	2	2	2	2.0	0.0	0.0	2	2	0
fam17090	2	2	2	2.0	0.0	0.0	2	2	0
fam17091	2	2	2	2.0	0.0	0.0	2	2	0
fam17092	2	2	2	2.0	0.0	0.0	2	2	0
fam17093	2	2	2	2.0	0.0	0.0	2	2	0
fam17094	2	2	2	2.0	0.0	0.0	2	2	0
fam17095	2	2	2	2.0	0.0	0.0	2	2	0
fam17096	2	2	2	2.0	0.0	0.0	2	2	0
fam17097	2	2	2	2.0	0.0	0.0	2	2	0
fam17098	2	2	2	2.0	0.0	0.0	2	2	0
fam17099	2	2	2	2.0	0.0	0.0	2	2	0
fam17100	2	2	2	2.0	0.0	0.0	2	2	0
fam17101	2	2	2	2.0	0.0	0.0	2	2	0
fam17102	2	2	2	2.0	0.0	0.0	2	2	0
fam17103	2	2	2	2.0	0.0	0.0	2	2	0
fam17104	2	2	2	2.0	0.0	0.0	2	2	0
fam17105	2	2	2	2.0	0.0	0.0	2	2	0
fam17106	2	2	2	2.0	0.0	0.0	2	2	0
fam17107	2	2	2	2.0	0.0	0.0	2	2	0
fam17108	2	2	2	2.0	0.0	0.0	2	2	0
fam17109	2	2	2	2.0	0.0	0.0	2	2	0
fam17110	2	2	2	2.0	0.0	0.0	2	2	0
fam17111	2	2	2	2.0	0.0	0.0	2	2	0
fam17112	2	2	2	2.0	0.0	0.0	2	2	0
fam17113	2	2	2	2.0	0.0	0.0	2	2	0
fam17114	2	2	2	2.0	0.0	0.0	2	2	0
fam17115	2	2	2	2.0	0.0	0.0	2	2	0
fam17116	2	2	2	2.0	0.0	0.0	2	2	0
fam17117	2	2	2	2.0	0.0	0.0	2	2	0
fam17118	2	2	2	2.0	0.0	0.0	2	2	0
fam17119	2	2	2	2.0	0.0	0.0	2	2	0
fam17120	2	2	2	2.0	0.0	0.0	2	2	0
fam17121	2	2	2	2.0	0.0	0.0	2	2	0
fam17122	2	2	2	2.0	0.0	0.0	2	2	0
fam17123	2	2	2	2.0	0.0	0.0	2	2	0
fam17124	2	2	2	2.0	0.0	0.0	2	2	0
fam17125	2	2	2	2.0	0.0	0.0	2	2	0
fam17126	2	2	2	2.0	0.0	0.0	2	2	0
fam17127	2	2	2	2.0	0.0	0.0	2	2	0
fam17128	2	2	2	2.0	0.0	0.0	2	2	0
fam17129	2	2	2	2.0	0.0	0.0	2	2	0
fam17130	2	2	2	2.0	0.0	0.0	2	2	0
fam17131	2	2	2	2.0	0.0	0.0	2	2	0
fam17132	2	2	2	2.0	0.0	0.0	2	2	0
fam17133	2	2	2	2.0	0.0	0.0	2	2	0
fam17134	2	2	2	2.0	0.0	0.0	2	2	0
fam17135	2	2	2	2.0	0.0	0.0	2	2	0
fam17136	2	2	2	2.0	0.0	0.0	2	2	0
fam17137	2	2	2	2.0	0.0	0.0	2	2	0
fam17138	2	2	2	2.0	0.0	0.0	2	2	0
fam17139	2	2	2	2.0	0.0	0.0	2	2	0
fam17140	2	2	2	2.0	0.0	0.0	2	2	0
fam17141	2	2	2	2.0	0.0	0.0	2	2	0
fam17142	2	2	2	2.0	0.0	0.0	2	2	0
fam17143	2	2	2	2.0	0.0	0.0	2	2	0
fam17144	2	2	2	2.0	0.0	0.0	2	2	0
fam17145	2	2	2	2.0	0.0	0.0	2	2	0
fam17146	2	2	2	2.0	0.0	0.0	2	2	0
fam17147	2	2	2	2.0	0.0	0.0	2	2	0
fam17148	2	2	2	2.0	0.0	0.0	2	2	0
fam17149	2	2	2	2.0	0.0	0.0	2	2	0
fam17150	2	2	2	2.0	0.0	0.0	2	2	0
fam17151	2	2	2	2.0	0.0	0.0	2	2	0
fam17152	2	2	2	2.0	0.0	0.0	2	2	0
fam17153	2	2	2	2.0	0.0	0.0	2	2	0
fam17154	2	2	2	2.0	0.0	0.0	2	2	0
fam17155	2	2	2	2.0	0.0	0.0	2	2	0
fam17156	2	2	2	2.0	0.0	0.0	2	2	0
fam17157	2	2	2	2.0	0.0	0.0	2	2	0
fam17158	2	2	2	2.0	0.0	0.0	2	2	0
fam17159	2	2	2	2.0	0.0	0.0	2	2	0
fam17160	2	2	2	2.0	0.0	0.0	2	2	0
fam17161	2	2	2	2.0	0.0	0.0	2	2	0
fam17162	2	2	2	2.0	0.0	0.0	2	2	0
fam17163	2	2	2	2.0	0.0	0.0	2	2	0
fam17164	2	2	2	2.0	0.0	0.0	2	2	0
fam17165	2	2	2	2.0	0.0	0.0	2	2	0
fam17166	2	2	2	2.0	0.0	0.0	2	2	0
fam17167	2	2	2	2.0	0.0	0.0	2	2	0
fam17168	2	2	2	2.0	0.0	0.0	2	2	0
fam17169	2	2	2	2.0	0.0	0.0	2	2	0
fam17170	2	2	2	2.0	0.0	0.0	2	2	0
fam17171	2	2	2	2.0	0.0	0.0	2	2	0
fam17172	2	2	2	2.0	0.0	0.0	2	2	0
fam17173	2	2	2	2.0	0.0	0.0	2	2	0
fam17174	2	2	2	2.0	0.0	0.0	2	2	0
fam17175	2	2	2	2.0	0.0	0.0	2	2	0
fam17176	2	2	2	2.0	0.0	0.0	2	2	0
fam17177	2	2	2	2.0	0.0	0.0	2	2	0
fam17178	2	2	2	2.0	0.0	0.0	2	2	0
fam17179	2	2	2	2.0	0.0	0.0	2	2	0
fam17180	2	2	2	2.0	0.0	0.0	2	2	0
fam17181	2	2	2	2.0	0.0	0.0	2	2	0
fam17182	2	2	2	2.0	0.0	0.0	2	2	0
fam17183	2	2	2	2.0	0.0	0.0	2	2	0
fam17184	2	2	2	2.0	0.0	0.0	2	2	0
fam17185	2	2	2	2.0	0.0	0.0	2	2	0
fam17186	2	2	2	2.0	0.0	0.0	2	2	0
fam17187	2	2	2	2.0	0.0	0.0	2	2	0
fam17188	2	2	2	2.0	0.0	0.0	2	2	0
fam17189	2	2	2	2.0	0.0	0.0	2	2	0
fam17190	2	2	2	2.0	0.0	0.0	2	2	0
fam17191	2	2	2	2.0	0.0	0.0	2	2	0
fam17192	2	2	2	2.0	0.0	0.0	2	2	0
fam17193	2	2	2	2.0	0.0	0.0	2	2	0
fam17194	2	2	2	2.0	0.0	0.0	2	2	0
fam17195	2	2	2	2.0	0.0	0.0	2	2	0
fam17196	2	2	2	2.0	0.0	0.0	2	2	0
fam17197	2	2	2	2.0	0.0	0.0	2	2	0
fam17198	2	2	2	2.0	0.0	0.0	2	2	0
fam17199	2	2	2	2.0	0.0	0.0	2	2	0
fam17200	2	2	2	2.0	0.0	0.0	2	2	0
fam17201	2	2	2	2.0	0.0	0.0	2	2	0
fam17202	2	2	2	2.0	0.0	0.0	2	2	0
fam17203	2	2	2	2.0	0.0	0.0	2	2	0
fam17204	2	2	2	2.0	0.0	0.0	2	2	0
fam17205	2	2	2	2.0	0.0	0.0	2	2	0
fam17206	2	2	2	2.0	0.0	0.0	2	2	0
fam17207	2	2	2	2.0	0.0	0.0	2	2	0
fam17208	2	2	2	2.0	0.0	0.0	2	2	0
fam17209	2	2	2	2.0	0.0	0.0	2	2	0
fam17210	2	2	2	2.0	0.0	0.0	2	2	0
fam17211	2	2	2	2.0	0.0	0.0	2	2	0
fam17212	2	2	2	2.0	0.0	0.0	2	2	0
fam17213	2	2	2	2.0	0.0	0.0	2	2	0
fam17214	2	2	2	2.0	0.0	0.0	2	2	0
fam17215	2	2	2	2.0	0.0	0.0	2	2	0
fam17216	2	2	2	2.0	0.0	0.0	2	2	0
fam17217	2	2	2	2.0	0.0	0.0	2	2	0
fam17218	2	2	2	2.0	0.0	0.0	2	2	0
fam17219	2	2	2	2.0	0.0	0.0	2	2	0
fam17220	2	2	2	2.0	0.0	0.0	2	2	0
fam17221	2	2	2	2.0	0.0	0.0	2	2	0
fam17222	2	2	2	2.0	0.0	0.0	2	2	0
fam17223	2	2	2	2.0	0.0	0.0	2	2	0
fam17224	2	2	2	2.0	0.0	0.0	2	2	0
fam17225	2	2	2	2.0	0.0	0.0	2	2	0
fam17226	2	2	2	2.0	0.0	0.0	2	2	0
fam17227	2	2	2	2.0	0.0	0.0	2	2	0
fam17228	2	2	2	2.0	0.0	0.0	2	2	0
fam17229	2	2	2	2.0	0.0	0.0	2	2	0
fam17230	2	2	2	2.0	0.0	0.0	2	2	0
fam17231	2	2	2	2.0	0.0	0.0	2	2	0
fam17232	2	2	2	2.0	0.0	0.0	2	2	0
fam17233	2	2	2	2.0	0.0	0.0	2	2	0
fam17234	2	2	2	2.0	0.0	0.0	2	2	0
fam17235	2	2	2	2.0	0.0	0.0	2	2	0
fam17236	2	2	2	2.0	0.0	0.0	2	2	0
fam17237	2	2	2	2.0	0.0	0.0	2	2	0
fam17238	2	2	2	2.0	0.0	0.0	2	2	0
fam17239	2	2	2	2.0	0.0	0.0	2	2	0
fam17240	2	2	2	2.0	0.0	0.0	2	2	0
fam17241	2	2	2	2.0	0.0	0.0	2	2	0
fam17242	2	2	2	2.0	0.0	0.0	2	2	0
fam17243	2	2	2	2.0	0.0	0.0	2	2	0
fam17244	2	2	2	2.0	0.0	0.0	2	2	0
fam17245	2	2	2	2.0	0.0	0.0	2	2	0
fam17246	2	2	2	2.0	0.0	0.0	2	2	0
fam17247	2	2	2	2.0	0.0	0.0	2	2	0
fam17248	2	2	2	2.0	0.0	0.0	2	2	0
fam17249	2	2	2	2.0	0.0	0.0	2	2	0
fam17250	2	2	2	2.0	0.0	0.0	2	2	0
fam17251	2	2	2	2.0	0.0	0.0	2	2	0
fam17252	2	2	2	2.0	0.0	0.0	2	2	0
fam17253	2	2	2	2.0	0.0	0.0	2	2	0
fam17254	2	2	2	2.0	0.0	0.0	2	2	0
fam17255	2	2	2	2.0	0.0	0.0	2	2	0
fam17256	2	2	2	2.0	0.0	0.0	2	2	0
fam17257	2	2	2	2.0	0.0	0.0	2	2	0
fam17258	2	2	2	2.0	0.0	0.0	2	2	0
fam17259	2	2	2	2.0	0.0	0.0	2	2	0
fam17260	2	2	2	2.0	0.0	0.0	2	2	0
fam17261	2	2	2	2.0	0.0	0.0	2	2	0
fam17262	2	2	2	2.0	0.0	0.0	2	2	0
fam17263	2	2	2	2.0	0.0	0.0	2	2	0
fam17264	2	2	2	2.0	0.0	0.0	2	2	0
fam17265	2	2	2	2.0	0.0	0.0	2	2	0
fam17266	2	2	2	2.0	0.0	0.0	2	2	0
fam17267	2	2	2	2.0	0.0	0.0	2	2	0
fam17268	2	2	2	2.0	0.0	0.0	2	2	0
fam17269	2	2	2	2.0	0.0	0.0	2	2	0
fam17270	2	2	2	2.0	0.0	0.0	2	2	0
fam17271	2	2	2	2.0	0.0	0.0	2	2	0
fam17272	2	2	2	2.0	0.0	0.0	2	2	0
fam17273	2	2	2	2.0	0.0	0.0	2	2	0
fam17274	2	2	2	2.0	0.0	0.0	2	2	0
fam17275	2	2	2	2.0	0.0	0.0	2	2	0
fam17276	2	2	2	2.0	0.0	0.0	2	2	0
fam17277	2	2	2	2.0	0.0	0.0	2	2	0
fam17278	2	2	2	2.0	0.0	0.0	2	2	0
fam17279	2	2	2	2.0	0.0	0.0	2	2	0
fam17280	2	2	2	2.0	0.0	0.0	2	2	0
fam17281	2	2	2	2.0	0.0	0.0	2	2	0
fam17282	2	2	2	2.0	0.0	0.0	2	2	0
fam17283	2	2	2	2.0	0.0	0.0	2	2	0
fam17284	2	2	2	2.0	0.0	0.0	2	2	0
fam17285	2	2	2	2.0	0.0	0.0	2	2	0
fam17286	2	2	2	2.0	0.0	0.0	2	2	0
fam17287	2	2	2	2.0	0.0	0.0	2	2	0
fam17288	2	2	2	2.0	0.0	0.0	2	2	0
fam17289	2	2	2	2.0	0.0	0.0	2	2	0
fam17290	2	2	2	2.0	0.0	0.0	2	2	0
fam17291	2	2	2	2.0	0.0	0.0	2	2	0
fam17292	2	2	2	2.0	0.0	0.0	2	2	0
fam17293	2	2	2	2.0	0.0	0.0	2	2	0
fam17294	2	2	2	2.0	0.0	0.0	2	2	0
fam17295	2	2	2	2.0	0.0	0.0	2	2	0
fam17296	2	2	2	2.0	0.0	0.0	2	2	0
fam17297	2	2	2	2.0	0.0	0.0	2	2	0
fam17298	2	2	2	2.0	0.0	0.0	2	2	0
fam17299	2	2	2	2.0	0.0	0.0	2	2	0
fam17300	2	2	2	2.0	0.0	0.0	2	2	0
fam17301	2	2	2	2.0	0.0	0.0	2	2	0
fam17302	2	2	2	2.0	0.0	0.0	2	2	0
fam17303	2	2	2	2.0	0.0	0.0	2	2	0
fam17304	2	2	2	2.0	0.0	0.0	2	2	0
fam17305	2	2	2	2.0	0.0	0.0	2	2	0
fam17306	2	2	2	2.0	0.0	0.0	2	2	0
fam17307	2	2	2	2.0	0.0	0.0	2	2	0
fam17308	2	2	2	2.0	0.0	0.0	2	2	0
fam17309	2	2	2	2.0	0.0	0.0	2	2	0
fam17310	2	2	2	2.0	0.0	0.0	2	2	0
fam17311	2	2	2	2.0	0.0	0.0	2	2	0
fam17312	2	2	2	2.0	0.0	0.0	2	2	0
fam17313	2	2	2	2.0	0.0	0.0	2	2	0
fam17314	2	2	2	2.0	0.0	0.0	2	2	0
fam17315	2	2	2	2.0	0.0	0.0	2	2	0
fam17316	2	2	2	2.0	0.0	0.0	2	2	0
fam17317	2	2	2	2.0	0.0	0.0	2	2	0
fam17318	2	2	2	2.0	0.0	0.0	2	2	0
fam17319	2	2	2	2.0	0.0	0.0	2	2	0
fam17320	2	2	2	2.0	0.0	0.0	2	2	0
fam17321	2	2	2	2.0	0.0	0.0	2	2	0
fam17322	2	2	2	2.0	0.0	0.0	2	2	0
fam17323	2	2	2	2.0	0.0	0.0	2	2	0
fam17324	2	2	2	2.0	0.0	0.0	2	2	0
fam17325	2	2	2	2.0	0.0	0.0	2	2	0
fam17326	2	2	2	2.0	0.0	0.0	2	2	0
fam17327	2	2	2	2.0	0.0	0.0	2	2	0
fam17328	2	2	2	2.0	0.0	0.0	2	2	0
fam17329	2	2	2	2.0	0.0	0.0	2	2	0
fam17330	2	2	2	2.0	0.0	0.0	2	2	0
fam17331	2	2	2	2.0	0.0	0.0	2	2	0
fam17332	2	2	2	2.0	0.0	0.0	2	2	0
fam17333	2	2	2	2.0	0.0	0.0	2	2	0
fam17334	2	2	2	2.0	0.0	0.0	2	2	0
fam17335	2	2	2	2.0	0.0	0.0	2	2	0
fam17336	2	2	2	2.0	0.0	0.0	2	2	0
fam17337	2	2	2	2.0	0.0	0.0	2	2	0
fam17338	2	2	2	2.0	0.0	0.0	2	2	0
fam17339	2	2	2	2.0	0.0	0.0	2	2	0
fam17340	2	2	2	2.0	0.0	0.0	2	2	0
fam17341	2	2	2	2.0	0.0	0.0	2	2	0
fam17342	2	2	2	2.0	0.0	0.0	2	2	0
fam17343	2	2	2	2.0	0.0	0.0	2	2	0
fam17344	2	2	2	2.0	0.0	0.0	2	2	0
fam17345	2	2	2	2.0	0.0	0.0	2	2	0
fam17346	2	2	2	2.0	0.0	0.0	2	2	0
fam17347	2	2	2	2.0	0.0	0.0	2	2	0
fam17348	2	2	2	2.0	0.0	0.0	2	2	0
fam17349	2	2	2	2.0	0.0	0.0	2	2	0
fam17350	2	2	2	2.0	0.0	0.0	2	2	0
fam17351	2	2	2	2.0	0.0	0.0	2	2	0
fam17352	2	2	2	2.0	0.0	0.0	2	2	0
fam17353	2	2	2	2.0	0.0	0.0	2	2	0
fam17354	2	2	2	2.0	0.0	0.0	2	2	0
fam17355	2	2	2	2.0	0.0	0.0	2	2	0
fam17356	2	2	2	2.0	0.0	0.0	2	2	0
fam17357	2	2	2	2.0	0.0	0.0	2	2	0
fam17358	2	2	2	2.0	0.0	0.0	2	2	0
fam17359	2	2	2	2.0	0.0	0.0	2	2	0
fam17360	2	2	2	2.0	0.0	0.0	2	2	0
fam17361	2	2	2	2.0	0.0	0.0	2	2	0
fam17362	2	2	2	2.0	0.0	0.0	2	2	0
fam17363	2	2	2	2.0	0.0	0.0	2	2	0
fam17364	2	2	2	2.0	0.0	0.0	2	2	0
fam17365	2	2	2	2.0	0.0	0.0	2	2	0
fam17366	2	2	2	2.0	0.0	0.0	2	2	0
fam17367	2	2	2	2.0	0.0	0.0	2	2	0
fam17368	2	2	2	2.0	0.0	0.0	2	2	0
fam17369	2	2	2	2.0	0.0	0.0	2	2	0
fam17370	2	2	2	2.0	0.0	0.0	2	2	0
fam17371	2	2	2	2.0	0.0	0.0	2	2	0
fam17372	2	2	2	2.0	0.0	0.0	2	2	0
fam17373	2	2	2	2.0	0.0	0.0	2	2	0
fam17374	2	2	2	2.0	0.0	0.0	2	2	0
fam17375	2	2	2	2.0	0.0	0.0	2	2	0
fam17376	2	2	2	2.0	0.0	0.0	2	2	0
fam17377	2	2	2	2.0	0.0	0.0	2	2	0
fam17378	2	2	2	2.0	0.0	0.0	2	2	0
fam17379	2	2	2	2.0	0.0	0.0	2	2	0
fam17380	2	2	2	2.0	0.0	0.0	2	2	0
fam17381	2	2	2	2.0	0.0	0.0	2	2	0
fam17382	2	2	2	2.0	0.0	0.0	2	2	0
fam17383	2	2	2	2.0	0.0	0.0	2	2	0
fam17384	2	2	2	2.0	0.0	0.0	2	2	0
fam17385	2	2	2	2.0	0.0	0.0	2	2	0
fam17386	2	2	2	2.0	0.0	0.0	2	2	0
fam17387	2	2	2	2.0	0.0	0.0	2	2	0
fam17388	2	2	2	2.0	0.0	0.0	2	2	0
fam17389	2	2	2	2.0	0.0	0.0	2	2	0
fam17390	2	2	2	2.0	0.0	0.0	2	2	0
fam17391	2	2	2	2.0	0.0	0.0	2	2	0
fam17392	2	2	2	2.0	0.0	0.0	2	2	0
fam17393	2	2	2	2.0	0.0	0.0	2	2	0
fam17394	2	2	2	2.0	0.0	0.0	2	2	0
fam17395	2	2	2	2.0	0.0	0.0	2	2	0
fam17396	2	2	2	2.0	0.0	0.0	2	2	0
fam17397	2	2	2	2.0	0.0	0.0	2	2	0
fam17398	2	2	2	2.0	0.0	0.0	2	2	0
fam17399	2	2	2	2.0	0.0	0.0	2	2	0
fam17400	2	2	2	2.0	0.0	0.0	2	2	0
fam17401	2	2	2	2.0	0.0	0.0	2	2	0
fam17402	2	2	2	2.0	0.0	0.0	2	2	0
fam17403	2	2	2	2.0	0.0	0.0	2	2	0
fam17404	2	2	2	2.0	0.0	0.0	2	2	0
fam17405	2	2	2	2.0	0.0	0.0	2	2	0
fam17406	2	2	2	2.0	0.0	0.0	2	2	0
fam17407	2	2	2	2.0	0.0	0.0	2	2	0
fam17408	2	2	2	2.0	0.0	0.0	2	2	0
fam17409	2	2	2	2.0	0.0	0.0	2	2	0
fam17410	2	2	2	2.0	0.0	0.0	2	2	0
fam17411	2	2	2	2.0	0.0	0.0	2	2	0
fam17412	2	2	2	2.0	0.0	0.0	2	2	0
fam17413	2	2	2	2.0	0.0	0.0	2	2	0
fam17414	2	2	2	2.0	0.0	0.0	2	2	0
fam17415	2	2	2	2.0	0.0	0.0	2	2	0
fam17416	2	2	2	2.0	0.0	0.0	2	2	0
fam17417	2	2	2	2.0	0.0	0.0	2	2	0
fam17418	2	2	2	2.0	0.0	0.0	2	2	0
fam17419	2	2	2	2.0	0.0	0.0	2	2	0
fam17420	2	2	2	2.0	0.0	0.0	2	2	0
fam17421	2	2	2	2.0	0.0	0.0	2	2	0
fam17422	2	2	2	2.0	0.0	0.0	2	2	0
fam17423	2	2	2	2.0	0.0	0.0	2	2	0
fam17424	2	2	2	2.0	0.0	0.0	2	2	0
fam17425	2	2	2	2.0	0.0	0.0	2	2	0
fam17426	2	2	2	2.0	0.0	0.0	2	2	0
fam17427	2	2	2	2.0	0.0	0.0	2	2	0
fam17428	2	2	2	2.0	0.0	0.0	2	2	0
fam17429	2	2	2	2.0	0.0	0.0	2	2	0
fam17430	2	2	2	2.0	0.0	0.0	2	2	0
fam17431	2	2	2	2.0	0.0	0.0	2	2	0
fam17432	2	2	2	2.0	0.0	0.0	2	2	0
fam17433	2	2	2	2.0	0.0	0.0	2	2	0
fam17434	2	2	2	2.0	0.0	0.0	2	2	0
fam17435	2	2	2	2.0	0.0	0.0	2	2	0
fam17436	2	2	2	2.0	0.0	0.0	2	2	0
fam17437	2	2	2	2.0	0.0	0.0	2	2	0
fam17438	2	2	2	2.0	0.0	0.0	2	2	0
fam17439	2	2	2	2.0	0.0	0.0	2	2	0
fam17440	2	2	2	2.0	0.0	0.0	2	2	0
fam17441	2	2	2	2.0	0.0	0.0	2	2	0
fam17442	2	2	2	2.0	0.0	0.0	2	2	0
fam17443	2	2	2	2.0	0.0	0.0	2	2	0
fam17444	2	2	2	2.0	0.0	0.0	2	2	0
fam17445	2	2	2	2.0	0.0	0.0	2	2	0
fam17446	2	2	2	2.0	0.0	0.0	2	2	0
fam17447	2	2	2	2.0	0.0	0.0	2	2	0
fam17448	2	2	2	2.0	0.0	0.0	2	2	0
fam17449	2	2	2	2.0	0.0	0.0	2	2	0
fam17450	2	2	2	2.0	0.0	0.0	2	2	0
fam17451	2	2	2	2.0	0.0	0.0	2	2	0
fam17452	2	2	2	2.0	0.0	0.0	2	2	0
fam17453	2	2	2	2.0	0.0	0.0	2	2	0
fam17454	2	2	2	2.0	0.0	0.0	2	2	0
fam17455	2	2	2	2.0	0.0	0.0	2	2	0
fam17456	2	2	2	2.0	0.0	0.0	2	2	0
fam17457	2	2	2	2.0	0.0	0.0	2	2	0
fam17458	2	2	2	2.0	0.0	0.0	2	2	0
fam17459	2	2	2	2.0	0.0	0.0	2	2	0
fam17460	2	2	2	2.0	0.0	0.0	2	2	0
fam17461	2	2	2	2.0	0.0	0.0	2	2	0
fam17462	2	2	2	2.0	0.0	0.0	2	2	0
fam17463	2	2	2	2.0	0.0	0.0	2	2	0
fam17464	2	2	2	2.0	0.0	0.0	2	2	0
fam17465	2	2	2	2.0	0.0	0.0	2	2	0
fam17466	2	2	2	2.0	0.0	0.0	2	2	0
fam17467	2	2	2	2.0	0.0	0.0	2	2	0
fam17468	2	2	2	2.0	0.0	0.0	2	2	0
fam17469	2	2	2	2.0	0.0	0.0	2	2	0
fam17470	2	2	2	2.0	0.0	0.0	2	2	0
fam17471	2	2	2	2.0	0.0	0.0	2	2	0
fam17472	2	2	2	2.0	0.0	0.0	2	2	0
fam17473	2	2	2	2.0	0.0	0.0	2	2	0
fam17474	2	2	2	2.0	0.0	0.0	2	2	0
fam17475	2	2	2	2.0	0.0	0.0	2	2	0
fam17476	2	2	2	2.0	0.0	0.0	2	2	0
fam17477	2	2	2	2.0	0.0	0.0	2	2	0
fam17478	2	2	2	2.0	0.0	0.0	2	2	0
fam17479	2	2	2	2.0	0.0	0.0	2	2	0
fam17480	2	2	2	2.0	0.0	0.0	2	2	0
fam17481	2	2	2	2.0	0.0	0.0	2	2	0
fam17482	2	2	2	2.0	0.0	0.0	2	2	0
fam17483	2	2	2	2.0	0.0	0.0	2	2	0
fam17484	2	2	2	2.0	0.0	0.0	2	2	0
fam17485	2	2	2	2.0	0.0	0.0	2	2	0
fam17486	2	2	2	2.0	0.0	0.0	2	2	0
fam17487	2	2	2	2.0	0.0	0.0	2	2	0
fam17488	2	2	2	2.0	0.0	0.0	2	2	0
fam17489	2	2	2	2.0	0.0	0.0	2	2	0
fam17490	2	2	2	2.0	0.0	0.0	2	2	0
fam17491	2	2	2	2.0	0.0	0.0	2	2	0
fam17492	2	2	2	2.0	0.0	0.0	2	2	0
fam17493	2	2	2	2.0	0.0	0.0	2	2	0
fam17494	2	2	2	2.0	0.0	0.0	2	2	0
fam17495	2	2	2	2.0	0.0	0.0	2	2	0
fam17496	2	2	2	2.0	0.0	0.0	2	2	0
fam17497	2	2	2	2.0	0.0	0.0	2	2	0
fam17498	2	2	2	2.0	0.0	0.0	2	2	0
fam17499	2	2	2	2.0	0.0	0.0	2	2	0
fam17500	2	2	2	2.0	0.0	0.0	2	2	0
fam17501	2	2	2	2.0	0.0	0.0	2	2	0
fam17502	2	2	2	2.0	0.0	0.0	2	2	0
fam17503	2	2	2	2.0	0.0	0.0	2	2	0
fam17504	2	2	2	2.0	0.0	0.0	2	2	0
fam17505	2	2	2	2.0	0.0	0.0	2	2	0
fam17506	2	2	2	2.0	0.0	0.0	2	2	0
fam17507	2	2	2	2.0	0.0	0.0	2	2	0
fam17508	2	2	2	2.0	0.0	0.0	2	2	0
fam17509	2	2	2	2.0	0.0	0.0	2	2	0
fam17510	2	2	2	2.0	0.0	0.0	2	2	0
fam17511	2	2	2	2.0	0.0	0.0	2	2	0
fam17512	2	2	2	2.0	0.0	0.0	2	2	0
fam17513	2	2	2	2.0	0.0	0.0	2	2	0
fam17514	2	2	2	2.0	0.0	0.0	2	2	0
fam17515	2	2	2	2.0	0.0	0.0	2	2	0
fam17516	2	2	2	2.0	0.0	0.0	2	2	0
fam17517	2	2	2	2.0	0.0	0.0	2	2	0
fam17518	2	2	2	2.0	0.0	0.0	2	2	0
fam17519	2	2	2	2.0	0.0	0.0	2	2	0
fam17520	2	2	2	2.0	0.0	0.0	2	2	0
fam17521	2	2	2	2.0	0.0	0.0	2	2	0
fam17522	2	2	2	2.0	0.0	0.0	2	2	0
fam17523	2	2	2	2.0	0.0	0.0	2	2	0
fam17524	2	2	2	2.0	0.0	0.0	2	2	0
fam17525	2	2	2	2.0	0.0	0.0	2	2	0
fam17526	2	2	2	2.0	0.0	0.0	2	2	0
fam17527	2	2	2	2.0	0.0	0.0	2	2	0
fam17528	2	2	2	2.0	0.0	0.0	2	2	0
fam17529	2	2	2	2.0	0.0	0.0	2	2	0
fam17530	2	2	2	2.0	0.0	0.0	2	2	0
fam17531	2	2	2	2.0	0.0	0.0	2	2	0
fam17532	2	2	2	2.0	0.0	0.0	2	2	0
fam17533	2	2	2	2.0	0.0	0.0	2	2	0
fam17534	2	2	2	2.0	0.0	0.0	2	2	0
fam17535	2	2	2	2.0	0.0	0.0	2	2	0
fam17536	2	2	2	2.0	0.0	0.0	2	2	0
fam17537	2	2	2	2.0	0.0	0.0	2	2	0
fam17538	2	2	2	2.0	0.0	0.0	2	2	0
fam17539	2	2	2	2.0	0.0	0.0	2	2	0
fam17540	2	2	2	2.0	0.0	0.0	2	2	0
fam17541	2	2	2	2.0	0.0	0.0	2	2	0
fam17542	2	2	2	2.0	0.0	0.0	2	2	0
fam17543	2	2	2	2.0	0.0	0.0	2	2	0
fam17544	2	2	2	2.0	0.0	0.0	2	2	0
fam17545	2	2	2	2.0	0.0	0.0	2	2	0
fam17546	2	2	2	2.0	0.0	0.0	2	2	0
fam17547	2	2	2	2.0	0.0	0.0	2	2	0
fam17548	2	2	2	2.0	0.0	0.0	2	2	0
fam17549	2	2	2	2.0	0.0	0.0	2	2	0
fam17550	2	2	2	2.0	0.0	0.0	2	2	0
fam17551	2	2	2	2.0	0.0	0.0	2	2	0
fam17552	2	2	2	2.0	0.0	0.0	2	2	0
fam17553	2	2	2	2.0	0.0	0.0	2	2	0
fam17554	2	2	2	2.0	0.0	0.0	2	2	0
fam17555	2	2	2	2.0	0.0	0.0	2	2	0
fam17556	2	2	2	2.0	0.0	0.0	2	2	0
fam17557	2	2	2	2.0	0.0	0.0	2	2	0
fam17558	2	2	2	2.0	0.0	0.0	2	2	0
fam17559	2	2	2	2.0	0.0	0.0	2	2	0
fam17560	2	2	2	2.0	0.0	0.0	2	2	0
fam17561	2	2	2	2.0	0.0	0.0	2	2	0
fam17562	2	2	2	2.0	0.0	0.0	2	2	0
fam17563	2	2	2	2.0	0.0	0.0	2	2	0
fam17564	2	2	2	2.0	0.0	0.0	2	2	0
fam17565	2	2	2	2.0	0.0	0.0	2	2	0
fam17566	2	2	2	2.0	0.0	0.0	2	2	0
fam17567	2	2	2	2.0	0.0	0.0	2	2	0
fam17568	2	2	2	2.0	0.0	0.0	2	2	0
fam17569	2	2	2	2.0	0.0	0.0	2	2	0
fam17570	2	2	2	2.0	0.0	0.0	2	2	0
fam17571	2	2	2	2.0	0.0	0.0	2	2	0
fam17572	2	2	2	2.0	0.0	0.0	2	2	0
fam17573	2	2	2	2.0	0.0	0.0	2	2	0
fam17574	2	2	2	2.0	0.0	0.0	2	2	0
fam17575	2	2	2	2.0	0.0	0.0	2	2	0
fam17576	2	2	2	2.0	0.0	0.0	2	2	0
fam17577	2	2	2	2.0	0.0	0.0	2	2	0
fam17578	2	2	2	2.0	0.0	0.0	2	2	0
fam17579	2	2	2	2.0	0.0	0.0	2	2	0
fam17580	2	2	2	2.0	0.0	0.0	2	2	0
fam17581	2	2	2	2.0	0.0	0.0	2	2	0
fam17582	2	2	2	2.0	0.0	0.0	2	2	0
fam17583	2	2	2	2.0	0.0	0.0	2	2	0
fam17584	2	2	2	2.0	0.0	0.0	2	2	0
fam17585	2	2	2	2.0	0.0	0.0	2	2	0
fam17586	2	2	2	2.0	0.0	0.0	2	2	0
fam17587	2	2	2	2.0	0.0	0.0	2	2	0
fam17588	2	2	2	2.0	0.0	0.0	2	2	0
fam17589	2	2	2	2.0	0.0	0.0	2	2	0
fam17590	2	2	2	2.0	0.0	0.0	2	2	0
fam17591	2	2	2	2.0	0.0	0.0	2	2	0
fam17592	2	2	2	2.0	0.0	0.0	2	2	0
fam17593	2	2	2	2.0	0.0	0.0	2	2	0
fam17594	2	2	2	2.0	0.0	0.0	2	2	0
fam17595	2	2	2	2.0	0.0	0.0	2	2	0
fam17596	2	2	2	2.0	0.0	0.0	2	2	0
fam17597	2	2	2	2.0	0.0	0.0	2	2	0
fam17598	2	2	2	2.0	0.0	0.0	2	2	0
fam17599	2	2	2	2.0	0.0	0.0	2	2	0
fam17600	2	2	2	2.0	0.0	0.0	2	2	0
fam17601	2	2	2	2.0	0.0	0.0	2	2	0
fam17602	2	2	2	2.0	0.0	0.0	2	2	0
fam17603	2	2	2	2.0	0.0	0.0	2	2	0
fam17604	2	2	2	2.0	0.0	0.0	2	2	0
fam17605	2	2	2	2.0	0.0	0.0	2	2	0
fam17606	2	2	2	2.0	0.0	0.0	2	2	0
fam17607	2	2	2	2.0	0.0	0.0	2	2	0
fam17608	2	2	2	2.0	0.0	0.0	2	2	0
fam17609	2	2	2	2.0	0.0	0.0	2	2	0
fam17610	2	2	2	2.0	0.0	0.0	2	2	0
fam17611	2	2	2	2.0	0.0	0.0	2	2	0
fam17612	2	2	2	2.0	0.0	0.0	2	2	0
fam17613	2	2	2	2.0	0.0	0.0	2	2	0
fam17614	2	2	2	2.0	0.0	0.0	2	2	0
fam17615	2	2	2	2.0	0.0	0.0	2	2	0
fam17616	2	2	2	2.0	0.0	0.0	2	2	0
fam17617	2	2	2	2.0	0.0	0.0	2	2	0
fam17618	2	2	2	2.0	0.0	0.0	2	2	0
fam17619	2	2	2	2.0	0.0	0.0	2	2	0
fam17620	2	2	2	2.0	0.0	0.0	2	2	0
fam17621	2	2	2	2.0	0.0	0.0	2	2	0
fam17622	2	2	2	2.0	0.0	0.0	2	2	0
fam17623	2	2	2	2.0	0.0	0.0	2	2	0
fam17624	2	2	2	2.0	0.0	0.0	2	2	0
fam17625	2	2	2	2.0	0.0	0.0	2	2	0
fam17626	2	2	2	2.0	0.0	0.0	2	2	0
fam17627	2	2	2	2.0	0.0	0.0	2	2	0
fam17628	2	2	2	2.0	0.0	0.0	2	2	0
fam17629	2	2	2	2.0	0.0	0.0	2	2	0
fam17630	2	2	2	2.0	0.0	0.0	2	2	0
fam17631	2	2	2	2.0	0.0	0.0	2	2	0
fam17632	2	2	2	2.0	0.0	0.0	2	2	0
fam17633	2	2	2	2.0	0.0	0.0	2	2	0
fam17634	2	2	2	2.0	0.0	0.0	2	2	0
fam17635	2	2	2	2.0	0.0	0.0	2	2	0
fam17636	2	2	2	2.0	0.0	0.0	2	2	0
fam17637	2	2	2	2.0	0.0	0.0	2	2	0
fam17638	2	2	2	2.0	0.0	0.0	2	2	0
fam17639	2	2	2	2.0	0.0	0.0	2	2	0
fam17640	2	2	2	2.0	0.0	0.0	2	2	0
fam17641	2	2	2	2.0	0.0	0.0	2	2	0
fam17642	2	2	2	2.0	0.0	0.0	2	2	0
fam17643	2	2	2	2.0	0.0	0.0	2	2	0
fam17644	2	2	2	2.0	0.0	0.0	2	2	0
fam17645	2	2	2	2.0	0.0	0.0	2	2	0
fam17646	2	2	2	2.0	0.0	0.0	2	2	0
fam17647	2	2	2	2.0	0.0	0.0	2	2	0
fam17648	2	2	2	2.0	0.0	0.0	2	2	0
fam17649	2	2	2	2.0	0.0	0.0	2	2	0
fam17650	2	2	2	2.0	0.0	0.0	2	2	0
fam17651	2	2	2	2.0	0.0	0.0	2	2	0
fam17652	2	2	2	2.0	0.0	0.0	2	2	0
fam17653	2	2	2	2.0	0.0	0.0	2	2	0
fam17654	2	2	2	2.0	0.0	0.0	2	2	0
fam17655	2	2	2	2.0	0.0	0.0	2	2	0
fam17656	2	2	2	2.0	0.0	0.0	2	2	0
fam17657	2	2	2	2.0	0.0	0.0	2	2	0
fam17658	2	2	2	2.0	0.0	0.0	2	2	0
fam17659	2	2	2	2.0	0.0	0.0	2	2	0
fam17660	2	2	2	2.0	0.0	0.0	2	2	0
fam17661	2	2	2	2.0	0.0	0.0	2	2	0
fam17662	2	2	2	2.0	0.0	0.0	2	2	0
fam17663	2	2	2	2.0	0.0	0.0	2	2	0
fam17664	2	2	2	2.0	0.0	0.0	2	2	0
fam17665	2	2	2	2.0	0.0	0.0	2	2	0
fam17666	2	2	2	2.0	0.0	0.0	2	2	0
fam17667	2	2	2	2.0	0.0	0.0	2	2	0
fam17668	2	2	2	2.0	0.0	0.0	2	2	0
fam17669	2	2	2	2.0	0.0	0.0	2	2	0
fam17670	2	2	2	2.0	0.0	0.0	2	2	0
fam17671	2	2	2	2.0	0.0	0.0	2	2	0
fam17672	2	2	2	2.0	0.0	0.0	2	2	0
fam17673	2	2	2	2.0	0.0	0.0	2	2	0
fam17674	2	2	2	2.0	0.0	0.0	2	2	0
fam17675	2	2	2	2.0	0.0	0.0	2	2	0
fam17676	2	2	2	2.0	0.0	0.0	2	2	0
fam17677	2	2	2	2.0	0.0	0.0	2	2	0
fam17678	2	2	2	2.0	0.0	0.0	2	2	0
fam17679	2	2	2	2.0	0.0	0.0	2	2	0
fam17680	2	2	2	2.0	0.0	0.0	2	2	0
fam17681	2	2	2	2.0	0.0	0.0	2	2	0
fam17682	2	2	2	2.0	0.0	0.0	2	2	0
fam17683	2	2	2	2.0	0.0	0.0	2	2	0
fam17684	2	2	2	2.0	0.0	0.0	2	2	0
fam17685	2	2	2	2.0	0.0	0.0	2	2	0
fam17686	2	2	2	2.0	0.0	0.0	2	2	0
fam17687	2	2	2	2.0	0.0	0.0	2	2	0
fam17688	2	2	2	2.0	0.0	0.0	2	2	0
fam17689	2	2	2	2.0	0.0	0.0	2	2	0
fam17690	2	2	2	2.0	0.0	0.0	2	2	0
fam17691	2	2	2	2.0	0.0	0.0	2	2	0
fam17692	2	2	2	2.0	0.0	0.0	2	2	0
fam17693	2	2	2	2.0	0.0	0.0	2	2	0
fam17694	2	2	2	2.0	0.0	0.0	2	2	0
fam17695	2	2	2	2.0	0.0	0.0	2	2	0
fam17696	2	2	2	2.0	0.0	0.0	2	2	0
fam17697	2	2	2	2.0	0.0	0.0	2	2	0
fam17698	2	2	2	2.0	0.0	0.0	2	2	0
fam17699	2	2	2	2.0	0.0	0.0	2	2	0
fam17700	2	2	2	2.0	0.0	0.0	2	2	0
fam17701	2	2	2	2.0	0.0	0.0	2	2	0
fam17702	2	2	2	2.0	0.0	0.0	2	2	0
fam17703	2	2	2	2.0	0.0	0.0	2	2	0
fam17704	2	2	2	2.0	0.0	0.0	2	2	0
fam17705	2	2	2	2.0	0.0	0.0	2	2	0
fam17706	2	2	2	2.0	0.0	0.0	2	2	0
fam17707	2	2	2	2.0	0.0	0.0	2	2	0
fam17708	2	2	2	2.0	0.0	0.0	2	2	0
fam17709	2	2	2	2.0	0.0	0.0	2	2	0
fam17710	2	2	2	2.0	0.0	0.0	2	2	0
fam17711	2	2	2	2.0	0.0	0.0	2	2	0
fam17712	2	2	2	2.0	0.0	0.0	2	2	0
fam17713	2	2	2	2.0	0.0	0.0	2	2	0
fam17714	2	2	2	2.0	0.0	0.0	2	2	0
fam17715	2	2	2	2.0	0.0	0.0	2	2	0
fam17716	2	2	2	2.0	0.0	0.0	2	2	0
fam17717	2	2	2	2.0	0.0	0.0	2	2	0
fam17718	2	2	2	2.0	0.0	0.0	2	2	0
fam17719	2	2	2	2.0	0.0	0.0	2	2	0
fam17720	2	2	2	2.0	0.0	0.0	2	2	0
fam17721	2	2	2	2.0	0.0	0.0	2	2	0
fam17722	2	2	2	2.0	0.0	0.0	2	2	0
fam17723	2	2	2	2.0	0.0	0.0	2	2	0
fam17724	2	2	2	2.0	0.0	0.0	2	2	0
fam17725	2	2	2	2.0	0.0	0.0	2	2	0
fam17726	2	2	2	2.0	0.0	0.0	2	2	0
fam17727	2	2	2	2.0	0.0	0.0	2	2	0
fam17728	2	2	2	2.0	0.0	0.0	2	2	0
fam17729	2	2	2	2.0	0.0	0.0	2	2	0
fam17730	2	2	2	2.0	0.0	0.0	2	2	0
fam17731	2	2	2	2.0	0.0	0.0	2	2	0
fam17732	2	2	2	2.0	0.0	0.0	2	2	0
fam17733	2	2	2	2.0	0.0	0.0	2	2	0
fam17734	2	2	2	2.0	0.0	0.0	2	2	0
fam17735	2	2	2	2.0	0.0	0.0	2	2	0
fam17736	2	2	2	2.0	0.0	0.0	2	2	0
fam17737	2	2	2	2.0	0.0	0.0	2	2	0
fam17738	2	2	2	2.0	0.0	0.0	2	2	0
fam17739	2	2	2	2.0	0.0	0.0	2	2	0
fam17740	2	2	2	2.0	0.0	0.0	2	2	0
fam17741	2	2	2	2.0	0.0	0.0	2	2	0
fam17742	2	2	2	2.0	0.0	0.0	2	2	0
fam17743	2	2	2	2.0	0.0	0.0	2	2	0
fam17744	2	2	2	2.0	0.0	0.0	2	2	0
fam17745	2	2	2	2.0	0.0	0.0	2	2	0
fam17746	2	2	2	2.0	0.0	0.0	2	2	0
fam17747	2	2	2	2.0	0.0	0.0	2	2	0
fam17748	2	2	2	2.0	0.0	0.0	2	2	0
fam17749	2	2	2	2.0	0.0	0.0	2	2	0
fam17750	2	2	2	2.0	0.0	0.0	2	2	0
fam17751	2	2	2	2.0	0.0	0.0	2	2	0
fam17752	2	2	2	2.0	0.0	0.0	2	2	0
fam17753	2	2	2	2.0	0.0	0.0	2	2	0
fam17754	2	2	2	2.0	0.0	0.0	2	2	0
fam17755	2	2	2	2.0	0.0	0.0	2	2	0
fam17756	2	2	2	2.0	0.0	0.0	2	2	0
fam17757	2	2	2	2.0	0.0	0.0	2	2	0
fam17758	2	2	2	2.0	0.0	0.0	2	2	0
fam17759	2	2	2	2.0	0.0	0.0	2	2	0
fam17760	2	2	2	2.0	0.0	0.0	2	2	0
fam17761	2	2	2	2.0	0.0	0.0	2	2	0
fam17762	2	2	2	2.0	0.0	0.0	2	2	0
fam17763	2	2	2	2.0	0.0	0.0	2	2	0
fam17764	2	2	2	2.0	0.0	0.0	2	2	0
fam17765	2	2	2	2.0	0.0	0.0	2	2	0
fam17766	2	2	2	2.0	0.0	0.0	2	2	0
fam17767	2	2	2	2.0	0.0	0.0	2	2	0
fam17768	2	2	2	2.0	0.0	0.0	2	2	0
fam17769	2	2	2	2.0	0.0	0.0	2	2	0
fam17770	2	2	2	2.0	0.0	0.0	2	2	0
fam17771	2	2	2	2.0	0.0	0.0	2	2	0
fam17772	2	2	2	2.0	0.0	0.0	2	2	0
fam17773	2	2	2	2.0	0.0	0.0	2	2	0
fam17774	2	2	2	2.0	0.0	0.0	2	2	0
fam17775	2	2	2	2.0	0.0	0.0	2	2	0
fam17776	2	2	2	2.0	0.0	0.0	2	2	0
fam17777	2	2	2	2.0	0.0	0.0	2	2	0
fam17778	2	2	2	2.0	0.0	0.0	2	2	0
fam17779	2	2	2	2.0	0.0	0.0	2	2	0
fam17780	2	2	2	2.0	0.0	0.0	2	2	0
fam17781	2	2	2	2.0	0.0	0.0	2	2	0
fam17782	2	2	2	2.0	0.0	0.0	2	2	0
fam17783	2	2	2	2.0	0.0	0.0	2	2	0
fam17784	2	2	2	2.0	0.0	0.0	2	2	0
fam17785	2	2	2	2.0	0.0	0.0	2	2	0
fam17786	2	2	2	2.0	0.0	0.0	2	2	0
fam17787	2	2	2	2.0	0.0	0.0	2	2	0
fam17788	2	2	2	2.0	0.0	0.0	2	2	0
fam17789	2	2	2	2.0	0.0	0.0	2	2	0
fam17790	2	2	2	2.0	0.0	0.0	2	2	0
fam17791	2	2	2	2.0	0.0	0.0	2	2	0
fam17792	2	2	2	2.0	0.0	0.0	2	2	0
fam17793	2	2	2	2.0	0.0	0.0	2	2	0
fam17794	2	2	2	2.0	0.0	0.0	2	2	0
fam17795	2	2	2	2.0	0.0	0.0	2	2	0
fam17796	2	2	2	2.0	0.0	0.0	2	2	0
fam17797	2	2	2	2.0	0.0	0.0	2	2	0
fam17798	2	2	2	2.0	0.0	0.0	2	2	0
fam17799	2	2	2	2.0	0.0	0.0	2	2	0
fam17800	2	2	2	2.0	0.0	0.0	2	2	0
fam17801	2	2	2	2.0	0.0	0.0	2	2	0
fam17802	2	2	2	2.0	0.0	0.0	2	2	0
fam17803	2	2	2	2.0	0.0	0.0	2	2	0
fam17804	2	2	2	2.0	0.0	0.0	2	2	0
fam17805	2	2	2	2.0	0.0	0.0	2	2	0
fam17806	2	2	2	2.0	0.0	0.0	2	2	0
fam17807	2	2	2	2.0	0.0	0.0	2	2	0
fam17808	2	2	2	2.0	0.0	0.0	2	2	0
fam17809	2	2	2	2.0	0.0	0.0	2	2	0
fam17810	2	2	2	2.0	0.0	0.0	2	2	0
fam17811	2	2	2	2.0	0.0	0.0	2	2	0
fam17812	2	2	2	2.0	0.0	0.0	2	2	0
fam17813	2	2	2	2.0	0.0	0.0	2	2	0
fam17814	2	2	2	2.0	0.0	0.0	2	2	0
fam17815	2	2	2	2.0	0.0	0.0	2	2	0
fam17816	2	2	2	2.0	0.0	0.0	2	2	0
fam17817	2	2	2	2.0	0.0	0.0	2	2	0
fam17818	2	2	2	2.0	0.0	0.0	2	2	0
fam17819	2	2	2	2.0	0.0	0.0	2	2	0
fam17820	2	2	2	2.0	0.0	0.0	2	2	0
fam17821	2	2	2	2.0	0.0	0.0	2	2	0
fam17822	2	2	2	2.0	0.0	0.0	2	2	0
fam17823	2	2	2	2.0	0.0	0.0	2	2	0
fam17824	2	2	2	2.0	0.0	0.0	2	2	0
fam17825	2	2	2	2.0	0.0	0.0	2	2	0
fam17826	2	2	2	2.0	0.0	0.0	2	2	0
fam17827	2	2	2	2.0	0.0	0.0	2	2	0
fam17828	2	2	2	2.0	0.0	0.0	2	2	0
fam17829	2	2	2	2.0	0.0	0.0	2	2	0
fam17830	2	2	2	2.0	0.0	0.0	2	2	0
fam17831	2	2	2	2.0	0.0	0.0	2	2	0
fam17832	2	2	2	2.0	0.0	0.0	2	2	0
fam17833	2	2	2	2.0	0.0	0.0	2	2	0
fam17834	2	2	2	2.0	0.0	0.0	2	2	0
fam17835	2	2	2	2.0	0.0	0.0	2	2	0
fam17836	2	2	2	2.0	0.0	0.0	2	2	0
fam17837	2	2	2	2.0	0.0	0.0	2	2	0
fam17838	2	2	2	2.0	0.0	0.0	2	2	0
fam17839	2	2	2	2.0	0.0	0.0	2	2	0
fam17840	2	2	2	2.0	0.0	0.0	2	2	0
fam17841	2	2	2	2.0	0.0	0.0	2	2	0
fam17842	2	2	2	2.0	0.0	0.0	2	2	0
fam17843	2	2	2	2.0	0.0	0.0	2	2	0
fam17844	2	2	2	2.0	0.0	0.0	2	2	0
fam17845	2	2	2	2.0	0.0	0.0	2	2	0
fam17846	2	2	2	2.0	0.0	0.0	2	2	0
fam17847	2	2	2	2.0	0.0	0.0	2	2	0
fam17848	2	2	2	2.0	0.0	0.0	2	2	0
fam17849	2	2	2	2.0	0.0	0.0	2	2	0
fam17850	2	2	2	2.0	0.0	0.0	2	2	0
fam17851	2	2	2	2.0	0.0	0.0	2	2	0
fam17852	2	2	2	2.0	0.0	0.0	2	2	0
fam17853	2	2	2	2.0	0.0	0.0	2	2	0
fam17854	2	2	2	2.0	0.0	0.0	2	2	0
fam17855	2	2	2	2.0	0.0	0.0	2	2	0
fam17856	2	2	2	2.0	0.0	0.0	2	2	0
fam17857	2	2	2	2.0	0.0	0.0	2	2	0
fam17858	2	2	2	2.0	0.0	0.0	2	2	0
fam17859	2	2	2	2.0	0.0	0.0	2	2	0
fam17860	2	2	2	2.0	0.0	0.0	2	2	0
fam17861	2	2	2	2.0	0.0	0.0	2	2	0
fam17862	2	2	2	2.0	0.0	0.0	2	2	0
fam17863	2	2	2	2.0	0.0	0.0	2	2	0
fam17864	2	2	2	2.0	0.0	0.0	2	2	0
fam17865	2	2	2	2.0	0.0	0.0	2	2	0
fam17866	2	2	2	2.0	0.0	0.0	2	2	0
fam17867	2	2	2	2.0	0.0	0.0	2	2	0
fam17868	2	2	2	2.0	0.0	0.0	2	2	0
fam17869	2	2	2	2.0	0.0	0.0	2	2	0
fam17870	2	2	2	2.0	0.0	0.0	2	2	0
fam17871	2	2	2	2.0	0.0	0.0	2	2	0
fam17872	2	2	2	2.0	0.0	0.0	2	2	0
fam17873	2	2	2	2.0	0.0	0.0	2	2	0
fam17874	2	2	2	2.0	0.0	0.0	2	2	0
fam17875	2	2	2	2.0	0.0	0.0	2	2	0
fam17876	2	2	2	2.0	0.0	0.0	2	2	0
fam17877	2	2	2	2.0	0.0	0.0	2	2	0
fam17878	2	2	2	2.0	0.0	0.0	2	2	0
fam17879	2	2	2	2.0	0.0	0.0	2	2	0
fam17880	2	2	2	2.0	0.0	0.0	2	2	0
fam17881	2	2	2	2.0	0.0	0.0	2	2	0
fam17882	2	2	2	2.0	0.0	0.0	2	2	0
fam17883	2	2	2	2.0	0.0	0.0	2	2	0
fam17884	2	2	2	2.0	0.0	0.0	2	2	0
fam17885	2	2	2	2.0	0.0	0.0	2	2	0
fam17886	2	2	2	2.0	0.0	0.0	2	2	0
fam17887	2	2	2	2.0	0.0	0.0	2	2	0
fam17888	2	2	2	2.0	0.0	0.0	2	2	0
fam17889	2	2	2	2.0	0.0	0.0	2	2	0
fam17890	2	2	2	2.0	0.0	0.0	2	2	0
fam17891	2	2	2	2.0	0.0	0.0	2	2	0
fam17892	2	2	2	2.0	0.0	0.0	2	2	0
fam17893	2	2	2	2.0	0.0	0.0	2	2	0
fam17894	2	2	2	2.0	0.0	0.0	2	2	0
fam17895	2	2	2	2.0	0.0	0.0	2	2	0
fam17896	2	2	2	2.0	0.0	0.0	2	2	0
fam17897	2	2	2	2.0	0.0	0.0	2	2	0
fam17898	2	2	2	2.0	0.0	0.0	2	2	0
fam17899	2	2	2	2.0	0.0	0.0	2	2	0
fam17900	2	2	2	2.0	0.0	0.0	2	2	0
fam17901	2	2	2	2.0	0.0	0.0	2	2	0
fam17902	2	2	2	2.0	0.0	0.0	2	2	0
fam17903	2	2	2	2.0	0.0	0.0	2	2	0
fam17904	2	2	2	2.0	0.0	0.0	2	2	0
fam17905	2	2	2	2.0	0.0	0.0	2	2	0
fam17906	2	2	2	2.0	0.0	0.0	2	2	0
fam17907	2	2	2	2.0	0.0	0.0	2	2	0
fam17908	2	2	2	2.0	0.0	0.0	2	2	0
fam17909	2	2	2	2.0	0.0	0.0	2	2	0
fam17910	2	2	2	2.0	0.0	0.0	2	2	0
fam17911	2	2	2	2.0	0.0	0.0	2	2	0
fam17912	2	2	2	2.0	0.0	0.0	2	2	0
fam17913	2	2	2	2.0	0.0	0.0	2	2	0
fam17914	2	2	2	2.0	0.0	0.0	2	2	0
fam17915	2	2	2	2.0	0.0	0.0	2	2	0
fam17916	2	2	2	2.0	0.0	0.0	2	2	0
fam17917	2	2	2	2.0	0.0	0.0	2	2	0
fam17918	2	2	2	2.0	0.0	0.0	2	2	0
fam17919	2	2	2	2.0	0.0	0.0	2	2	0
fam17920	2	2	2	2.0	0.0	0.0	2	2	0
fam17921	2	2	2	2.0	0.0	0.0	2	2	0
fam17922	2	2	2	2.0	0.0	0.0	2	2	0
fam17923	2	2	2	2.0	0.0	0.0	2	2	0
fam17924	2	2	2	2.0	0.0	0.0	2	2	0
fam17925	2	2	2	2.0	0.0	0.0	2	2	0
fam17926	2	2	2	2.0	0.0	0.0	2	2	0
fam17927	2	2	2	2.0	0.0	0.0	2	2	0
fam17928	2	2	2	2.0	0.0	0.0	2	2	0
fam17929	2	2	2	2.0	0.0	0.0	2	2	0
fam17930	2	2	2	2.0	0.0	0.0	2	2	0
fam17931	2	2	2	2.0	0.0	0.0	2	2	0
fam17932	2	2	2	2.0	0.0	0.0	2	2	0
fam17933	2	2	2	2.0	0.0	0.0	2	2	0
fam17934	2	2	2	2.0	0.0	0.0	2	2	0
fam17935	2	2	2	2.0	0.0	0.0	2	2	0
fam17936	2	2	2	2.0	0.0	0.0	2	2	0
fam17937	2	2	2	2.0	0.0	0.0	2	2	0
fam17938	2	2	2	2.0	0.0	0.0	2	2	0
fam17939	2	2	2	2.0	0.0	0.0	2	2	0
fam17940	2	2	2	2.0	0.0	0.0	2	2	0
fam17941	2	2	2	2.0	0.0	0.0	2	2	0
fam17942	2	2	2	2.0	0.0	0.0	2	2	0
fam17943	2	2	2	2.0	0.0	0.0	2	2	0
fam17944	2	2	2	2.0	0.0	0.0	2	2	0
fam17945	2	2	2	2.0	0.0	0.0	2	2	0
fam17946	2	2	2	2.0	0.0	0.0	2	2	0
fam17947	2	2	2	2.0	0.0	0.0	2	2	0
fam17948	2	2	2	2.0	0.0	0.0	2	2	0
fam17949	2	2	2	2.0	0.0	0.0	2	2	0
fam17950	2	2	2	2.0	0.0	0.0	2	2	0
fam17951	2	2	2	2.0	0.0	0.0	2	2	0
fam17952	2	2	2	2.0	0.0	0.0	2	2	0
fam17953	2	2	2	2.0	0.0	0.0	2	2	0
fam17954	2	2	2	2.0	0.0	0.0	2	2	0
fam17955	2	2	2	2.0	0.0	0.0	2	2	0
fam17956	2	2	2	2.0	0.0	0.0	2	2	0
fam17957	2	2	2	2.0	0.0	0.0	2	2	0
fam17958	2	2	2	2.0	0.0	0.0	2	2	0
fam17959	2	2	2	2.0	0.0	0.0	2	2	0
fam17960	2	2	2	2.0	0.0	0.0	2	2	0
fam17961	2	2	2	2.0	0.0	0.0	2	2	0
fam17962	2	2	2	2.0	0.0	0.0	2	2	0
fam17963	2	2	2	2.0	0.0	0.0	2	2	0
fam17964	2	2	2	2.0	0.0	0.0	2	2	0
fam17965	2	2	2	2.0	0.0	0.0	2	2	0
fam17966	2	2	2	2.0	0.0	0.0	2	2	0
fam17967	2	2	2	2.0	0.0	0.0	2	2	0
fam17968	2	2	2	2.0	0.0	0.0	2	2	0
fam17969	2	2	2	2.0	0.0	0.0	2	2	0
fam17970	2	2	2	2.0	0.0	0.0	2	2	0
fam17971	2	2	2	2.0	0.0	0.0	2	2	0
fam17972	2	2	2	2.0	0.0	0.0	2	2	0
fam17973	2	2	2	2.0	0.0	0.0	2	2	0
fam17974	2	2	2	2.0	0.0	0.0	2	2	0
fam17975	2	2	2	2.0	0.0	0.0	2	2	0
fam17976	2	2	2	2.0	0.0	0.0	2	2	0
fam17977	2	2	2	2.0	0.0	0.0	2	2	0
fam17978	2	2	2	2.0	0.0	0.0	2	2	0
fam17979	2	2	2	2.0	0.0	0.0	2	2	0
fam17980	2	2	2	2.0	0.0	0.0	2	2	0
fam17981	2	2	2	2.0	0.0	0.0	2	2	0
fam17982	2	2	2	2.0	0.0	0.0	2	2	0
fam17983	2	2	2	2.0	0.0	0.0	2	2	0
fam17984	2	2	2	2.0	0.0	0.0	2	2	0
fam17985	2	2	2	2.0	0.0	0.0	2	2	0
fam17986	2	2	2	2.0	0.0	0.0	2	2	0
fam17987	2	2	2	2.0	0.0	0.0	2	2	0
fam17988	2	2	2	2.0	0.0	0.0	2	2	0
fam17989	2	2	2	2.0	0.0	0.0	2	2	0
fam17990	2	2	2	2.0	0.0	0.0	2	2	0
fam17991	2	2	2	2.0	0.0	0.0	2	2	0
fam17992	2	2	2	2.0	0.0	0.0	2	2	0
fam17993	2	2	2	2.0	0.0	0.0	2	2	0
fam17994	2	2	2	2.0	0.0	0.0	2	2	0
fam17995	2	2	2	2.0	0.0	0.0	2	2	0
fam17996	2	2	2	2.0	0.0	0.0	2	2	0
fam17997	2	2	2	2.0	0.0	0.0	2	2	0
fam17998	2	2	2	2.0	0.0	0.0	2	2	0
fam17999	2	2	2	2.0	0.0	0.0	2	2	0
fam18000	2	2	2	2.0	0.0	0.0	2	2	0
fam18001	2	2	2	2.0	0.0	0.0	2	2	0
fam18002	2	2	2	2.0	0.0	0.0	2	2	0
fam18003	2	2	2	2.0	0.0	0.0	2	2	0
fam18004	2	2	2	2.0	0.0	0.0	2	2	0
fam18005	2	2	2	2.0	0.0	0.0	2	2	0
fam18006	2	2	2	2.0	0.0	0.0	2	2	0
fam18007	2	2	2	2.0	0.0	0.0	2	2	0
fam18008	2	2	2	2.0	0.0	0.0	2	2	0
fam18009	2	2	2	2.0	0.0	0.0	2	2	0
fam18010	2	2	2	2.0	0.0	0.0	2	2	0
fam18011	2	2	2	2.0	0.0	0.0	2	2	0
fam18012	2	2	2	2.0	0.0	0.0	2	2	0
fam18013	2	2	2	2.0	0.0	0.0	2	2	0
fam18014	2	2	2	2.0	0.0	0.0	2	2	0
fam18015	2	2	2	2.0	0.0	0.0	2	2	0
fam18016	2	2	2	2.0	0.0	0.0	2	2	0
fam18017	2	2	2	2.0	0.0	0.0	2	2	0
fam18018	2	2	2	2.0	0.0	0.0	2	2	0
fam18019	2	2	2	2.0	0.0	0.0	2	2	0
fam18020	2	2	2	2.0	0.0	0.0	2	2	0
fam18021	2	2	2	2.0	0.0	0.0	2	2	0
fam18022	2	2	2	2.0	0.0	0.0	2	2	0
fam18023	2	2	2	2.0	0.0	0.0	2	2	0
fam18024	2	2	2	2.0	0.0	0.0	2	2	0
fam18025	2	2	2	2.0	0.0	0.0	2	2	0
fam18026	2	2	2	2.0	0.0	0.0	2	2	0
fam18027	2	2	2	2.0	0.0	0.0	2	2	0
fam18028	2	2	2	2.0	0.0	0.0	2	2	0
fam18029	2	2	2	2.0	0.0	0.0	2	2	0
fam18030	2	2	2	2.0	0.0	0.0	2	2	0
fam18031	2	2	2	2.0	0.0	0.0	2	2	0
fam18032	2	2	2	2.0	0.0	0.0	2	2	0
fam18033	2	2	2	2.0	0.0	0.0	2	2	0
fam18034	2	2	2	2.0	0.0	0.0	2	2	0
fam18035	2	2	2	2.0	0.0	0.0	2	2	0
fam18036	2	2	2	2.0	0.0	0.0	2	2	0
fam18037	2	2	2	2.0	0.0	0.0	2	2	0
fam18038	2	2	2	2.0	0.0	0.0	2	2	0
fam18039	2	2	2	2.0	0.0	0.0	2	2	0
fam18040	2	2	2	2.0	0.0	0.0	2	2	0
fam18041	2	2	2	2.0	0.0	0.0	2	2	0
fam18042	2	2	2	2.0	0.0	0.0	2	2	0
fam18043	2	2	2	2.0	0.0	0.0	2	2	0
fam18044	2	2	2	2.0	0.0	0.0	2	2	0
fam18045	2	2	2	2.0	0.0	0.0	2	2	0
fam18046	2	2	2	2.0	0.0	0.0	2	2	0
fam18047	2	2	2	2.0	0.0	0.0	2	2	0
fam18048	2	2	2	2.0	0.0	0.0	2	2	0
fam18049	2	2	2	2.0	0.0	0.0	2	2	0
fam18050	2	2	2	2.0	0.0	0.0	2	2	0
fam18051	2	2	2	2.0	0.0	0.0	2	2	0
fam18052	2	2	2	2.0	0.0	0.0	2	2	0
fam18053	2	2	2	2.0	0.0	0.0	2	2	0
fam18054	2	2	2	2.0	0.0	0.0	2	2	0
fam18055	2	2	2	2.0	0.0	0.0	2	2	0
fam18056	2	2	2	2.0	0.0	0.0	2	2	0
fam18057	2	2	2	2.0	0.0	0.0	2	2	0
fam18058	2	2	2	2.0	0.0	0.0	2	2	0
fam18059	2	2	2	2.0	0.0	0.0	2	2	0
fam18060	2	2	2	2.0	0.0	0.0	2	2	0
fam18061	2	2	2	2.0	0.0	0.0	2	2	0
fam18062	2	2	2	2.0	0.0	0.0	2	2	0
fam18063	2	2	2	2.0	0.0	0.0	2	2	0
fam18064	2	2	2	2.0	0.0	0.0	2	2	0
fam18065	2	2	2	2.0	0.0	0.0	2	2	0
fam18066	2	2	2	2.0	0.0	0.0	2	2	0
fam18067	2	2	2	2.0	0.0	0.0	2	2	0
fam18068	2	2	2	2.0	0.0	0.0	2	2	0
fam18069	2	2	2	2.0	0.0	0.0	2	2	0
fam18070	2	2	2	2.0	0.0	0.0	2	2	0
fam18071	2	2	2	2.0	0.0	0.0	2	2	0
fam18072	2	2	2	2.0	0.0	0.0	2	2	0
fam18073	2	2	2	2.0	0.0	0.0	2	2	0
fam18074	2	2	2	2.0	0.0	0.0	2	2	0
fam18075	2	2	2	2.0	0.0	0.0	2	2	0
fam18076	2	2	2	2.0	0.0	0.0	2	2	0
fam18077	2	2	2	2.0	0.0	0.0	2	2	0
fam18078	2	2	2	2.0	0.0	0.0	2	2	0
fam18079	2	2	2	2.0	0.0	0.0	2	2	0
fam18080	2	2	2	2.0	0.0	0.0	2	2	0
fam18081	2	2	2	2.0	0.0	0.0	2	2	0
fam18082	2	2	2	2.0	0.0	0.0	2	2	0
fam18083	2	2	2	2.0	0.0	0.0	2	2	0
fam18084	2	2	2	2.0	0.0	0.0	2	2	0
fam18085	2	2	2	2.0	0.0	0.0	2	2	0
fam18086	2	2	2	2.0	0.0	0.0	2	2	0
fam18087	2	2	2	2.0	0.0	0.0	2	2	0
fam18088	2	2	2	2.0	0.0	0.0	2	2	0
fam18089	2	2	2	2.0	0.0	0.0	2	2	0
fam18090	2	2	2	2.0	0.0	0.0	2	2	0
fam18091	2	2	2	2.0	0.0	0.0	2	2	0
fam18092	2	2	2	2.0	0.0	0.0	2	2	0
fam18093	2	2	2	2.0	0.0	0.0	2	2	0
fam18094	2	2	2	2.0	0.0	0.0	2	2	0
fam18095	2	2	2	2.0	0.0	0.0	2	2	0
fam18096	2	2	2	2.0	0.0	0.0	2	2	0
fam18097	2	2	2	2.0	0.0	0.0	2	2	0
fam18098	2	2	2	2.0	0.0	0.0	2	2	0
fam18099	2	2	2	2.0	0.0	0.0	2	2	0
fam18100	2	2	2	2.0	0.0	0.0	2	2	0
fam18101	2	2	2	2.0	0.0	0.0	2	2	0
fam18102	2	2	2	2.0	0.0	0.0	2	2	0
fam18103	2	2	2	2.0	0.0	0.0	2	2	0
fam18104	2	2	2	2.0	0.0	0.0	2	2	0
fam18105	2	2	2	2.0	0.0	0.0	2	2	0
fam18106	2	2	2	2.0	0.0	0.0	2	2	0
fam18107	2	2	2	2.0	0.0	0.0	2	2	0
fam18108	2	2	2	2.0	0.0	0.0	2	2	0
fam18109	2	2	2	2.0	0.0	0.0	2	2	0
fam18110	2	2	2	2.0	0.0	0.0	2	2	0
fam18111	2	2	2	2.0	0.0	0.0	2	2	0
fam18112	2	2	2	2.0	0.0	0.0	2	2	0
fam18113	2	2	2	2.0	0.0	0.0	2	2	0
fam18114	2	2	2	2.0	0.0	0.0	2	2	0
fam18115	2	2	2	2.0	0.0	0.0	2	2	0
fam18116	2	2	2	2.0	0.0	0.0	2	2	0
fam18117	2	2	2	2.0	0.0	0.0	2	2	0
fam18118	2	2	2	2.0	0.0	0.0	2	2	0
fam18119	2	2	2	2.0	0.0	0.0	2	2	0
fam18120	2	2	2	2.0	0.0	0.0	2	2	0
fam18121	2	2	2	2.0	0.0	0.0	2	2	0
fam18122	2	2	2	2.0	0.0	0.0	2	2	0
fam18123	2	2	2	2.0	0.0	0.0	2	2	0
fam18124	2	2	2	2.0	0.0	0.0	2	2	0
fam18125	2	2	2	2.0	0.0	0.0	2	2	0
fam18126	2	2	2	2.0	0.0	0.0	2	2	0
fam18127	2	2	2	2.0	0.0	0.0	2	2	0
fam18128	2	2	2	2.0	0.0	0.0	2	2	0
fam18129	2	2	2	2.0	0.0	0.0	2	2	0
fam18130	2	2	2	2.0	0.0	0.0	2	2	0
fam18131	2	2	2	2.0	0.0	0.0	2	2	0
fam18132	2	2	2	2.0	0.0	0.0	2	2	0
fam18133	2	2	2	2.0	0.0	0.0	2	2	0
fam18134	2	2	2	2.0	0.0	0.0	2	2	0
fam18135	2	2	2	2.0	0.0	0.0	2	2	0
fam18136	2	2	2	2.0	0.0	0.0	2	2	0
fam18137	2	2	2	2.0	0.0	0.0	2	2	0
fam18138	2	2	2	2.0	0.0	0.0	2	2	0
fam18139	2	2	2	2.0	0.0	0.0	2	2	0
fam18140	2	2	2	2.0	0.0	0.0	2	2	0
fam18141	2	2	2	2.0	0.0	0.0	2	2	0
fam18142	2	2	2	2.0	0.0	0.0	2	2	0
fam18143	2	2	2	2.0	0.0	0.0	2	2	0
fam18144	2	2	2	2.0	0.0	0.0	2	2	0
fam18145	2	2	2	2.0	0.0	0.0	2	2	0
fam18146	2	2	2	2.0	0.0	0.0	2	2	0
fam18147	2	2	2	2.0	0.0	0.0	2	2	0
fam18148	2	2	2	2.0	0.0	0.0	2	2	0
fam18149	2	2	2	2.0	0.0	0.0	2	2	0
fam18150	2	2	2	2.0	0.0	0.0	2	2	0
fam18151	2	2	2	2.0	0.0	0.0	2	2	0
fam18152	2	2	2	2.0	0.0	0.0	2	2	0
fam18153	2	2	2	2.0	0.0	0.0	2	2	0
fam18154	2	2	2	2.0	0.0	0.0	2	2	0
fam18155	2	2	2	2.0	0.0	0.0	2	2	0
fam18156	2	2	2	2.0	0.0	0.0	2	2	0
fam18157	2	2	2	2.0	0.0	0.0	2	2	0
fam18158	2	2	2	2.0	0.0	0.0	2	2	0
fam18159	2	2	2	2.0	0.0	0.0	2	2	0
fam18160	2	2	2	2.0	0.0	0.0	2	2	0
fam18161	2	2	2	2.0	0.0	0.0	2	2	0
fam18162	2	2	2	2.0	0.0	0.0	2	2	0
fam18163	2	2	2	2.0	0.0	0.0	2	2	0
fam18164	2	2	2	2.0	0.0	0.0	2	2	0
fam18165	2	2	2	2.0	0.0	0.0	2	2	0
fam18166	2	2	2	2.0	0.0	0.0	2	2	0
fam18167	2	2	2	2.0	0.0	0.0	2	2	0
fam18168	2	2	2	2.0	0.0	0.0	2	2	0
fam18169	2	2	2	2.0	0.0	0.0	2	2	0
fam18170	2	2	2	2.0	0.0	0.0	2	2	0
fam18171	2	2	2	2.0	0.0	0.0	2	2	0
fam18172	2	2	2	2.0	0.0	0.0	2	2	0
fam18173	2	2	2	2.0	0.0	0.0	2	2	0
fam18174	2	2	2	2.0	0.0	0.0	2	2	0
fam18175	2	2	2	2.0	0.0	0.0	2	2	0
fam18176	2	2	2	2.0	0.0	0.0	2	2	0
fam18177	2	2	2	2.0	0.0	0.0	2	2	0
fam18178	2	2	2	2.0	0.0	0.0	2	2	0
fam18179	2	2	2	2.0	0.0	0.0	2	2	0
fam18180	2	2	2	2.0	0.0	0.0	2	2	0
fam18181	2	2	2	2.0	0.0	0.0	2	2	0
fam18182	2	2	2	2.0	0.0	0.0	2	2	0
fam18183	2	2	2	2.0	0.0	0.0	2	2	0
fam18184	2	2	2	2.0	0.0	0.0	2	2	0
fam18185	2	2	2	2.0	0.0	0.0	2	2	0
fam18186	2	2	2	2.0	0.0	0.0	2	2	0
fam18187	2	2	2	2.0	0.0	0.0	2	2	0
fam18188	2	2	2	2.0	0.0	0.0	2	2	0
fam18189	2	2	2	2.0	0.0	0.0	2	2	0
fam18190	2	2	2	2.0	0.0	0.0	2	2	0
fam18191	2	2	2	2.0	0.0	0.0	2	2	0
fam18192	2	2	2	2.0	0.0	0.0	2	2	0
fam18193	2	2	2	2.0	0.0	0.0	2	2	0
fam18194	2	2	2	2.0	0.0	0.0	2	2	0
fam18195	2	2	2	2.0	0.0	0.0	2	2	0
fam18196	2	2	2	2.0	0.0	0.0	2	2	0
fam18197	2	2	2	2.0	0.0	0.0	2	2	0
fam18198	2	2	2	2.0	0.0	0.0	2	2	0
fam18199	2	2	2	2.0	0.0	0.0	2	2	0
fam18200	2	2	2	2.0	0.0	0.0	2	2	0
fam18201	2	2	2	2.0	0.0	0.0	2	2	0
fam18202	2	2	2	2.0	0.0	0.0	2	2	0
fam18203	2	2	2	2.0	0.0	0.0	2	2	0
fam18204	2	2	2	2.0	0.0	0.0	2	2	0
fam18205	2	2	2	2.0	0.0	0.0	2	2	0
fam18206	2	2	2	2.0	0.0	0.0	2	2	0
fam18207	2	2	2	2.0	0.0	0.0	2	2	0
fam18208	2	2	2	2.0	0.0	0.0	2	2	0
fam18209	2	2	2	2.0	0.0	0.0	2	2	0
fam18210	2	2	2	2.0	0.0	0.0	2	2	0
fam18211	2	2	2	2.0	0.0	0.0	2	2	0
fam18212	2	2	2	2.0	0.0	0.0	2	2	0
fam18213	2	2	2	2.0	0.0	0.0	2	2	0
fam18214	2	2	2	2.0	0.0	0.0	2	2	0
fam18215	2	2	2	2.0	0.0	0.0	2	2	0
fam18216	2	2	2	2.0	0.0	0.0	2	2	0
fam18217	2	2	2	2.0	0.0	0.0	2	2	0
fam18218	2	2	2	2.0	0.0	0.0	2	2	0
fam18219	2	2	2	2.0	0.0	0.0	2	2	0
fam18220	2	2	2	2.0	0.0	0.0	2	2	0
fam18221	2	2	2	2.0	0.0	0.0	2	2	0
fam18222	2	2	2	2.0	0.0	0.0	2	2	0
fam18223	2	2	2	2.0	0.0	0.0	2	2	0
fam18224	2	2	2	2.0	0.0	0.0	2	2	0
fam18225	2	2	2	2.0	0.0	0.0	2	2	0
fam18226	2	2	2	2.0	0.0	0.0	2	2	0
fam18227	2	2	2	2.0	0.0	0.0	2	2	0
fam18228	2	2	2	2.0	0.0	0.0	2	2	0
fam18229	2	2	2	2.0	0.0	0.0	2	2	0
fam18230	2	2	2	2.0	0.0	0.0	2	2	0
fam18231	2	2	2	2.0	0.0	0.0	2	2	0
fam18232	2	2	2	2.0	0.0	0.0	2	2	0
fam18233	2	2	2	2.0	0.0	0.0	2	2	0
fam18234	2	2	2	2.0	0.0	0.0	2	2	0
fam18235	2	2	2	2.0	0.0	0.0	2	2	0
fam18236	2	2	2	2.0	0.0	0.0	2	2	0
fam18237	2	2	2	2.0	0.0	0.0	2	2	0
fam18238	2	2	2	2.0	0.0	0.0	2	2	0
fam18239	2	2	2	2.0	0.0	0.0	2	2	0
fam18240	2	2	2	2.0	0.0	0.0	2	2	0
fam18241	2	2	2	2.0	0.0	0.0	2	2	0
fam18242	2	2	2	2.0	0.0	0.0	2	2	0
fam18243	2	2	2	2.0	0.0	0.0	2	2	0
fam18244	2	2	2	2.0	0.0	0.0	2	2	0
fam18245	2	2	2	2.0	0.0	0.0	2	2	0
fam18246	2	2	2	2.0	0.0	0.0	2	2	0
fam18247	2	2	2	2.0	0.0	0.0	2	2	0
fam18248	2	2	2	2.0	0.0	0.0	2	2	0
fam18249	2	2	2	2.0	0.0	0.0	2	2	0
fam18250	2	2	2	2.0	0.0	0.0	2	2	0
fam18251	2	2	2	2.0	0.0	0.0	2	2	0
fam18252	2	2	2	2.0	0.0	0.0	2	2	0
fam18253	2	2	2	2.0	0.0	0.0	2	2	0
fam18254	2	2	2	2.0	0.0	0.0	2	2	0
fam18255	2	2	2	2.0	0.0	0.0	2	2	0
fam18256	2	2	2	2.0	0.0	0.0	2	2	0
fam18257	2	2	2	2.0	0.0	0.0	2	2	0
fam18258	2	2	2	2.0	0.0	0.0	2	2	0
fam18259	2	2	2	2.0	0.0	0.0	2	2	0
fam18260	2	2	2	2.0	0.0	0.0	2	2	0
fam18261	2	2	2	2.0	0.0	0.0	2	2	0
fam18262	2	2	2	2.0	0.0	0.0	2	2	0
fam18263	2	2	2	2.0	0.0	0.0	2	2	0
fam18264	2	2	2	2.0	0.0	0.0	2	2	0
fam18265	2	2	2	2.0	0.0	0.0	2	2	0
fam18266	2	2	2	2.0	0.0	0.0	2	2	0
fam18267	2	2	2	2.0	0.0	0.0	2	2	0
fam18268	2	2	2	2.0	0.0	0.0	2	2	0
fam18269	2	2	2	2.0	0.0	0.0	2	2	0
fam18270	2	2	2	2.0	0.0	0.0	2	2	0
fam18271	2	2	2	2.0	0.0	0.0	2	2	0
fam18272	2	2	2	2.0	0.0	0.0	2	2	0
fam18273	2	2	2	2.0	0.0	0.0	2	2	0
fam18274	2	2	2	2.0	0.0	0.0	2	2	0
fam18275	2	2	2	2.0	0.0	0.0	2	2	0
fam18276	2	2	2	2.0	0.0	0.0	2	2	0
fam18277	2	2	2	2.0	0.0	0.0	2	2	0
fam18278	2	2	2	2.0	0.0	0.0	2	2	0
fam18279	2	2	2	2.0	0.0	0.0	2	2	0
fam18280	2	2	2	2.0	0.0	0.0	2	2	0
fam18281	2	2	2	2.0	0.0	0.0	2	2	0
fam18282	2	2	2	2.0	0.0	0.0	2	2	0
fam18283	2	2	2	2.0	0.0	0.0	2	2	0
fam18284	2	2	2	2.0	0.0	0.0	2	2	0
fam18285	2	2	2	2.0	0.0	0.0	2	2	0
fam18286	2	2	2	2.0	0.0	0.0	2	2	0
fam18287	2	2	2	2.0	0.0	0.0	2	2	0
fam18288	2	2	2	2.0	0.0	0.0	2	2	0
fam18289	2	2	2	2.0	0.0	0.0	2	2	0
fam18290	2	2	2	2.0	0.0	0.0	2	2	0
fam18291	2	2	2	2.0	0.0	0.0	2	2	0
fam18292	2	2	2	2.0	0.0	0.0	2	2	0
fam18293	2	2	2	2.0	0.0	0.0	2	2	0
fam18294	2	2	2	2.0	0.0	0.0	2	2	0
fam18295	2	2	2	2.0	0.0	0.0	2	2	0
fam18296	2	2	2	2.0	0.0	0.0	2	2	0
fam18297	2	2	2	2.0	0.0	0.0	2	2	0
fam18298	2	2	2	2.0	0.0	0.0	2	2	0
fam18299	2	2	2	2.0	0.0	0.0	2	2	0
fam18300	2	2	2	2.0	0.0	0.0	2	2	0
fam18301	2	2	2	2.0	0.0	0.0	2	2	0
fam18302	2	2	2	2.0	0.0	0.0	2	2	0
fam18303	2	2	2	2.0	0.0	0.0	2	2	0
fam18304	2	2	2	2.0	0.0	0.0	2	2	0
fam18305	2	2	2	2.0	0.0	0.0	2	2	0
fam18306	2	2	2	2.0	0.0	0.0	2	2	0
fam18307	2	2	2	2.0	0.0	0.0	2	2	0
fam18308	2	2	2	2.0	0.0	0.0	2	2	0
fam18309	2	2	2	2.0	0.0	0.0	2	2	0
fam18310	2	2	2	2.0	0.0	0.0	2	2	0
fam18311	2	2	2	2.0	0.0	0.0	2	2	0
fam18312	2	2	2	2.0	0.0	0.0	2	2	0
fam18313	2	2	2	2.0	0.0	0.0	2	2	0
fam18314	2	2	2	2.0	0.0	0.0	2	2	0
fam18315	2	2	2	2.0	0.0	0.0	2	2	0
fam18316	2	2	2	2.0	0.0	0.0	2	2	0
fam18317	2	2	2	2.0	0.0	0.0	2	2	0
fam18318	2	2	2	2.0	0.0	0.0	2	2	0
fam18319	2	2	2	2.0	0.0	0.0	2	2	0
fam18320	2	2	2	2.0	0.0	0.0	2	2	0
fam18321	2	2	2	2.0	0.0	0.0	2	2	0
fam18322	2	2	2	2.0	0.0	0.0	2	2	0
fam18323	2	2	2	2.0	0.0	0.0	2	2	0
fam18324	2	2	2	2.0	0.0	0.0	2	2	0
fam18325	2	2	2	2.0	0.0	0.0	2	2	0
fam18326	2	2	2	2.0	0.0	0.0	2	2	0
fam18327	2	2	2	2.0	0.0	0.0	2	2	0
fam18328	2	2	2	2.0	0.0	0.0	2	2	0
fam18329	2	2	2	2.0	0.0	0.0	2	2	0
fam18330	2	2	2	2.0	0.0	0.0	2	2	0
fam18331	2	2	2	2.0	0.0	0.0	2	2	0
fam18332	2	2	2	2.0	0.0	0.0	2	2	0
fam18333	2	2	2	2.0	0.0	0.0	2	2	0
fam18334	2	2	2	2.0	0.0	0.0	2	2	0
fam18335	2	2	2	2.0	0.0	0.0	2	2	0
fam18336	2	2	2	2.0	0.0	0.0	2	2	0
fam18337	2	2	2	2.0	0.0	0.0	2	2	0
fam18338	2	2	2	2.0	0.0	0.0	2	2	0
fam18339	2	2	2	2.0	0.0	0.0	2	2	0
fam18340	2	2	2	2.0	0.0	0.0	2	2	0
fam18341	2	2	2	2.0	0.0	0.0	2	2	0
fam18342	2	2	2	2.0	0.0	0.0	2	2	0
fam18343	2	2	2	2.0	0.0	0.0	2	2	0
fam18344	2	2	2	2.0	0.0	0.0	2	2	0
fam18345	2	2	2	2.0	0.0	0.0	2	2	0
fam18346	2	2	2	2.0	0.0	0.0	2	2	0
fam18347	2	2	2	2.0	0.0	0.0	2	2	0
fam18348	2	2	2	2.0	0.0	0.0	2	2	0
fam18349	2	2	2	2.0	0.0	0.0	2	2	0
fam18350	2	2	2	2.0	0.0	0.0	2	2	0
fam18351	2	2	2	2.0	0.0	0.0	2	2	0
fam18352	2	2	2	2.0	0.0	0.0	2	2	0
fam18353	2	2	2	2.0	0.0	0.0	2	2	0
fam18354	2	2	2	2.0	0.0	0.0	2	2	0
fam18355	2	2	2	2.0	0.0	0.0	2	2	0
fam18356	2	2	2	2.0	0.0	0.0	2	2	0
fam18357	2	2	2	2.0	0.0	0.0	2	2	0
fam18358	2	2	2	2.0	0.0	0.0	2	2	0
fam18359	2	2	2	2.0	0.0	0.0	2	2	0
fam18360	2	2	2	2.0	0.0	0.0	2	2	0
fam18361	2	2	2	2.0	0.0	0.0	2	2	0
fam18362	2	2	2	2.0	0.0	0.0	2	2	0
fam18363	2	2	2	2.0	0.0	0.0	2	2	0
fam18364	2	2	2	2.0	0.0	0.0	2	2	0
fam18365	2	2	2	2.0	0.0	0.0	2	2	0
fam18366	2	2	2	2.0	0.0	0.0	2	2	0
fam18367	2	2	2	2.0	0.0	0.0	2	2	0
fam18368	2	2	2	2.0	0.0	0.0	2	2	0
fam18369	2	2	2	2.0	0.0	0.0	2	2	0
fam18370	2	2	2	2.0	0.0	0.0	2	2	0
fam18371	2	2	2	2.0	0.0	0.0	2	2	0
fam18372	2	2	2	2.0	0.0	0.0	2	2	0
fam18373	2	2	2	2.0	0.0	0.0	2	2	0
fam18374	2	2	2	2.0	0.0	0.0	2	2	0
fam18375	2	2	2	2.0	0.0	0.0	2	2	0
fam18376	2	2	2	2.0	0.0	0.0	2	2	0
fam18377	2	2	2	2.0	0.0	0.0	2	2	0
fam18378	2	2	2	2.0	0.0	0.0	2	2	0
fam18379	2	2	2	2.0	0.0	0.0	2	2	0
fam18380	2	2	2	2.0	0.0	0.0	2	2	0
fam18381	2	2	2	2.0	0.0	0.0	2	2	0
fam18382	2	2	2	2.0	0.0	0.0	2	2	0
fam18383	2	2	2	2.0	0.0	0.0	2	2	0
fam18384	2	2	2	2.0	0.0	0.0	2	2	0
fam18385	2	2	2	2.0	0.0	0.0	2	2	0
fam18386	2	2	2	2.0	0.0	0.0	2	2	0
fam18387	2	2	2	2.0	0.0	0.0	2	2	0
fam18388	2	2	2	2.0	0.0	0.0	2	2	0
fam18389	2	2	2	2.0	0.0	0.0	2	2	0
fam18390	2	2	2	2.0	0.0	0.0	2	2	0
fam18391	2	2	2	2.0	0.0	0.0	2	2	0
fam18392	2	2	2	2.0	0.0	0.0	2	2	0
fam18393	2	2	2	2.0	0.0	0.0	2	2	0
fam18394	2	2	2	2.0	0.0	0.0	2	2	0
fam18395	2	2	2	2.0	0.0	0.0	2	2	0
fam18396	2	2	2	2.0	0.0	0.0	2	2	0
fam18397	2	2	2	2.0	0.0	0.0	2	2	0
fam18398	2	2	2	2.0	0.0	0.0	2	2	0
fam18399	2	2	2	2.0	0.0	0.0	2	2	0
fam18400	2	2	2	2.0	0.0	0.0	2	2	0
fam18401	2	2	2	2.0	0.0	0.0	2	2	0
fam18402	2	2	2	2.0	0.0	0.0	2	2	0
fam18403	2	2	2	2.0	0.0	0.0	2	2	0
fam18404	2	2	2	2.0	0.0	0.0	2	2	0
fam18405	2	2	2	2.0	0.0	0.0	2	2	0
fam18406	2	2	2	2.0	0.0	0.0	2	2	0
fam18407	2	2	2	2.0	0.0	0.0	2	2	0
fam18408	2	2	2	2.0	0.0	0.0	2	2	0
fam18409	2	2	2	2.0	0.0	0.0	2	2	0
fam18410	2	2	2	2.0	0.0	0.0	2	2	0
fam18411	2	2	2	2.0	0.0	0.0	2	2	0
fam18412	2	2	2	2.0	0.0	0.0	2	2	0
fam18413	2	2	2	2.0	0.0	0.0	2	2	0
fam18414	2	2	2	2.0	0.0	0.0	2	2	0
fam18415	2	2	2	2.0	0.0	0.0	2	2	0
fam18416	2	2	2	2.0	0.0	0.0	2	2	0
fam18417	2	2	2	2.0	0.0	0.0	2	2	0
fam18418	2	2	2	2.0	0.0	0.0	2	2	0
fam18419	2	2	2	2.0	0.0	0.0	2	2	0
fam18420	2	2	2	2.0	0.0	0.0	2	2	0
fam18421	2	2	2	2.0	0.0	0.0	2	2	0
fam18422	2	2	2	2.0	0.0	0.0	2	2	0
fam18423	2	2	2	2.0	0.0	0.0	2	2	0
fam18424	2	2	2	2.0	0.0	0.0	2	2	0
fam18425	2	2	2	2.0	0.0	0.0	2	2	0
fam18426	2	2	2	2.0	0.0	0.0	2	2	0
fam18427	2	2	2	2.0	0.0	0.0	2	2	0
fam18428	2	2	2	2.0	0.0	0.0	2	2	0
fam18429	2	2	2	2.0	0.0	0.0	2	2	0
fam18430	2	2	2	2.0	0.0	0.0	2	2	0
fam18431	2	2	2	2.0	0.0	0.0	2	2	0
fam18432	2	2	2	2.0	0.0	0.0	2	2	0
fam18433	2	2	2	2.0	0.0	0.0	2	2	0
fam18434	2	2	2	2.0	0.0	0.0	2	2	0
fam18435	2	2	2	2.0	0.0	0.0	2	2	0
fam18436	2	2	2	2.0	0.0	0.0	2	2	0
fam18437	2	2	2	2.0	0.0	0.0	2	2	0
fam18438	2	2	2	2.0	0.0	0.0	2	2	0
fam18439	2	2	2	2.0	0.0	0.0	2	2	0
fam18440	2	2	2	2.0	0.0	0.0	2	2	0
fam18441	2	2	2	2.0	0.0	0.0	2	2	0
fam18442	2	2	2	2.0	0.0	0.0	2	2	0
fam18443	2	2	2	2.0	0.0	0.0	2	2	0
fam18444	2	2	2	2.0	0.0	0.0	2	2	0
fam18445	2	2	2	2.0	0.0	0.0	2	2	0
fam18446	2	2	2	2.0	0.0	0.0	2	2	0
fam18447	2	2	2	2.0	0.0	0.0	2	2	0
fam18448	2	2	2	2.0	0.0	0.0	2	2	0
fam18449	2	2	2	2.0	0.0	0.0	2	2	0
fam18450	2	2	2	2.0	0.0	0.0	2	2	0
fam18451	2	2	2	2.0	0.0	0.0	2	2	0
fam18452	2	2	2	2.0	0.0	0.0	2	2	0
fam18453	2	2	2	2.0	0.0	0.0	2	2	0
fam18454	2	2	2	2.0	0.0	0.0	2	2	0
fam18455	2	2	2	2.0	0.0	0.0	2	2	0
fam18456	2	2	2	2.0	0.0	0.0	2	2	0
fam18457	2	2	2	2.0	0.0	0.0	2	2	0
fam18458	2	2	2	2.0	0.0	0.0	2	2	0
fam18459	2	2	2	2.0	0.0	0.0	2	2	0
fam18460	2	2	2	2.0	0.0	0.0	2	2	0
fam18461	2	2	2	2.0	0.0	0.0	2	2	0
fam18462	2	2	2	2.0	0.0	0.0	2	2	0
fam18463	2	2	2	2.0	0.0	0.0	2	2	0
fam18464	2	2	2	2.0	0.0	0.0	2	2	0
fam18465	2	2	2	2.0	0.0	0.0	2	2	0
fam18466	2	2	2	2.0	0.0	0.0	2	2	0
fam18467	2	2	2	2.0	0.0	0.0	2	2	0
fam18468	2	2	2	2.0	0.0	0.0	2	2	0
fam18469	2	2	2	2.0	0.0	0.0	2	2	0
fam18470	2	2	2	2.0	0.0	0.0	2	2	0
fam18471	2	2	2	2.0	0.0	0.0	2	2	0
fam18472	2	2	2	2.0	0.0	0.0	2	2	0
fam18473	2	2	2	2.0	0.0	0.0	2	2	0
fam18474	2	2	2	2.0	0.0	0.0	2	2	0
fam18475	2	2	2	2.0	0.0	0.0	2	2	0
fam18476	2	2	2	2.0	0.0	0.0	2	2	0
fam18477	2	2	2	2.0	0.0	0.0	2	2	0
fam18478	2	2	2	2.0	0.0	0.0	2	2	0
fam18479	2	2	2	2.0	0.0	0.0	2	2	0
fam18480	2	2	2	2.0	0.0	0.0	2	2	0
fam18481	2	2	2	2.0	0.0	0.0	2	2	0
fam18482	2	2	2	2.0	0.0	0.0	2	2	0
fam18483	2	2	2	2.0	0.0	0.0	2	2	0
fam18484	2	2	2	2.0	0.0	0.0	2	2	0
fam18485	2	2	2	2.0	0.0	0.0	2	2	0
fam18486	2	2	2	2.0	0.0	0.0	2	2	0
fam18487	2	2	2	2.0	0.0	0.0	2	2	0
fam18488	2	2	2	2.0	0.0	0.0	2	2	0
fam18489	2	2	2	2.0	0.0	0.0	2	2	0
fam18490	2	2	2	2.0	0.0	0.0	2	2	0
fam18491	2	2	2	2.0	0.0	0.0	2	2	0
fam18492	2	2	2	2.0	0.0	0.0	2	2	0
fam18493	2	2	2	2.0	0.0	0.0	2	2	0
fam18494	2	2	2	2.0	0.0	0.0	2	2	0
fam18495	2	2	2	2.0	0.0	0.0	2	2	0
fam18496	2	2	2	2.0	0.0	0.0	2	2	0
fam18497	2	2	2	2.0	0.0	0.0	2	2	0
fam18498	2	2	2	2.0	0.0	0.0	2	2	0
fam18499	2	2	2	2.0	0.0	0.0	2	2	0
fam18500	2	2	2	2.0	0.0	0.0	2	2	0
fam18501	2	2	2	2.0	0.0	0.0	2	2	0
fam18502	2	2	2	2.0	0.0	0.0	2	2	0
fam18503	2	2	2	2.0	0.0	0.0	2	2	0
fam18504	2	2	2	2.0	0.0	0.0	2	2	0
fam18505	2	2	2	2.0	0.0	0.0	2	2	0
fam18506	2	2	2	2.0	0.0	0.0	2	2	0
fam18507	2	2	2	2.0	0.0	0.0	2	2	0
fam18508	2	2	2	2.0	0.0	0.0	2	2	0
fam18509	2	2	2	2.0	0.0	0.0	2	2	0
fam18510	2	2	2	2.0	0.0	0.0	2	2	0
fam18511	2	2	2	2.0	0.0	0.0	2	2	0
fam18512	2	2	2	2.0	0.0	0.0	2	2	0
fam18513	2	2	2	2.0	0.0	0.0	2	2	0
fam18514	2	2	2	2.0	0.0	0.0	2	2	0
fam18515	2	2	2	2.0	0.0	0.0	2	2	0
fam18516	2	2	2	2.0	0.0	0.0	2	2	0
fam18517	2	2	2	2.0	0.0	0.0	2	2	0
fam18518	2	2	2	2.0	0.0	0.0	2	2	0
fam18519	2	2	2	2.0	0.0	0.0	2	2	0
fam18520	2	2	2	2.0	0.0	0.0	2	2	0
fam18521	2	2	2	2.0	0.0	0.0	2	2	0
fam18522	2	2	2	2.0	0.0	0.0	2	2	0
fam18523	2	2	2	2.0	0.0	0.0	2	2	0
fam18524	2	2	2	2.0	0.0	0.0	2	2	0
fam18525	2	2	2	2.0	0.0	0.0	2	2	0
fam18526	2	2	2	2.0	0.0	0.0	2	2	0
fam18527	2	2	2	2.0	0.0	0.0	2	2	0
fam18528	2	2	2	2.0	0.0	0.0	2	2	0
fam18529	2	2	2	2.0	0.0	0.0	2	2	0
fam18530	2	2	2	2.0	0.0	0.0	2	2	0
fam18531	2	2	2	2.0	0.0	0.0	2	2	0
fam18532	2	2	2	2.0	0.0	0.0	2	2	0
fam18533	2	2	2	2.0	0.0	0.0	2	2	0
fam18534	2	2	2	2.0	0.0	0.0	2	2	0
fam18535	2	2	2	2.0	0.0	0.0	2	2	0
fam18536	2	2	2	2.0	0.0	0.0	2	2	0
fam18537	2	2	2	2.0	0.0	0.0	2	2	0
fam18538	2	2	2	2.0	0.0	0.0	2	2	0
fam18539	2	2	2	2.0	0.0	0.0	2	2	0
fam18540	2	2	2	2.0	0.0	0.0	2	2	0
fam18541	2	2	2	2.0	0.0	0.0	2	2	0
fam18542	2	2	2	2.0	0.0	0.0	2	2	0
fam18543	2	2	2	2.0	0.0	0.0	2	2	0
fam18544	2	2	2	2.0	0.0	0.0	2	2	0
fam18545	2	2	2	2.0	0.0	0.0	2	2	0
fam18546	2	2	2	2.0	0.0	0.0	2	2	0
fam18547	2	2	2	2.0	0.0	0.0	2	2	0
fam18548	2	2	2	2.0	0.0	0.0	2	2	0
fam18549	2	2	2	2.0	0.0	0.0	2	2	0
fam18550	2	2	2	2.0	0.0	0.0	2	2	0
fam18551	2	2	2	2.0	0.0	0.0	2	2	0
fam18552	2	2	2	2.0	0.0	0.0	2	2	0
fam18553	2	2	2	2.0	0.0	0.0	2	2	0
fam18554	2	2	2	2.0	0.0	0.0	2	2	0
fam18555	2	2	2	2.0	0.0	0.0	2	2	0
fam18556	2	2	2	2.0	0.0	0.0	2	2	0
fam18557	2	2	2	2.0	0.0	0.0	2	2	0
fam18558	2	2	2	2.0	0.0	0.0	2	2	0
fam18559	2	2	2	2.0	0.0	0.0	2	2	0
fam18560	2	2	2	2.0	0.0	0.0	2	2	0
fam18561	2	2	2	2.0	0.0	0.0	2	2	0
fam18562	2	2	2	2.0	0.0	0.0	2	2	0
fam18563	2	2	2	2.0	0.0	0.0	2	2	0
fam18564	2	2	2	2.0	0.0	0.0	2	2	0
fam18565	2	2	2	2.0	0.0	0.0	2	2	0
fam18566	2	2	2	2.0	0.0	0.0	2	2	0
fam18567	2	2	2	2.0	0.0	0.0	2	2	0
fam18568	2	2	2	2.0	0.0	0.0	2	2	0
fam18569	2	2	2	2.0	0.0	0.0	2	2	0
fam18570	2	2	2	2.0	0.0	0.0	2	2	0
fam18571	2	2	2	2.0	0.0	0.0	2	2	0
fam18572	2	2	2	2.0	0.0	0.0	2	2	0
fam18573	2	2	2	2.0	0.0	0.0	2	2	0
fam18574	2	2	2	2.0	0.0	0.0	2	2	0
fam18575	2	2	2	2.0	0.0	0.0	2	2	0
fam18576	2	2	2	2.0	0.0	0.0	2	2	0
fam18577	2	2	2	2.0	0.0	0.0	2	2	0
fam18578	2	2	2	2.0	0.0	0.0	2	2	0
fam18579	2	2	2	2.0	0.0	0.0	2	2	0
fam18580	22	2	25	16.333333333333332	12.503332889007368	0.7655101768780022	25	2	23
fam18581	2	14	17	11.0	7.937253933193772	0.721568539381252	17	2	15
fam18582	5	25	2	10.666666666666666	12.503332889007368	1.1721874583444407	25	2	23
fam18583	2	14	11	9.0	6.244997998398398	0.693888666488711	14	2	12
fam18584	2	10	15	9.0	6.557438524302	0.7286042804780001	15	2	13
fam18585	2	11	12	8.333333333333334	5.507570547286102	0.6609084656743321	12	2	10
fam18586	2	7	13	7.333333333333333	5.507570547286102	0.7510323473571958	13	2	11
fam18587	2	14	6	7.333333333333333	6.110100926607786	0.8331955809010618	14	2	12
fam18588	2	10	10	7.333333333333333	4.618802153517007	0.6298366572977737	10	2	8
fam18589	2	10	8	6.666666666666667	4.163331998932266	0.6244997998398399	10	2	8
fam18590	2	4	14	6.666666666666667	6.429100507328636	0.9643650760992953	14	2	12
fam18591	2	13	4	6.333333333333333	5.8594652770823155	0.9251787279603656	13	2	11
fam18592	2	13	4	6.333333333333333	5.8594652770823155	0.9251787279603656	13	2	11
fam18593	3	14	2	6.333333333333333	6.658328118479393	1.0513149660756937	14	2	12
fam18594	2	8	8	6.0	3.4641016151377544	0.5773502691896257	8	2	6
fam18595	2	6	10	6.0	4.0	0.6666666666666666	10	2	8
fam18596	5	11	2	6.0	4.58257569495584	0.7637626158259733	11	2	9
fam18597	2	12	4	6.0	5.291502622129181	0.8819171036881969	12	2	10
fam18598	2	14	2	6.0	6.928203230275509	1.1547005383792515	14	2	12
fam18599	2	12	4	6.0	5.291502622129181	0.8819171036881969	12	2	10
fam18600	2	8	7	5.666666666666667	3.2145502536643185	0.5672735741760562	8	2	6
fam18601	2	7	8	5.666666666666667	3.214550253664318	0.5672735741760561	8	2	6
fam18602	2	4	11	5.666666666666667	4.725815626252609	0.8339674634563427	11	2	9
fam18603	2	10	5	5.666666666666667	4.041451884327381	0.7131973913518906	10	2	8
fam18604	2	2	13	5.666666666666667	6.350852961085883	1.1207387578386852	13	2	11
fam18605	2	9	6	5.666666666666667	3.5118845842842465	0.6197443384031023	9	2	7
fam18606	2	9	6	5.666666666666667	3.5118845842842465	0.6197443384031023	9	2	7
fam18607	2	9	6	5.666666666666667	3.5118845842842465	0.6197443384031023	9	2	7
fam18608	2	7	7	5.333333333333333	2.8867513459481287	0.5412658773652742	7	2	5
fam18609	2	7	7	5.333333333333333	2.8867513459481287	0.5412658773652742	7	2	5
fam18610	2	8	6	5.333333333333333	3.0550504633038935	0.5728219618694801	8	2	6
fam18611	2	6	8	5.333333333333333	3.055050463303893	0.57282196186948	8	2	6
fam18612	2	9	5	5.333333333333333	3.5118845842842465	0.6584783595532963	9	2	7
fam18613	2	7	7	5.333333333333333	2.8867513459481287	0.5412658773652742	7	2	5
fam18614	2	8	6	5.333333333333333	3.0550504633038935	0.5728219618694801	8	2	6
fam18615	2	8	6	5.333333333333333	3.0550504633038935	0.5728219618694801	8	2	6
fam18616	2	8	6	5.333333333333333	3.0550504633038935	0.5728219618694801	8	2	6
fam18617	2	9	4	5.0	3.605551275463989	0.7211102550927978	9	2	7
fam18618	2	10	3	5.0	4.358898943540674	0.8717797887081348	10	2	8
fam18619	10	3	2	5.0	4.358898943540674	0.8717797887081348	10	2	8
fam18620	2	8	5	5.0	3.0	0.6	8	2	6
fam18621	2	8	5	5.0	3.0	0.6	8	2	6
fam18622	2	6	6	4.666666666666667	2.309401076758503	0.49487165930539345	6	2	4
fam18623	2	6	6	4.666666666666667	2.309401076758503	0.49487165930539345	6	2	4
fam18624	2	6	6	4.666666666666667	2.309401076758503	0.49487165930539345	6	2	4
fam18625	2	7	5	4.666666666666667	2.516611478423583	0.5392738882336249	7	2	5
fam18626	2	5	7	4.666666666666667	2.516611478423583	0.5392738882336249	7	2	5
fam18627	2	7	5	4.666666666666667	2.516611478423583	0.5392738882336249	7	2	5
fam18628	2	7	5	4.666666666666667	2.516611478423583	0.5392738882336249	7	2	5
fam18629	2	7	5	4.666666666666667	2.516611478423583	0.5392738882336249	7	2	5
fam18630	2	7	5	4.666666666666667	2.516611478423583	0.5392738882336249	7	2	5
fam18631	2	8	4	4.666666666666667	3.0550504633038935	0.6546536707079771	8	2	6
fam18632	8	2	4	4.666666666666667	3.0550504633038935	0.6546536707079771	8	2	6
fam18633	2	5	7	4.666666666666667	2.516611478423583	0.5392738882336249	7	2	5
fam18634	6	6	2	4.666666666666667	2.309401076758503	0.49487165930539345	6	2	4
fam18635	2	9	3	4.666666666666667	3.7859388972001824	0.8112726208286105	9	2	7
fam18636	2	8	4	4.666666666666667	3.0550504633038935	0.6546536707079771	8	2	6
fam18637	2	10	2	4.666666666666667	4.618802153517007	0.9897433186107871	10	2	8
fam18638	2	6	5	4.333333333333333	2.0816659994661326	0.4803844614152614	6	2	4
fam18639	2	6	5	4.333333333333333	2.0816659994661326	0.4803844614152614	6	2	4
fam18640	2	6	5	4.333333333333333	2.0816659994661326	0.4803844614152614	6	2	4
fam18641	2	5	6	4.333333333333333	2.0816659994661326	0.4803844614152614	6	2	4
fam18642	2	7	4	4.333333333333333	2.516611478423583	0.5807564950208269	7	2	5
fam18643	2	7	4	4.333333333333333	2.516611478423583	0.5807564950208269	7	2	5
fam18644	2	8	3	4.333333333333333	3.2145502536643185	0.7418192893071505	8	2	6
fam18645	2	8	3	4.333333333333333	3.2145502536643185	0.7418192893071505	8	2	6
fam18646	2	8	3	4.333333333333333	3.2145502536643185	0.7418192893071505	8	2	6
fam18647	2	8	3	4.333333333333333	3.2145502536643185	0.7418192893071505	8	2	6
fam18648	2	5	6	4.333333333333333	2.0816659994661326	0.4803844614152614	6	2	4
fam18649	2	4	7	4.333333333333333	2.516611478423583	0.5807564950208269	7	2	5
fam18650	2	8	3	4.333333333333333	3.2145502536643185	0.7418192893071505	8	2	6
fam18651	2	5	5	4.0	1.7320508075688772	0.4330127018922193	5	2	3
fam18652	2	5	5	4.0	1.7320508075688772	0.4330127018922193	5	2	3
fam18653	2	5	5	4.0	1.7320508075688772	0.4330127018922193	5	2	3
fam18654	2	5	5	4.0	1.7320508075688772	0.4330127018922193	5	2	3
fam18655	2	5	5	4.0	1.7320508075688772	0.4330127018922193	5	2	3
fam18656	2	6	4	4.0	2.0	0.5	6	2	4
fam18657	2	6	4	4.0	2.0	0.5	6	2	4
fam18658	2	6	4	4.0	2.0	0.5	6	2	4
fam18659	2	6	4	4.0	2.0	0.5	6	2	4
fam18660	2	6	4	4.0	2.0	0.5	6	2	4
fam18661	2	4	6	4.0	2.0	0.5	6	2	4
fam18662	2	6	4	4.0	2.0	0.5	6	2	4
fam18663	2	7	3	4.0	2.6457513110645907	0.6614378277661477	7	2	5
fam18664	2	7	3	4.0	2.6457513110645907	0.6614378277661477	7	2	5
fam18665	2	7	3	4.0	2.6457513110645907	0.6614378277661477	7	2	5
fam18666	2	3	7	4.0	2.6457513110645907	0.6614378277661477	7	2	5
fam18667	2	7	3	4.0	2.6457513110645907	0.6614378277661477	7	2	5
fam18668	3	7	2	4.0	2.6457513110645907	0.6614378277661477	7	2	5
fam18669	2	6	4	4.0	2.0	0.5	6	2	4
fam18670	6	4	2	4.0	2.0	0.5	6	2	4
fam18671	2	8	2	4.0	3.4641016151377544	0.8660254037844386	8	2	6
fam18672	2	5	5	4.0	1.7320508075688772	0.4330127018922193	5	2	3
fam18673	2	8	2	4.0	3.4641016151377544	0.8660254037844386	8	2	6
fam18674	2	8	2	4.0	3.4641016151377544	0.8660254037844386	8	2	6
fam18675	2	2	8	4.0	3.4641016151377544	0.8660254037844386	8	2	6
fam18676	2	8	2	4.0	3.4641016151377544	0.8660254037844386	8	2	6
fam18677	2	8	2	4.0	3.4641016151377544	0.8660254037844386	8	2	6
fam18678	2	2	8	4.0	3.4641016151377544	0.8660254037844386	8	2	6
fam18679	2	7	3	4.0	2.6457513110645907	0.6614378277661477	7	2	5
fam18680	2	7	3	4.0	2.6457513110645907	0.6614378277661477	7	2	5
fam18681	2	7	3	4.0	2.6457513110645907	0.6614378277661477	7	2	5
fam18682	2	6	4	4.0	2.0	0.5	6	2	4
fam18683	2	3	7	4.0	2.6457513110645907	0.6614378277661477	7	2	5
fam18684	5	5	2	4.0	1.7320508075688772	0.4330127018922193	5	2	3
fam18685	2	6	4	4.0	2.0	0.5	6	2	4
fam18686	2	5	4	3.6666666666666665	1.5275252316519468	0.41659779045053097	5	2	3
fam18687	2	5	4	3.6666666666666665	1.5275252316519468	0.41659779045053097	5	2	3
fam18688	2	4	5	3.6666666666666665	1.5275252316519465	0.4165977904505309	5	2	3
fam18689	2	5	4	3.6666666666666665	1.5275252316519468	0.41659779045053097	5	2	3
fam18690	2	5	4	3.6666666666666665	1.5275252316519468	0.41659779045053097	5	2	3
fam18691	2	5	4	3.6666666666666665	1.5275252316519468	0.41659779045053097	5	2	3
fam18692	2	4	5	3.6666666666666665	1.5275252316519465	0.4165977904505309	5	2	3
fam18693	2	5	4	3.6666666666666665	1.5275252316519468	0.41659779045053097	5	2	3
fam18694	2	4	5	3.6666666666666665	1.5275252316519465	0.4165977904505309	5	2	3
fam18695	2	4	5	3.6666666666666665	1.5275252316519465	0.4165977904505309	5	2	3
fam18696	2	5	4	3.6666666666666665	1.5275252316519468	0.41659779045053097	5	2	3
fam18697	2	5	4	3.6666666666666665	1.5275252316519468	0.41659779045053097	5	2	3
fam18698	2	5	4	3.6666666666666665	1.5275252316519468	0.41659779045053097	5	2	3
fam18699	2	5	4	3.6666666666666665	1.5275252316519468	0.41659779045053097	5	2	3
fam18700	2	5	4	3.6666666666666665	1.5275252316519468	0.41659779045053097	5	2	3
fam18701	2	4	5	3.6666666666666665	1.5275252316519465	0.4165977904505309	5	2	3
fam18702	2	4	5	3.6666666666666665	1.5275252316519465	0.4165977904505309	5	2	3
fam18703	2	5	4	3.6666666666666665	1.5275252316519468	0.41659779045053097	5	2	3
fam18704	2	5	4	3.6666666666666665	1.5275252316519468	0.41659779045053097	5	2	3
fam18705	2	4	5	3.6666666666666665	1.5275252316519465	0.4165977904505309	5	2	3
fam18706	2	5	4	3.6666666666666665	1.5275252316519468	0.41659779045053097	5	2	3
fam18707	2	5	4	3.6666666666666665	1.5275252316519468	0.41659779045053097	5	2	3
fam18708	2	5	4	3.6666666666666665	1.5275252316519468	0.41659779045053097	5	2	3
fam18709	2	6	3	3.6666666666666665	2.081665999466133	0.5677270907634908	6	2	4
fam18710	2	6	3	3.6666666666666665	2.081665999466133	0.5677270907634908	6	2	4
fam18711	2	3	6	3.6666666666666665	2.081665999466133	0.5677270907634908	6	2	4
fam18712	2	6	3	3.6666666666666665	2.081665999466133	0.5677270907634908	6	2	4
fam18713	2	6	3	3.6666666666666665	2.081665999466133	0.5677270907634908	6	2	4
fam18714	2	6	3	3.6666666666666665	2.081665999466133	0.5677270907634908	6	2	4
fam18715	2	6	3	3.6666666666666665	2.081665999466133	0.5677270907634908	6	2	4
fam18716	2	5	4	3.6666666666666665	1.5275252316519468	0.41659779045053097	5	2	3
fam18717	2	7	2	3.6666666666666665	2.886751345948129	0.787295821622217	7	2	5
fam18718	2	7	2	3.6666666666666665	2.886751345948129	0.787295821622217	7	2	5
fam18719	2	7	2	3.6666666666666665	2.886751345948129	0.787295821622217	7	2	5
fam18720	2	7	2	3.6666666666666665	2.886751345948129	0.787295821622217	7	2	5
fam18721	2	2	7	3.6666666666666665	2.886751345948129	0.787295821622217	7	2	5
fam18722	2	7	2	3.6666666666666665	2.886751345948129	0.787295821622217	7	2	5
fam18723	2	7	2	3.6666666666666665	2.886751345948129	0.787295821622217	7	2	5
fam18724	2	7	2	3.6666666666666665	2.886751345948129	0.787295821622217	7	2	5
fam18725	2	5	4	3.6666666666666665	1.5275252316519468	0.41659779045053097	5	2	3
fam18726	2	6	3	3.6666666666666665	2.081665999466133	0.5677270907634908	6	2	4
fam18727	2	3	6	3.6666666666666665	2.081665999466133	0.5677270907634908	6	2	4
fam18728	2	6	3	3.6666666666666665	2.081665999466133	0.5677270907634908	6	2	4
fam18729	2	4	5	3.6666666666666665	1.5275252316519465	0.4165977904505309	5	2	3
fam18730	2	5	4	3.6666666666666665	1.5275252316519468	0.41659779045053097	5	2	3
fam18731	2	8	2	4.0	3.4641016151377544	0.8660254037844386	8	2	6
fam18732	2	8	2	4.0	3.4641016151377544	0.8660254037844386	8	2	6
fam18733	2	8	2	4.0	3.4641016151377544	0.8660254037844386	8	2	6
fam18734	2	8	2	4.0	3.4641016151377544	0.8660254037844386	8	2	6
fam18735	2	8	2	4.0	3.4641016151377544	0.8660254037844386	8	2	6
fam18736	2	2	8	4.0	3.4641016151377544	0.8660254037844386	8	2	6
fam18737	2	6	3	3.6666666666666665	2.081665999466133	0.5677270907634908	6	2	4
fam18738	2	3	6	3.6666666666666665	2.081665999466133	0.5677270907634908	6	2	4
fam18739	2	4	4	3.3333333333333335	1.1547005383792515	0.3464101615137754	4	2	2
fam18740	2	4	4	3.3333333333333335	1.1547005383792515	0.3464101615137754	4	2	2
fam18741	2	4	4	3.3333333333333335	1.1547005383792515	0.3464101615137754	4	2	2
fam18742	2	4	4	3.3333333333333335	1.1547005383792515	0.3464101615137754	4	2	2
fam18743	2	4	4	3.3333333333333335	1.1547005383792515	0.3464101615137754	4	2	2
fam18744	2	4	4	3.3333333333333335	1.1547005383792515	0.3464101615137754	4	2	2
fam18745	2	4	4	3.3333333333333335	1.1547005383792515	0.3464101615137754	4	2	2
fam18746	2	4	4	3.3333333333333335	1.1547005383792515	0.3464101615137754	4	2	2
fam18747	2	4	4	3.3333333333333335	1.1547005383792515	0.3464101615137754	4	2	2
fam18748	2	4	4	3.3333333333333335	1.1547005383792515	0.3464101615137754	4	2	2
fam18749	2	4	4	3.3333333333333335	1.1547005383792515	0.3464101615137754	4	2	2
fam18750	2	4	4	3.3333333333333335	1.1547005383792515	0.3464101615137754	4	2	2
fam18751	2	4	4	3.3333333333333335	1.1547005383792515	0.3464101615137754	4	2	2
fam18752	2	4	4	3.3333333333333335	1.1547005383792515	0.3464101615137754	4	2	2
fam18753	2	4	4	3.3333333333333335	1.1547005383792515	0.3464101615137754	4	2	2
fam18754	2	4	4	3.3333333333333335	1.1547005383792515	0.3464101615137754	4	2	2
fam18755	2	4	4	3.3333333333333335	1.1547005383792515	0.3464101615137754	4	2	2
fam18756	2	4	4	3.3333333333333335	1.1547005383792515	0.3464101615137754	4	2	2
fam18757	2	4	4	3.3333333333333335	1.1547005383792515	0.3464101615137754	4	2	2
fam18758	2	4	4	3.3333333333333335	1.1547005383792515	0.3464101615137754	4	2	2
fam18759	2	4	4	3.3333333333333335	1.1547005383792515	0.3464101615137754	4	2	2
fam18760	2	4	4	3.3333333333333335	1.1547005383792515	0.3464101615137754	4	2	2
fam18761	2	4	4	3.3333333333333335	1.1547005383792515	0.3464101615137754	4	2	2
fam18762	2	4	4	3.3333333333333335	1.1547005383792515	0.3464101615137754	4	2	2
fam18763	2	4	4	3.3333333333333335	1.1547005383792515	0.3464101615137754	4	2	2
fam18764	4	4	2	3.3333333333333335	1.1547005383792515	0.3464101615137754	4	2	2
fam18765	2	3	5	3.3333333333333335	1.5275252316519465	0.45825756949558394	5	2	3
fam18766	2	5	3	3.3333333333333335	1.5275252316519468	0.458257569495584	5	2	3
fam18767	2	3	5	3.3333333333333335	1.5275252316519465	0.45825756949558394	5	2	3
fam18768	2	3	5	3.3333333333333335	1.5275252316519465	0.45825756949558394	5	2	3
fam18769	2	5	3	3.3333333333333335	1.5275252316519468	0.458257569495584	5	2	3
fam18770	2	5	3	3.3333333333333335	1.5275252316519468	0.458257569495584	5	2	3
fam18771	2	3	5	3.3333333333333335	1.5275252316519465	0.45825756949558394	5	2	3
fam18772	2	5	3	3.3333333333333335	1.5275252316519468	0.458257569495584	5	2	3
fam18773	2	3	5	3.3333333333333335	1.5275252316519465	0.45825756949558394	5	2	3
fam18774	2	5	3	3.3333333333333335	1.5275252316519468	0.458257569495584	5	2	3
fam18775	2	3	5	3.3333333333333335	1.5275252316519465	0.45825756949558394	5	2	3
fam18776	5	3	2	3.3333333333333335	1.5275252316519465	0.45825756949558394	5	2	3
fam18777	3	2	5	3.3333333333333335	1.5275252316519465	0.45825756949558394	5	2	3
fam18778	3	5	2	3.3333333333333335	1.5275252316519465	0.45825756949558394	5	2	3
fam18779	2	4	4	3.3333333333333335	1.1547005383792515	0.3464101615137754	4	2	2
fam18780	2	4	4	3.3333333333333335	1.1547005383792515	0.3464101615137754	4	2	2
fam18781	2	4	4	3.3333333333333335	1.1547005383792515	0.3464101615137754	4	2	2
fam18782	2	2	6	3.3333333333333335	2.3094010767585034	0.692820323027551	6	2	4
fam18783	2	6	2	3.3333333333333335	2.3094010767585034	0.692820323027551	6	2	4
fam18784	2	2	6	3.3333333333333335	2.3094010767585034	0.692820323027551	6	2	4
fam18785	2	4	4	3.3333333333333335	1.1547005383792515	0.3464101615137754	4	2	2
fam18786	2	6	2	3.3333333333333335	2.3094010767585034	0.692820323027551	6	2	4
fam18787	2	2	6	3.3333333333333335	2.3094010767585034	0.692820323027551	6	2	4
fam18788	2	6	2	3.3333333333333335	2.3094010767585034	0.692820323027551	6	2	4
fam18789	2	2	6	3.3333333333333335	2.3094010767585034	0.692820323027551	6	2	4
fam18790	2	2	6	3.3333333333333335	2.3094010767585034	0.692820323027551	6	2	4
fam18791	2	6	2	3.3333333333333335	2.3094010767585034	0.692820323027551	6	2	4
fam18792	2	6	2	3.3333333333333335	2.3094010767585034	0.692820323027551	6	2	4
fam18793	2	5	3	3.3333333333333335	1.5275252316519468	0.458257569495584	5	2	3
fam18794	2	5	3	3.3333333333333335	1.5275252316519468	0.458257569495584	5	2	3
fam18795	2	5	3	3.3333333333333335	1.5275252316519468	0.458257569495584	5	2	3
fam18796	2	7	2	3.6666666666666665	2.886751345948129	0.787295821622217	7	2	5
fam18797	2	7	2	3.6666666666666665	2.886751345948129	0.787295821622217	7	2	5
fam18798	2	7	2	3.6666666666666665	2.886751345948129	0.787295821622217	7	2	5
fam18799	2	7	2	3.6666666666666665	2.886751345948129	0.787295821622217	7	2	5
fam18800	2	7	2	3.6666666666666665	2.886751345948129	0.787295821622217	7	2	5
fam18801	2	7	2	3.6666666666666665	2.886751345948129	0.787295821622217	7	2	5
fam18802	2	7	2	3.6666666666666665	2.886751345948129	0.787295821622217	7	2	5
fam18803	2	7	2	3.6666666666666665	2.886751345948129	0.787295821622217	7	2	5
fam18804	2	7	2	3.6666666666666665	2.886751345948129	0.787295821622217	7	2	5
fam18805	2	7	2	3.6666666666666665	2.886751345948129	0.787295821622217	7	2	5
fam18806	2	7	2	3.6666666666666665	2.886751345948129	0.787295821622217	7	2	5
fam18807	2	7	2	3.6666666666666665	2.886751345948129	0.787295821622217	7	2	5
fam18808	2	7	2	3.6666666666666665	2.886751345948129	0.787295821622217	7	2	5
fam18809	2	7	2	3.6666666666666665	2.886751345948129	0.787295821622217	7	2	5
fam18810	2	7	2	3.6666666666666665	2.886751345948129	0.787295821622217	7	2	5
fam18811	2	7	2	3.6666666666666665	2.886751345948129	0.787295821622217	7	2	5
fam18812	2	7	2	3.6666666666666665	2.886751345948129	0.787295821622217	7	2	5
fam18813	7	2	2	3.6666666666666665	2.886751345948129	0.787295821622217	7	2	5
fam18814	2	7	2	3.6666666666666665	2.886751345948129	0.787295821622217	7	2	5
fam18815	2	7	2	3.6666666666666665	2.886751345948129	0.787295821622217	7	2	5
fam18816	2	7	2	3.6666666666666665	2.886751345948129	0.787295821622217	7	2	5
fam18817	2	2	7	3.6666666666666665	2.886751345948129	0.787295821622217	7	2	5
fam18818	2	2	6	3.3333333333333335	2.3094010767585034	0.692820323027551	6	2	4
fam18819	2	6	2	3.3333333333333335	2.3094010767585034	0.692820323027551	6	2	4
fam18820	2	5	3	3.3333333333333335	1.5275252316519468	0.458257569495584	5	2	3
fam18821	2	4	4	3.3333333333333335	1.1547005383792515	0.3464101615137754	4	2	2
fam18822	2	4	4	3.3333333333333335	1.1547005383792515	0.3464101615137754	4	2	2
fam18823	6	2	2	3.3333333333333335	2.3094010767585034	0.692820323027551	6	2	4
fam18824	2	3	4	3.0	1.0	0.3333333333333333	4	2	2
fam18825	2	3	4	3.0	1.0	0.3333333333333333	4	2	2
fam18826	2	4	3	3.0	1.0	0.3333333333333333	4	2	2
fam18827	2	3	4	3.0	1.0	0.3333333333333333	4	2	2
fam18828	2	4	3	3.0	1.0	0.3333333333333333	4	2	2
fam18829	2	4	3	3.0	1.0	0.3333333333333333	4	2	2
fam18830	2	3	4	3.0	1.0	0.3333333333333333	4	2	2
fam18831	2	3	4	3.0	1.0	0.3333333333333333	4	2	2
fam18832	2	4	3	3.0	1.0	0.3333333333333333	4	2	2
fam18833	2	3	4	3.0	1.0	0.3333333333333333	4	2	2
fam18834	2	3	4	3.0	1.0	0.3333333333333333	4	2	2
fam18835	2	4	3	3.0	1.0	0.3333333333333333	4	2	2
fam18836	2	3	4	3.0	1.0	0.3333333333333333	4	2	2
fam18837	2	4	3	3.0	1.0	0.3333333333333333	4	2	2
fam18838	2	4	3	3.0	1.0	0.3333333333333333	4	2	2
fam18839	2	3	4	3.0	1.0	0.3333333333333333	4	2	2
fam18840	2	3	4	3.0	1.0	0.3333333333333333	4	2	2
fam18841	2	4	3	3.0	1.0	0.3333333333333333	4	2	2
fam18842	2	4	3	3.0	1.0	0.3333333333333333	4	2	2
fam18843	2	4	3	3.0	1.0	0.3333333333333333	4	2	2
fam18844	2	3	4	3.0	1.0	0.3333333333333333	4	2	2
fam18845	2	3	4	3.0	1.0	0.3333333333333333	4	2	2
fam18846	2	4	3	3.0	1.0	0.3333333333333333	4	2	2
fam18847	2	4	3	3.0	1.0	0.3333333333333333	4	2	2
fam18848	2	4	3	3.0	1.0	0.3333333333333333	4	2	2
fam18849	2	4	3	3.0	1.0	0.3333333333333333	4	2	2
fam18850	2	4	3	3.0	1.0	0.3333333333333333	4	2	2
fam18851	2	4	3	3.0	1.0	0.3333333333333333	4	2	2
fam18852	2	4	3	3.0	1.0	0.3333333333333333	4	2	2
fam18853	2	4	3	3.0	1.0	0.3333333333333333	4	2	2
fam18854	3	4	2	3.0	1.0	0.3333333333333333	4	2	2
fam18855	4	3	2	3.0	1.0	0.3333333333333333	4	2	2
fam18856	3	2	4	3.0	1.0	0.3333333333333333	4	2	2
fam18857	3	4	2	3.0	1.0	0.3333333333333333	4	2	2
fam18858	3	4	2	3.0	1.0	0.3333333333333333	4	2	2
fam18859	2	2	5	3.0	1.7320508075688772	0.5773502691896257	5	2	3
fam18860	2	2	5	3.0	1.7320508075688772	0.5773502691896257	5	2	3
fam18861	2	2	5	3.0	1.7320508075688772	0.5773502691896257	5	2	3
fam18862	2	5	2	3.0	1.7320508075688772	0.5773502691896257	5	2	3
fam18863	2	2	5	3.0	1.7320508075688772	0.5773502691896257	5	2	3
fam18864	2	5	2	3.0	1.7320508075688772	0.5773502691896257	5	2	3
fam18865	2	2	5	3.0	1.7320508075688772	0.5773502691896257	5	2	3
fam18866	2	5	2	3.0	1.7320508075688772	0.5773502691896257	5	2	3
fam18867	2	5	2	3.0	1.7320508075688772	0.5773502691896257	5	2	3
fam18868	2	2	5	3.0	1.7320508075688772	0.5773502691896257	5	2	3
fam18869	2	5	2	3.0	1.7320508075688772	0.5773502691896257	5	2	3
fam18870	2	5	2	3.0	1.7320508075688772	0.5773502691896257	5	2	3
fam18871	2	5	2	3.0	1.7320508075688772	0.5773502691896257	5	2	3
fam18872	2	5	2	3.0	1.7320508075688772	0.5773502691896257	5	2	3
fam18873	2	5	2	3.0	1.7320508075688772	0.5773502691896257	5	2	3
fam18874	2	5	2	3.0	1.7320508075688772	0.5773502691896257	5	2	3
fam18875	2	5	2	3.0	1.7320508075688772	0.5773502691896257	5	2	3
fam18876	2	5	2	3.0	1.7320508075688772	0.5773502691896257	5	2	3
fam18877	2	5	2	3.0	1.7320508075688772	0.5773502691896257	5	2	3
fam18878	5	2	2	3.0	1.7320508075688772	0.5773502691896257	5	2	3
fam18879	2	5	2	3.0	1.7320508075688772	0.5773502691896257	5	2	3
fam18880	2	4	3	3.0	1.0	0.3333333333333333	4	2	2
fam18881	2	3	4	3.0	1.0	0.3333333333333333	4	2	2
fam18882	3	4	2	3.0	1.0	0.3333333333333333	4	2	2
fam18883	2	6	2	3.3333333333333335	2.3094010767585034	0.692820323027551	6	2	4
fam18884	2	2	6	3.3333333333333335	2.3094010767585034	0.692820323027551	6	2	4
fam18885	2	6	2	3.3333333333333335	2.3094010767585034	0.692820323027551	6	2	4
fam18886	2	6	2	3.3333333333333335	2.3094010767585034	0.692820323027551	6	2	4
fam18887	2	6	2	3.3333333333333335	2.3094010767585034	0.692820323027551	6	2	4
fam18888	2	6	2	3.3333333333333335	2.3094010767585034	0.692820323027551	6	2	4
fam18889	2	6	2	3.3333333333333335	2.3094010767585034	0.692820323027551	6	2	4
fam18890	2	6	2	3.3333333333333335	2.3094010767585034	0.692820323027551	6	2	4
fam18891	2	6	2	3.3333333333333335	2.3094010767585034	0.692820323027551	6	2	4
fam18892	2	6	2	3.3333333333333335	2.3094010767585034	0.692820323027551	6	2	4
fam18893	2	6	2	3.3333333333333335	2.3094010767585034	0.692820323027551	6	2	4
fam18894	2	6	2	3.3333333333333335	2.3094010767585034	0.692820323027551	6	2	4
fam18895	2	6	2	3.3333333333333335	2.3094010767585034	0.692820323027551	6	2	4
fam18896	2	6	2	3.3333333333333335	2.3094010767585034	0.692820323027551	6	2	4
fam18897	2	6	2	3.3333333333333335	2.3094010767585034	0.692820323027551	6	2	4
fam18898	2	6	2	3.3333333333333335	2.3094010767585034	0.692820323027551	6	2	4
fam18899	6	2	2	3.3333333333333335	2.3094010767585034	0.692820323027551	6	2	4
fam18900	2	6	2	3.3333333333333335	2.3094010767585034	0.692820323027551	6	2	4
fam18901	2	4	3	3.0	1.0	0.3333333333333333	4	2	2
fam18902	2	3	4	3.0	1.0	0.3333333333333333	4	2	2
fam18903	2	5	2	3.0	1.7320508075688772	0.5773502691896257	5	2	3
fam18904	2	5	2	3.0	1.7320508075688772	0.5773502691896257	5	2	3
fam18905	2	5	2	3.0	1.7320508075688772	0.5773502691896257	5	2	3
fam18906	2	5	2	3.0	1.7320508075688772	0.5773502691896257	5	2	3
fam18907	2	5	2	3.0	1.7320508075688772	0.5773502691896257	5	2	3
fam18908	2	5	2	3.0	1.7320508075688772	0.5773502691896257	5	2	3
fam18909	2	5	2	3.0	1.7320508075688772	0.5773502691896257	5	2	3
fam18910	2	3	4	3.0	1.0	0.3333333333333333	4	2	2
fam18911	2	4	3	3.0	1.0	0.3333333333333333	4	2	2
fam18912	3	4	2	3.0	1.0	0.3333333333333333	4	2	2
fam18913	5	2	2	3.0	1.7320508075688772	0.5773502691896257	5	2	3
fam18914	2	3	4	3.0	1.0	0.3333333333333333	4	2	2
fam18915	2	3	3	2.6666666666666665	0.5773502691896258	0.2165063509461097	3	2	1
fam18916	2	3	3	2.6666666666666665	0.5773502691896258	0.2165063509461097	3	2	1
fam18917	2	3	3	2.6666666666666665	0.5773502691896258	0.2165063509461097	3	2	1
fam18918	2	3	3	2.6666666666666665	0.5773502691896258	0.2165063509461097	3	2	1
fam18919	2	3	3	2.6666666666666665	0.5773502691896258	0.2165063509461097	3	2	1
fam18920	2	3	3	2.6666666666666665	0.5773502691896258	0.2165063509461097	3	2	1
fam18921	2	3	3	2.6666666666666665	0.5773502691896258	0.2165063509461097	3	2	1
fam18922	2	3	3	2.6666666666666665	0.5773502691896258	0.2165063509461097	3	2	1
fam18923	2	3	3	2.6666666666666665	0.5773502691896258	0.2165063509461097	3	2	1
fam18924	2	3	3	2.6666666666666665	0.5773502691896258	0.2165063509461097	3	2	1
fam18925	2	3	3	2.6666666666666665	0.5773502691896258	0.2165063509461097	3	2	1
fam18926	2	3	3	2.6666666666666665	0.5773502691896258	0.2165063509461097	3	2	1
fam18927	2	3	3	2.6666666666666665	0.5773502691896258	0.2165063509461097	3	2	1
fam18928	2	3	3	2.6666666666666665	0.5773502691896258	0.2165063509461097	3	2	1
fam18929	2	3	3	2.6666666666666665	0.5773502691896258	0.2165063509461097	3	2	1
fam18930	2	3	3	2.6666666666666665	0.5773502691896258	0.2165063509461097	3	2	1
fam18931	2	3	3	2.6666666666666665	0.5773502691896258	0.2165063509461097	3	2	1
fam18932	2	3	3	2.6666666666666665	0.5773502691896258	0.2165063509461097	3	2	1
fam18933	2	3	3	2.6666666666666665	0.5773502691896258	0.2165063509461097	3	2	1
fam18934	2	3	3	2.6666666666666665	0.5773502691896258	0.2165063509461097	3	2	1
fam18935	2	3	3	2.6666666666666665	0.5773502691896258	0.2165063509461097	3	2	1
fam18936	2	3	3	2.6666666666666665	0.5773502691896258	0.2165063509461097	3	2	1
fam18937	2	3	3	2.6666666666666665	0.5773502691896258	0.2165063509461097	3	2	1
fam18938	2	3	3	2.6666666666666665	0.5773502691896258	0.2165063509461097	3	2	1
fam18939	2	3	3	2.6666666666666665	0.5773502691896258	0.2165063509461097	3	2	1
fam18940	2	3	3	2.6666666666666665	0.5773502691896258	0.2165063509461097	3	2	1
fam18941	2	3	3	2.6666666666666665	0.5773502691896258	0.2165063509461097	3	2	1
fam18942	2	3	3	2.6666666666666665	0.5773502691896258	0.2165063509461097	3	2	1
fam18943	2	3	3	2.6666666666666665	0.5773502691896258	0.2165063509461097	3	2	1
fam18944	2	3	3	2.6666666666666665	0.5773502691896258	0.2165063509461097	3	2	1
fam18945	2	3	3	2.6666666666666665	0.5773502691896258	0.2165063509461097	3	2	1
fam18946	2	3	3	2.6666666666666665	0.5773502691896258	0.2165063509461097	3	2	1
fam18947	2	3	3	2.6666666666666665	0.5773502691896258	0.2165063509461097	3	2	1
fam18948	2	3	3	2.6666666666666665	0.5773502691896258	0.2165063509461097	3	2	1
fam18949	2	3	3	2.6666666666666665	0.5773502691896258	0.2165063509461097	3	2	1
fam18950	2	3	3	2.6666666666666665	0.5773502691896258	0.2165063509461097	3	2	1
fam18951	2	3	3	2.6666666666666665	0.5773502691896258	0.2165063509461097	3	2	1
fam18952	2	3	3	2.6666666666666665	0.5773502691896258	0.2165063509461097	3	2	1
fam18953	2	3	3	2.6666666666666665	0.5773502691896258	0.2165063509461097	3	2	1
fam18954	2	3	3	2.6666666666666665	0.5773502691896258	0.2165063509461097	3	2	1
fam18955	2	3	3	2.6666666666666665	0.5773502691896258	0.2165063509461097	3	2	1
fam18956	2	3	3	2.6666666666666665	0.5773502691896258	0.2165063509461097	3	2	1
fam18957	2	3	3	2.6666666666666665	0.5773502691896258	0.2165063509461097	3	2	1
fam18958	2	3	3	2.6666666666666665	0.5773502691896258	0.2165063509461097	3	2	1
fam18959	3	3	2	2.6666666666666665	0.5773502691896258	0.2165063509461097	3	2	1
fam18960	3	3	2	2.6666666666666665	0.5773502691896258	0.2165063509461097	3	2	1
fam18961	3	3	2	2.6666666666666665	0.5773502691896258	0.2165063509461097	3	2	1
fam18962	2	4	2	2.6666666666666665	1.1547005383792515	0.4330127018922193	4	2	2
fam18963	2	2	4	2.6666666666666665	1.1547005383792515	0.4330127018922193	4	2	2
fam18964	2	4	2	2.6666666666666665	1.1547005383792515	0.4330127018922193	4	2	2
fam18965	2	2	4	2.6666666666666665	1.1547005383792515	0.4330127018922193	4	2	2
fam18966	2	2	4	2.6666666666666665	1.1547005383792515	0.4330127018922193	4	2	2
fam18967	2	4	2	2.6666666666666665	1.1547005383792515	0.4330127018922193	4	2	2
fam18968	2	4	2	2.6666666666666665	1.1547005383792515	0.4330127018922193	4	2	2
fam18969	2	4	2	2.6666666666666665	1.1547005383792515	0.4330127018922193	4	2	2
fam18970	2	4	2	2.6666666666666665	1.1547005383792515	0.4330127018922193	4	2	2
fam18971	2	4	2	2.6666666666666665	1.1547005383792515	0.4330127018922193	4	2	2
fam18972	2	4	2	2.6666666666666665	1.1547005383792515	0.4330127018922193	4	2	2
fam18973	2	4	2	2.6666666666666665	1.1547005383792515	0.4330127018922193	4	2	2
fam18974	2	4	2	2.6666666666666665	1.1547005383792515	0.4330127018922193	4	2	2
fam18975	2	2	4	2.6666666666666665	1.1547005383792515	0.4330127018922193	4	2	2
fam18976	2	4	2	2.6666666666666665	1.1547005383792515	0.4330127018922193	4	2	2
fam18977	2	4	2	2.6666666666666665	1.1547005383792515	0.4330127018922193	4	2	2
fam18978	2	4	2	2.6666666666666665	1.1547005383792515	0.4330127018922193	4	2	2
fam18979	2	4	2	2.6666666666666665	1.1547005383792515	0.4330127018922193	4	2	2
fam18980	2	4	2	2.6666666666666665	1.1547005383792515	0.4330127018922193	4	2	2
fam18981	2	4	2	2.6666666666666665	1.1547005383792515	0.4330127018922193	4	2	2
fam18982	2	4	2	2.6666666666666665	1.1547005383792515	0.4330127018922193	4	2	2
fam18983	2	4	2	2.6666666666666665	1.1547005383792515	0.4330127018922193	4	2	2
fam18984	2	4	2	2.6666666666666665	1.1547005383792515	0.4330127018922193	4	2	2
fam18985	2	4	2	2.6666666666666665	1.1547005383792515	0.4330127018922193	4	2	2
fam18986	2	2	4	2.6666666666666665	1.1547005383792515	0.4330127018922193	4	2	2
fam18987	2	4	2	2.6666666666666665	1.1547005383792515	0.4330127018922193	4	2	2
fam18988	2	4	2	2.6666666666666665	1.1547005383792515	0.4330127018922193	4	2	2
fam18989	2	2	4	2.6666666666666665	1.1547005383792515	0.4330127018922193	4	2	2
fam18990	2	4	2	2.6666666666666665	1.1547005383792515	0.4330127018922193	4	2	2
fam18991	4	2	2	2.6666666666666665	1.1547005383792515	0.4330127018922193	4	2	2
fam18992	2	2	4	2.6666666666666665	1.1547005383792515	0.4330127018922193	4	2	2
fam18993	2	4	2	2.6666666666666665	1.1547005383792515	0.4330127018922193	4	2	2
fam18994	4	2	2	2.6666666666666665	1.1547005383792515	0.4330127018922193	4	2	2
fam18995	4	2	2	2.6666666666666665	1.1547005383792515	0.4330127018922193	4	2	2
fam18996	4	2	2	2.6666666666666665	1.1547005383792515	0.4330127018922193	4	2	2
fam18997	2	4	2	2.6666666666666665	1.1547005383792515	0.4330127018922193	4	2	2
fam18998	4	2	2	2.6666666666666665	1.1547005383792515	0.4330127018922193	4	2	2
fam18999	2	3	3	2.6666666666666665	0.5773502691896258	0.2165063509461097	3	2	1
fam19000	2	3	3	2.6666666666666665	0.5773502691896258	0.2165063509461097	3	2	1
fam19001	2	3	3	2.6666666666666665	0.5773502691896258	0.2165063509461097	3	2	1
fam19002	2	3	3	2.6666666666666665	0.5773502691896258	0.2165063509461097	3	2	1
fam19003	3	3	2	2.6666666666666665	0.5773502691896258	0.2165063509461097	3	2	1
fam19004	2	5	2	3.0	1.7320508075688772	0.5773502691896257	5	2	3
fam19005	2	5	2	3.0	1.7320508075688772	0.5773502691896257	5	2	3
fam19006	2	2	5	3.0	1.7320508075688772	0.5773502691896257	5	2	3
fam19007	2	5	2	3.0	1.7320508075688772	0.5773502691896257	5	2	3
fam19008	2	3	3	2.6666666666666665	0.5773502691896258	0.2165063509461097	3	2	1
fam19009	2	5	2	3.0	1.7320508075688772	0.5773502691896257	5	2	3
fam19010	2	3	3	2.6666666666666665	0.5773502691896258	0.2165063509461097	3	2	1
fam19011	2	5	2	3.0	1.7320508075688772	0.5773502691896257	5	2	3
fam19012	2	5	2	3.0	1.7320508075688772	0.5773502691896257	5	2	3
fam19013	2	5	2	3.0	1.7320508075688772	0.5773502691896257	5	2	3
fam19014	2	2	5	3.0	1.7320508075688772	0.5773502691896257	5	2	3
fam19015	2	5	2	3.0	1.7320508075688772	0.5773502691896257	5	2	3
fam19016	2	3	3	2.6666666666666665	0.5773502691896258	0.2165063509461097	3	2	1
fam19017	2	5	2	3.0	1.7320508075688772	0.5773502691896257	5	2	3
fam19018	2	2	5	3.0	1.7320508075688772	0.5773502691896257	5	2	3
fam19019	2	2	5	3.0	1.7320508075688772	0.5773502691896257	5	2	3
fam19020	2	5	2	3.0	1.7320508075688772	0.5773502691896257	5	2	3
fam19021	2	3	3	2.6666666666666665	0.5773502691896258	0.2165063509461097	3	2	1
fam19022	2	5	2	3.0	1.7320508075688772	0.5773502691896257	5	2	3
fam19023	2	5	2	3.0	1.7320508075688772	0.5773502691896257	5	2	3
fam19024	2	5	2	3.0	1.7320508075688772	0.5773502691896257	5	2	3
fam19025	2	3	3	2.6666666666666665	0.5773502691896258	0.2165063509461097	3	2	1
fam19026	2	5	2	3.0	1.7320508075688772	0.5773502691896257	5	2	3
fam19027	2	3	3	2.6666666666666665	0.5773502691896258	0.2165063509461097	3	2	1
fam19028	2	5	2	3.0	1.7320508075688772	0.5773502691896257	5	2	3
fam19029	2	5	2	3.0	1.7320508075688772	0.5773502691896257	5	2	3
fam19030	2	5	2	3.0	1.7320508075688772	0.5773502691896257	5	2	3
fam19031	2	2	5	3.0	1.7320508075688772	0.5773502691896257	5	2	3
fam19032	2	5	2	3.0	1.7320508075688772	0.5773502691896257	5	2	3
fam19033	2	5	2	3.0	1.7320508075688772	0.5773502691896257	5	2	3
fam19034	2	5	2	3.0	1.7320508075688772	0.5773502691896257	5	2	3
fam19035	2	2	5	3.0	1.7320508075688772	0.5773502691896257	5	2	3
fam19036	2	2	5	3.0	1.7320508075688772	0.5773502691896257	5	2	3
fam19037	2	5	2	3.0	1.7320508075688772	0.5773502691896257	5	2	3
fam19038	3	3	2	2.6666666666666665	0.5773502691896258	0.2165063509461097	3	2	1
fam19039	2	5	2	3.0	1.7320508075688772	0.5773502691896257	5	2	3
fam19040	2	2	5	3.0	1.7320508075688772	0.5773502691896257	5	2	3
fam19041	2	5	2	3.0	1.7320508075688772	0.5773502691896257	5	2	3
fam19042	2	5	2	3.0	1.7320508075688772	0.5773502691896257	5	2	3
fam19043	2	5	2	3.0	1.7320508075688772	0.5773502691896257	5	2	3
fam19044	2	5	2	3.0	1.7320508075688772	0.5773502691896257	5	2	3
fam19045	2	5	2	3.0	1.7320508075688772	0.5773502691896257	5	2	3
fam19046	5	2	2	3.0	1.7320508075688772	0.5773502691896257	5	2	3
fam19047	5	2	2	3.0	1.7320508075688772	0.5773502691896257	5	2	3
fam19048	2	5	2	3.0	1.7320508075688772	0.5773502691896257	5	2	3
fam19049	2	5	2	3.0	1.7320508075688772	0.5773502691896257	5	2	3
fam19050	3	3	2	2.6666666666666665	0.5773502691896258	0.2165063509461097	3	2	1
fam19051	2	2	5	3.0	1.7320508075688772	0.5773502691896257	5	2	3
fam19052	2	5	2	3.0	1.7320508075688772	0.5773502691896257	5	2	3
fam19053	2	2	5	3.0	1.7320508075688772	0.5773502691896257	5	2	3
fam19054	2	5	2	3.0	1.7320508075688772	0.5773502691896257	5	2	3
fam19055	3	3	2	2.6666666666666665	0.5773502691896258	0.2165063509461097	3	2	1
fam19056	2	5	2	3.0	1.7320508075688772	0.5773502691896257	5	2	3
fam19057	2	5	2	3.0	1.7320508075688772	0.5773502691896257	5	2	3
fam19058	2	5	2	3.0	1.7320508075688772	0.5773502691896257	5	2	3
fam19059	2	5	2	3.0	1.7320508075688772	0.5773502691896257	5	2	3
fam19060	5	2	2	3.0	1.7320508075688772	0.5773502691896257	5	2	3
fam19061	2	2	4	2.6666666666666665	1.1547005383792515	0.4330127018922193	4	2	2
fam19062	2	4	2	2.6666666666666665	1.1547005383792515	0.4330127018922193	4	2	2
fam19063	2	4	2	2.6666666666666665	1.1547005383792515	0.4330127018922193	4	2	2
fam19064	2	2	4	2.6666666666666665	1.1547005383792515	0.4330127018922193	4	2	2
fam19065	2	4	2	2.6666666666666665	1.1547005383792515	0.4330127018922193	4	2	2
fam19066	4	2	2	2.6666666666666665	1.1547005383792515	0.4330127018922193	4	2	2
fam19067	2	3	3	2.6666666666666665	0.5773502691896258	0.2165063509461097	3	2	1
fam19068	2	4	2	2.6666666666666665	1.1547005383792515	0.4330127018922193	4	2	2
fam19069	2	2	4	2.6666666666666665	1.1547005383792515	0.4330127018922193	4	2	2
fam19070	2	3	3	2.6666666666666665	0.5773502691896258	0.2165063509461097	3	2	1
fam19071	3	2	3	2.6666666666666665	0.5773502691896258	0.2165063509461097	3	2	1
fam19072	2	3	2	2.3333333333333335	0.5773502691896258	0.24743582965269678	3	2	1
fam19073	2	3	2	2.3333333333333335	0.5773502691896258	0.24743582965269678	3	2	1
fam19074	2	3	2	2.3333333333333335	0.5773502691896258	0.24743582965269678	3	2	1
fam19075	2	3	2	2.3333333333333335	0.5773502691896258	0.24743582965269678	3	2	1
fam19076	2	2	3	2.3333333333333335	0.5773502691896258	0.24743582965269678	3	2	1
fam19077	2	3	2	2.3333333333333335	0.5773502691896258	0.24743582965269678	3	2	1
fam19078	2	3	2	2.3333333333333335	0.5773502691896258	0.24743582965269678	3	2	1
fam19079	2	3	2	2.3333333333333335	0.5773502691896258	0.24743582965269678	3	2	1
fam19080	2	3	2	2.3333333333333335	0.5773502691896258	0.24743582965269678	3	2	1
fam19081	2	3	2	2.3333333333333335	0.5773502691896258	0.24743582965269678	3	2	1
fam19082	2	3	2	2.3333333333333335	0.5773502691896258	0.24743582965269678	3	2	1
fam19083	2	2	3	2.3333333333333335	0.5773502691896258	0.24743582965269678	3	2	1
fam19084	2	3	2	2.3333333333333335	0.5773502691896258	0.24743582965269678	3	2	1
fam19085	2	3	2	2.3333333333333335	0.5773502691896258	0.24743582965269678	3	2	1
fam19086	2	2	3	2.3333333333333335	0.5773502691896258	0.24743582965269678	3	2	1
fam19087	2	3	2	2.3333333333333335	0.5773502691896258	0.24743582965269678	3	2	1
fam19088	2	2	3	2.3333333333333335	0.5773502691896258	0.24743582965269678	3	2	1
fam19089	2	2	3	2.3333333333333335	0.5773502691896258	0.24743582965269678	3	2	1
fam19090	2	3	2	2.3333333333333335	0.5773502691896258	0.24743582965269678	3	2	1
fam19091	2	2	3	2.3333333333333335	0.5773502691896258	0.24743582965269678	3	2	1
fam19092	2	2	3	2.3333333333333335	0.5773502691896258	0.24743582965269678	3	2	1
fam19093	2	3	2	2.3333333333333335	0.5773502691896258	0.24743582965269678	3	2	1
fam19094	2	2	3	2.3333333333333335	0.5773502691896258	0.24743582965269678	3	2	1
fam19095	2	3	2	2.3333333333333335	0.5773502691896258	0.24743582965269678	3	2	1
fam19096	2	3	2	2.3333333333333335	0.5773502691896258	0.24743582965269678	3	2	1
fam19097	2	2	3	2.3333333333333335	0.5773502691896258	0.24743582965269678	3	2	1
fam19098	2	3	2	2.3333333333333335	0.5773502691896258	0.24743582965269678	3	2	1
fam19099	2	3	2	2.3333333333333335	0.5773502691896258	0.24743582965269678	3	2	1
fam19100	2	2	3	2.3333333333333335	0.5773502691896258	0.24743582965269678	3	2	1
fam19101	2	2	3	2.3333333333333335	0.5773502691896258	0.24743582965269678	3	2	1
fam19102	2	2	3	2.3333333333333335	0.5773502691896258	0.24743582965269678	3	2	1
fam19103	2	3	2	2.3333333333333335	0.5773502691896258	0.24743582965269678	3	2	1
fam19104	2	2	3	2.3333333333333335	0.5773502691896258	0.24743582965269678	3	2	1
fam19105	2	2	3	2.3333333333333335	0.5773502691896258	0.24743582965269678	3	2	1
fam19106	2	2	3	2.3333333333333335	0.5773502691896258	0.24743582965269678	3	2	1
fam19107	2	3	2	2.3333333333333335	0.5773502691896258	0.24743582965269678	3	2	1
fam19108	2	3	2	2.3333333333333335	0.5773502691896258	0.24743582965269678	3	2	1
fam19109	2	3	2	2.3333333333333335	0.5773502691896258	0.24743582965269678	3	2	1
fam19110	2	3	2	2.3333333333333335	0.5773502691896258	0.24743582965269678	3	2	1
fam19111	2	3	2	2.3333333333333335	0.5773502691896258	0.24743582965269678	3	2	1
fam19112	2	2	3	2.3333333333333335	0.5773502691896258	0.24743582965269678	3	2	1
fam19113	2	3	2	2.3333333333333335	0.5773502691896258	0.24743582965269678	3	2	1
fam19114	2	3	2	2.3333333333333335	0.5773502691896258	0.24743582965269678	3	2	1
fam19115	2	3	2	2.3333333333333335	0.5773502691896258	0.24743582965269678	3	2	1
fam19116	2	2	3	2.3333333333333335	0.5773502691896258	0.24743582965269678	3	2	1
fam19117	2	2	3	2.3333333333333335	0.5773502691896258	0.24743582965269678	3	2	1
fam19118	2	3	2	2.3333333333333335	0.5773502691896258	0.24743582965269678	3	2	1
fam19119	2	3	2	2.3333333333333335	0.5773502691896258	0.24743582965269678	3	2	1
fam19120	2	2	3	2.3333333333333335	0.5773502691896258	0.24743582965269678	3	2	1
fam19121	2	2	3	2.3333333333333335	0.5773502691896258	0.24743582965269678	3	2	1
fam19122	2	3	2	2.3333333333333335	0.5773502691896258	0.24743582965269678	3	2	1
fam19123	2	3	2	2.3333333333333335	0.5773502691896258	0.24743582965269678	3	2	1
fam19124	2	3	2	2.3333333333333335	0.5773502691896258	0.24743582965269678	3	2	1
fam19125	2	2	3	2.3333333333333335	0.5773502691896258	0.24743582965269678	3	2	1
fam19126	2	3	2	2.3333333333333335	0.5773502691896258	0.24743582965269678	3	2	1
fam19127	2	3	2	2.3333333333333335	0.5773502691896258	0.24743582965269678	3	2	1
fam19128	2	2	3	2.3333333333333335	0.5773502691896258	0.24743582965269678	3	2	1
fam19129	2	3	2	2.3333333333333335	0.5773502691896258	0.24743582965269678	3	2	1
fam19130	2	2	3	2.3333333333333335	0.5773502691896258	0.24743582965269678	3	2	1
fam19131	2	3	2	2.3333333333333335	0.5773502691896258	0.24743582965269678	3	2	1
fam19132	2	3	2	2.3333333333333335	0.5773502691896258	0.24743582965269678	3	2	1
fam19133	2	3	2	2.3333333333333335	0.5773502691896258	0.24743582965269678	3	2	1
fam19134	2	3	2	2.3333333333333335	0.5773502691896258	0.24743582965269678	3	2	1
fam19135	2	3	2	2.3333333333333335	0.5773502691896258	0.24743582965269678	3	2	1
fam19136	2	2	3	2.3333333333333335	0.5773502691896258	0.24743582965269678	3	2	1
fam19137	2	2	3	2.3333333333333335	0.5773502691896258	0.24743582965269678	3	2	1
fam19138	2	2	3	2.3333333333333335	0.5773502691896258	0.24743582965269678	3	2	1
fam19139	2	2	3	2.3333333333333335	0.5773502691896258	0.24743582965269678	3	2	1
fam19140	2	3	2	2.3333333333333335	0.5773502691896258	0.24743582965269678	3	2	1
fam19141	2	2	3	2.3333333333333335	0.5773502691896258	0.24743582965269678	3	2	1
fam19142	2	3	2	2.3333333333333335	0.5773502691896258	0.24743582965269678	3	2	1
fam19143	2	3	2	2.3333333333333335	0.5773502691896258	0.24743582965269678	3	2	1
fam19144	2	2	3	2.3333333333333335	0.5773502691896258	0.24743582965269678	3	2	1
fam19145	2	3	2	2.3333333333333335	0.5773502691896258	0.24743582965269678	3	2	1
fam19146	2	3	2	2.3333333333333335	0.5773502691896258	0.24743582965269678	3	2	1
fam19147	2	2	3	2.3333333333333335	0.5773502691896258	0.24743582965269678	3	2	1
fam19148	2	3	2	2.3333333333333335	0.5773502691896258	0.24743582965269678	3	2	1
fam19149	2	3	2	2.3333333333333335	0.5773502691896258	0.24743582965269678	3	2	1
fam19150	2	2	3	2.3333333333333335	0.5773502691896258	0.24743582965269678	3	2	1
fam19151	2	3	2	2.3333333333333335	0.5773502691896258	0.24743582965269678	3	2	1
fam19152	2	3	2	2.3333333333333335	0.5773502691896258	0.24743582965269678	3	2	1
fam19153	2	2	3	2.3333333333333335	0.5773502691896258	0.24743582965269678	3	2	1
fam19154	2	3	2	2.3333333333333335	0.5773502691896258	0.24743582965269678	3	2	1
fam19155	2	3	2	2.3333333333333335	0.5773502691896258	0.24743582965269678	3	2	1
fam19156	2	2	3	2.3333333333333335	0.5773502691896258	0.24743582965269678	3	2	1
fam19157	2	2	3	2.3333333333333335	0.5773502691896258	0.24743582965269678	3	2	1
fam19158	2	3	2	2.3333333333333335	0.5773502691896258	0.24743582965269678	3	2	1
fam19159	2	2	3	2.3333333333333335	0.5773502691896258	0.24743582965269678	3	2	1
fam19160	2	2	3	2.3333333333333335	0.5773502691896258	0.24743582965269678	3	2	1
fam19161	2	3	2	2.3333333333333335	0.5773502691896258	0.24743582965269678	3	2	1
fam19162	2	2	3	2.3333333333333335	0.5773502691896258	0.24743582965269678	3	2	1
fam19163	2	3	2	2.3333333333333335	0.5773502691896258	0.24743582965269678	3	2	1
fam19164	2	2	3	2.3333333333333335	0.5773502691896258	0.24743582965269678	3	2	1
fam19165	2	2	3	2.3333333333333335	0.5773502691896258	0.24743582965269678	3	2	1
fam19166	2	2	3	2.3333333333333335	0.5773502691896258	0.24743582965269678	3	2	1
fam19167	2	3	2	2.3333333333333335	0.5773502691896258	0.24743582965269678	3	2	1
fam19168	2	3	2	2.3333333333333335	0.5773502691896258	0.24743582965269678	3	2	1
fam19169	2	2	3	2.3333333333333335	0.5773502691896258	0.24743582965269678	3	2	1
fam19170	2	3	2	2.3333333333333335	0.5773502691896258	0.24743582965269678	3	2	1
fam19171	2	3	2	2.3333333333333335	0.5773502691896258	0.24743582965269678	3	2	1
fam19172	2	2	3	2.3333333333333335	0.5773502691896258	0.24743582965269678	3	2	1
fam19173	2	3	2	2.3333333333333335	0.5773502691896258	0.24743582965269678	3	2	1
fam19174	2	3	2	2.3333333333333335	0.5773502691896258	0.24743582965269678	3	2	1
fam19175	2	3	2	2.3333333333333335	0.5773502691896258	0.24743582965269678	3	2	1
fam19176	2	2	3	2.3333333333333335	0.5773502691896258	0.24743582965269678	3	2	1
fam19177	2	2	3	2.3333333333333335	0.5773502691896258	0.24743582965269678	3	2	1
fam19178	2	3	2	2.3333333333333335	0.5773502691896258	0.24743582965269678	3	2	1
fam19179	2	3	2	2.3333333333333335	0.5773502691896258	0.24743582965269678	3	2	1
fam19180	2	3	2	2.3333333333333335	0.5773502691896258	0.24743582965269678	3	2	1
fam19181	2	3	2	2.3333333333333335	0.5773502691896258	0.24743582965269678	3	2	1
fam19182	2	3	2	2.3333333333333335	0.5773502691896258	0.24743582965269678	3	2	1
fam19183	2	3	2	2.3333333333333335	0.5773502691896258	0.24743582965269678	3	2	1
fam19184	2	2	3	2.3333333333333335	0.5773502691896258	0.24743582965269678	3	2	1
fam19185	2	2	3	2.3333333333333335	0.5773502691896258	0.24743582965269678	3	2	1
fam19186	2	2	3	2.3333333333333335	0.5773502691896258	0.24743582965269678	3	2	1
fam19187	2	3	2	2.3333333333333335	0.5773502691896258	0.24743582965269678	3	2	1
fam19188	2	3	2	2.3333333333333335	0.5773502691896258	0.24743582965269678	3	2	1
fam19189	2	2	3	2.3333333333333335	0.5773502691896258	0.24743582965269678	3	2	1
fam19190	2	2	3	2.3333333333333335	0.5773502691896258	0.24743582965269678	3	2	1
fam19191	2	2	3	2.3333333333333335	0.5773502691896258	0.24743582965269678	3	2	1
fam19192	2	2	3	2.3333333333333335	0.5773502691896258	0.24743582965269678	3	2	1
fam19193	2	2	3	2.3333333333333335	0.5773502691896258	0.24743582965269678	3	2	1
fam19194	2	3	2	2.3333333333333335	0.5773502691896258	0.24743582965269678	3	2	1
fam19195	2	3	2	2.3333333333333335	0.5773502691896258	0.24743582965269678	3	2	1
fam19196	2	2	3	2.3333333333333335	0.5773502691896258	0.24743582965269678	3	2	1
fam19197	2	3	2	2.3333333333333335	0.5773502691896258	0.24743582965269678	3	2	1
fam19198	2	3	2	2.3333333333333335	0.5773502691896258	0.24743582965269678	3	2	1
fam19199	2	2	3	2.3333333333333335	0.5773502691896258	0.24743582965269678	3	2	1
fam19200	2	3	2	2.3333333333333335	0.5773502691896258	0.24743582965269678	3	2	1
fam19201	2	3	2	2.3333333333333335	0.5773502691896258	0.24743582965269678	3	2	1
fam19202	2	2	3	2.3333333333333335	0.5773502691896258	0.24743582965269678	3	2	1
fam19203	2	3	2	2.3333333333333335	0.5773502691896258	0.24743582965269678	3	2	1
fam19204	2	3	2	2.3333333333333335	0.5773502691896258	0.24743582965269678	3	2	1
fam19205	2	3	2	2.3333333333333335	0.5773502691896258	0.24743582965269678	3	2	1
fam19206	2	2	3	2.3333333333333335	0.5773502691896258	0.24743582965269678	3	2	1
fam19207	2	2	3	2.3333333333333335	0.5773502691896258	0.24743582965269678	3	2	1
fam19208	2	2	3	2.3333333333333335	0.5773502691896258	0.24743582965269678	3	2	1
fam19209	2	3	2	2.3333333333333335	0.5773502691896258	0.24743582965269678	3	2	1
fam19210	2	3	2	2.3333333333333335	0.5773502691896258	0.24743582965269678	3	2	1
fam19211	2	2	3	2.3333333333333335	0.5773502691896258	0.24743582965269678	3	2	1
fam19212	2	2	3	2.3333333333333335	0.5773502691896258	0.24743582965269678	3	2	1
fam19213	2	3	2	2.3333333333333335	0.5773502691896258	0.24743582965269678	3	2	1
fam19214	2	3	2	2.3333333333333335	0.5773502691896258	0.24743582965269678	3	2	1
fam19215	2	3	2	2.3333333333333335	0.5773502691896258	0.24743582965269678	3	2	1
fam19216	3	2	2	2.3333333333333335	0.5773502691896258	0.24743582965269678	3	2	1
fam19217	2	2	3	2.3333333333333335	0.5773502691896258	0.24743582965269678	3	2	1
fam19218	2	2	3	2.3333333333333335	0.5773502691896258	0.24743582965269678	3	2	1
fam19219	2	3	2	2.3333333333333335	0.5773502691896258	0.24743582965269678	3	2	1
fam19220	3	2	2	2.3333333333333335	0.5773502691896258	0.24743582965269678	3	2	1
fam19221	2	2	3	2.3333333333333335	0.5773502691896258	0.24743582965269678	3	2	1
fam19222	3	2	2	2.3333333333333335	0.5773502691896258	0.24743582965269678	3	2	1
fam19223	2	2	3	2.3333333333333335	0.5773502691896258	0.24743582965269678	3	2	1
fam19224	3	2	2	2.3333333333333335	0.5773502691896258	0.24743582965269678	3	2	1
fam19225	2	2	3	2.3333333333333335	0.5773502691896258	0.24743582965269678	3	2	1
fam19226	2	3	2	2.3333333333333335	0.5773502691896258	0.24743582965269678	3	2	1
fam19227	2	3	2	2.3333333333333335	0.5773502691896258	0.24743582965269678	3	2	1
fam19228	2	4	2	2.6666666666666665	1.1547005383792515	0.4330127018922193	4	2	2
fam19229	2	2	4	2.6666666666666665	1.1547005383792515	0.4330127018922193	4	2	2
fam19230	2	2	4	2.6666666666666665	1.1547005383792515	0.4330127018922193	4	2	2
fam19231	2	2	4	2.6666666666666665	1.1547005383792515	0.4330127018922193	4	2	2
fam19232	2	4	2	2.6666666666666665	1.1547005383792515	0.4330127018922193	4	2	2
fam19233	2	2	4	2.6666666666666665	1.1547005383792515	0.4330127018922193	4	2	2
fam19234	2	4	2	2.6666666666666665	1.1547005383792515	0.4330127018922193	4	2	2
fam19235	2	2	4	2.6666666666666665	1.1547005383792515	0.4330127018922193	4	2	2
fam19236	2	4	2	2.6666666666666665	1.1547005383792515	0.4330127018922193	4	2	2
fam19237	2	4	2	2.6666666666666665	1.1547005383792515	0.4330127018922193	4	2	2
fam19238	2	4	2	2.6666666666666665	1.1547005383792515	0.4330127018922193	4	2	2
fam19239	2	2	4	2.6666666666666665	1.1547005383792515	0.4330127018922193	4	2	2
fam19240	2	4	2	2.6666666666666665	1.1547005383792515	0.4330127018922193	4	2	2
fam19241	2	4	2	2.6666666666666665	1.1547005383792515	0.4330127018922193	4	2	2
fam19242	2	4	2	2.6666666666666665	1.1547005383792515	0.4330127018922193	4	2	2
fam19243	2	4	2	2.6666666666666665	1.1547005383792515	0.4330127018922193	4	2	2
fam19244	2	4	2	2.6666666666666665	1.1547005383792515	0.4330127018922193	4	2	2
fam19245	2	2	4	2.6666666666666665	1.1547005383792515	0.4330127018922193	4	2	2
fam19246	2	4	2	2.6666666666666665	1.1547005383792515	0.4330127018922193	4	2	2
fam19247	2	2	4	2.6666666666666665	1.1547005383792515	0.4330127018922193	4	2	2
fam19248	2	4	2	2.6666666666666665	1.1547005383792515	0.4330127018922193	4	2	2
fam19249	2	2	4	2.6666666666666665	1.1547005383792515	0.4330127018922193	4	2	2
fam19250	2	2	4	2.6666666666666665	1.1547005383792515	0.4330127018922193	4	2	2
fam19251	2	4	2	2.6666666666666665	1.1547005383792515	0.4330127018922193	4	2	2
fam19252	2	4	2	2.6666666666666665	1.1547005383792515	0.4330127018922193	4	2	2
fam19253	2	4	2	2.6666666666666665	1.1547005383792515	0.4330127018922193	4	2	2
fam19254	2	4	2	2.6666666666666665	1.1547005383792515	0.4330127018922193	4	2	2
fam19255	2	4	2	2.6666666666666665	1.1547005383792515	0.4330127018922193	4	2	2
fam19256	2	2	4	2.6666666666666665	1.1547005383792515	0.4330127018922193	4	2	2
fam19257	2	2	4	2.6666666666666665	1.1547005383792515	0.4330127018922193	4	2	2
fam19258	2	4	2	2.6666666666666665	1.1547005383792515	0.4330127018922193	4	2	2
fam19259	2	4	2	2.6666666666666665	1.1547005383792515	0.4330127018922193	4	2	2
fam19260	2	4	2	2.6666666666666665	1.1547005383792515	0.4330127018922193	4	2	2
fam19261	2	2	4	2.6666666666666665	1.1547005383792515	0.4330127018922193	4	2	2
fam19262	2	4	2	2.6666666666666665	1.1547005383792515	0.4330127018922193	4	2	2
fam19263	2	4	2	2.6666666666666665	1.1547005383792515	0.4330127018922193	4	2	2
fam19264	2	4	2	2.6666666666666665	1.1547005383792515	0.4330127018922193	4	2	2
fam19265	2	4	2	2.6666666666666665	1.1547005383792515	0.4330127018922193	4	2	2
fam19266	2	2	4	2.6666666666666665	1.1547005383792515	0.4330127018922193	4	2	2
fam19267	2	4	2	2.6666666666666665	1.1547005383792515	0.4330127018922193	4	2	2
fam19268	2	4	2	2.6666666666666665	1.1547005383792515	0.4330127018922193	4	2	2
fam19269	2	4	2	2.6666666666666665	1.1547005383792515	0.4330127018922193	4	2	2
fam19270	2	4	2	2.6666666666666665	1.1547005383792515	0.4330127018922193	4	2	2
fam19271	2	4	2	2.6666666666666665	1.1547005383792515	0.4330127018922193	4	2	2
fam19272	2	4	2	2.6666666666666665	1.1547005383792515	0.4330127018922193	4	2	2
fam19273	2	4	2	2.6666666666666665	1.1547005383792515	0.4330127018922193	4	2	2
fam19274	2	4	2	2.6666666666666665	1.1547005383792515	0.4330127018922193	4	2	2
fam19275	2	4	2	2.6666666666666665	1.1547005383792515	0.4330127018922193	4	2	2
fam19276	2	4	2	2.6666666666666665	1.1547005383792515	0.4330127018922193	4	2	2
fam19277	2	4	2	2.6666666666666665	1.1547005383792515	0.4330127018922193	4	2	2
fam19278	2	4	2	2.6666666666666665	1.1547005383792515	0.4330127018922193	4	2	2
fam19279	2	2	4	2.6666666666666665	1.1547005383792515	0.4330127018922193	4	2	2
fam19280	2	4	2	2.6666666666666665	1.1547005383792515	0.4330127018922193	4	2	2
fam19281	2	4	2	2.6666666666666665	1.1547005383792515	0.4330127018922193	4	2	2
fam19282	2	4	2	2.6666666666666665	1.1547005383792515	0.4330127018922193	4	2	2
fam19283	2	4	2	2.6666666666666665	1.1547005383792515	0.4330127018922193	4	2	2
fam19284	2	2	4	2.6666666666666665	1.1547005383792515	0.4330127018922193	4	2	2
fam19285	2	4	2	2.6666666666666665	1.1547005383792515	0.4330127018922193	4	2	2
fam19286	2	2	4	2.6666666666666665	1.1547005383792515	0.4330127018922193	4	2	2
fam19287	2	4	2	2.6666666666666665	1.1547005383792515	0.4330127018922193	4	2	2
fam19288	2	4	2	2.6666666666666665	1.1547005383792515	0.4330127018922193	4	2	2
fam19289	2	4	2	2.6666666666666665	1.1547005383792515	0.4330127018922193	4	2	2
fam19290	2	2	4	2.6666666666666665	1.1547005383792515	0.4330127018922193	4	2	2
fam19291	2	4	2	2.6666666666666665	1.1547005383792515	0.4330127018922193	4	2	2
fam19292	2	2	4	2.6666666666666665	1.1547005383792515	0.4330127018922193	4	2	2
fam19293	2	2	4	2.6666666666666665	1.1547005383792515	0.4330127018922193	4	2	2
fam19294	2	2	4	2.6666666666666665	1.1547005383792515	0.4330127018922193	4	2	2
fam19295	2	4	2	2.6666666666666665	1.1547005383792515	0.4330127018922193	4	2	2
fam19296	2	4	2	2.6666666666666665	1.1547005383792515	0.4330127018922193	4	2	2
fam19297	2	4	2	2.6666666666666665	1.1547005383792515	0.4330127018922193	4	2	2
fam19298	2	4	2	2.6666666666666665	1.1547005383792515	0.4330127018922193	4	2	2
fam19299	2	4	2	2.6666666666666665	1.1547005383792515	0.4330127018922193	4	2	2
fam19300	4	2	2	2.6666666666666665	1.1547005383792515	0.4330127018922193	4	2	2
fam19301	2	4	2	2.6666666666666665	1.1547005383792515	0.4330127018922193	4	2	2
fam19302	2	4	2	2.6666666666666665	1.1547005383792515	0.4330127018922193	4	2	2
fam19303	2	4	2	2.6666666666666665	1.1547005383792515	0.4330127018922193	4	2	2
fam19304	2	2	4	2.6666666666666665	1.1547005383792515	0.4330127018922193	4	2	2
fam19305	2	4	2	2.6666666666666665	1.1547005383792515	0.4330127018922193	4	2	2
fam19306	2	4	2	2.6666666666666665	1.1547005383792515	0.4330127018922193	4	2	2
fam19307	2	4	2	2.6666666666666665	1.1547005383792515	0.4330127018922193	4	2	2
fam19308	2	4	2	2.6666666666666665	1.1547005383792515	0.4330127018922193	4	2	2
fam19309	2	4	2	2.6666666666666665	1.1547005383792515	0.4330127018922193	4	2	2
fam19310	2	4	2	2.6666666666666665	1.1547005383792515	0.4330127018922193	4	2	2
fam19311	2	4	2	2.6666666666666665	1.1547005383792515	0.4330127018922193	4	2	2
fam19312	2	4	2	2.6666666666666665	1.1547005383792515	0.4330127018922193	4	2	2
fam19313	2	2	4	2.6666666666666665	1.1547005383792515	0.4330127018922193	4	2	2
fam19314	2	2	4	2.6666666666666665	1.1547005383792515	0.4330127018922193	4	2	2
fam19315	2	2	4	2.6666666666666665	1.1547005383792515	0.4330127018922193	4	2	2
fam19316	2	4	2	2.6666666666666665	1.1547005383792515	0.4330127018922193	4	2	2
fam19317	4	2	2	2.6666666666666665	1.1547005383792515	0.4330127018922193	4	2	2
fam19318	4	2	2	2.6666666666666665	1.1547005383792515	0.4330127018922193	4	2	2
fam19319	2	4	2	2.6666666666666665	1.1547005383792515	0.4330127018922193	4	2	2
fam19320	2	2	3	2.3333333333333335	0.5773502691896258	0.24743582965269678	3	2	1
fam19321	2	2	3	2.3333333333333335	0.5773502691896258	0.24743582965269678	3	2	1
fam19322	2	2	3	2.3333333333333335	0.5773502691896258	0.24743582965269678	3	2	1
fam19323	2	2	3	2.3333333333333335	0.5773502691896258	0.24743582965269678	3	2	1
fam19324	2	3	2	2.3333333333333335	0.5773502691896258	0.24743582965269678	3	2	1
fam19325	2	2	3	2.3333333333333335	0.5773502691896258	0.24743582965269678	3	2	1
fam19326	2	2	3	2.3333333333333335	0.5773502691896258	0.24743582965269678	3	2	1
fam19327	2	3	2	2.3333333333333335	0.5773502691896258	0.24743582965269678	3	2	1
fam19328	2	2	3	2.3333333333333335	0.5773502691896258	0.24743582965269678	3	2	1
fam19329	2	3	2	2.3333333333333335	0.5773502691896258	0.24743582965269678	3	2	1
fam19330	2	3	2	2.3333333333333335	0.5773502691896258	0.24743582965269678	3	2	1
fam19331	2	3	2	2.3333333333333335	0.5773502691896258	0.24743582965269678	3	2	1
fam19332	2	3	2	2.3333333333333335	0.5773502691896258	0.24743582965269678	3	2	1
fam19333	2	2	3	2.3333333333333335	0.5773502691896258	0.24743582965269678	3	2	1
fam19334	2	3	2	2.3333333333333335	0.5773502691896258	0.24743582965269678	3	2	1
fam19335	2	3	2	2.3333333333333335	0.5773502691896258	0.24743582965269678	3	2	1
fam19336	2	3	2	2.3333333333333335	0.5773502691896258	0.24743582965269678	3	2	1
fam19337	2	2	3	2.3333333333333335	0.5773502691896258	0.24743582965269678	3	2	1
fam19338	2	3	2	2.3333333333333335	0.5773502691896258	0.24743582965269678	3	2	1
fam19339	2	3	2	2.3333333333333335	0.5773502691896258	0.24743582965269678	3	2	1
fam19340	2	3	2	2.3333333333333335	0.5773502691896258	0.24743582965269678	3	2	1
fam19341	2	2	3	2.3333333333333335	0.5773502691896258	0.24743582965269678	3	2	1
fam19342	2	3	2	2.3333333333333335	0.5773502691896258	0.24743582965269678	3	2	1
fam19343	2	2	2	2.0	0.0	0.0	2	2	0
fam19344	2	2	2	2.0	0.0	0.0	2	2	0
fam19345	2	2	2	2.0	0.0	0.0	2	2	0
fam19346	2	2	2	2.0	0.0	0.0	2	2	0
fam19347	2	2	2	2.0	0.0	0.0	2	2	0
fam19348	2	2	2	2.0	0.0	0.0	2	2	0
fam19349	2	2	2	2.0	0.0	0.0	2	2	0
fam19350	2	2	2	2.0	0.0	0.0	2	2	0
fam19351	2	2	2	2.0	0.0	0.0	2	2	0
fam19352	2	2	2	2.0	0.0	0.0	2	2	0
fam19353	2	2	2	2.0	0.0	0.0	2	2	0
fam19354	2	2	2	2.0	0.0	0.0	2	2	0
fam19355	2	2	2	2.0	0.0	0.0	2	2	0
fam19356	2	2	2	2.0	0.0	0.0	2	2	0
fam19357	2	2	2	2.0	0.0	0.0	2	2	0
fam19358	2	2	2	2.0	0.0	0.0	2	2	0
fam19359	2	2	2	2.0	0.0	0.0	2	2	0
fam19360	2	2	2	2.0	0.0	0.0	2	2	0
fam19361	2	2	2	2.0	0.0	0.0	2	2	0
fam19362	2	2	2	2.0	0.0	0.0	2	2	0
fam19363	2	2	2	2.0	0.0	0.0	2	2	0
fam19364	2	2	2	2.0	0.0	0.0	2	2	0
fam19365	2	2	2	2.0	0.0	0.0	2	2	0
fam19366	2	2	2	2.0	0.0	0.0	2	2	0
fam19367	2	2	2	2.0	0.0	0.0	2	2	0
fam19368	2	2	2	2.0	0.0	0.0	2	2	0
fam19369	2	2	2	2.0	0.0	0.0	2	2	0
fam19370	2	2	2	2.0	0.0	0.0	2	2	0
fam19371	2	2	2	2.0	0.0	0.0	2	2	0
fam19372	2	2	2	2.0	0.0	0.0	2	2	0
fam19373	2	2	2	2.0	0.0	0.0	2	2	0
fam19374	2	2	2	2.0	0.0	0.0	2	2	0
fam19375	2	2	2	2.0	0.0	0.0	2	2	0
fam19376	2	2	2	2.0	0.0	0.0	2	2	0
fam19377	2	2	2	2.0	0.0	0.0	2	2	0
fam19378	2	2	2	2.0	0.0	0.0	2	2	0
fam19379	2	2	2	2.0	0.0	0.0	2	2	0
fam19380	2	2	2	2.0	0.0	0.0	2	2	0
fam19381	2	2	2	2.0	0.0	0.0	2	2	0
fam19382	2	2	2	2.0	0.0	0.0	2	2	0
fam19383	2	2	2	2.0	0.0	0.0	2	2	0
fam19384	2	2	2	2.0	0.0	0.0	2	2	0
fam19385	2	2	2	2.0	0.0	0.0	2	2	0
fam19386	2	2	2	2.0	0.0	0.0	2	2	0
fam19387	2	2	2	2.0	0.0	0.0	2	2	0
fam19388	2	2	2	2.0	0.0	0.0	2	2	0
fam19389	2	2	2	2.0	0.0	0.0	2	2	0
fam19390	2	2	2	2.0	0.0	0.0	2	2	0
fam19391	2	2	2	2.0	0.0	0.0	2	2	0
fam19392	2	2	2	2.0	0.0	0.0	2	2	0
fam19393	2	2	2	2.0	0.0	0.0	2	2	0
fam19394	2	2	2	2.0	0.0	0.0	2	2	0
fam19395	2	2	2	2.0	0.0	0.0	2	2	0
fam19396	2	2	2	2.0	0.0	0.0	2	2	0
fam19397	2	2	2	2.0	0.0	0.0	2	2	0
fam19398	2	2	2	2.0	0.0	0.0	2	2	0
fam19399	2	2	2	2.0	0.0	0.0	2	2	0
fam19400	2	2	2	2.0	0.0	0.0	2	2	0
fam19401	2	2	2	2.0	0.0	0.0	2	2	0
fam19402	2	2	2	2.0	0.0	0.0	2	2	0
fam19403	2	2	2	2.0	0.0	0.0	2	2	0
fam19404	2	2	2	2.0	0.0	0.0	2	2	0
fam19405	2	2	2	2.0	0.0	0.0	2	2	0
fam19406	2	2	2	2.0	0.0	0.0	2	2	0
fam19407	2	2	2	2.0	0.0	0.0	2	2	0
fam19408	2	2	2	2.0	0.0	0.0	2	2	0
fam19409	2	2	2	2.0	0.0	0.0	2	2	0
fam19410	2	2	2	2.0	0.0	0.0	2	2	0
fam19411	2	2	2	2.0	0.0	0.0	2	2	0
fam19412	2	2	2	2.0	0.0	0.0	2	2	0
fam19413	2	2	2	2.0	0.0	0.0	2	2	0
fam19414	2	2	2	2.0	0.0	0.0	2	2	0
fam19415	2	2	2	2.0	0.0	0.0	2	2	0
fam19416	2	2	2	2.0	0.0	0.0	2	2	0
fam19417	2	2	2	2.0	0.0	0.0	2	2	0
fam19418	2	2	2	2.0	0.0	0.0	2	2	0
fam19419	2	2	2	2.0	0.0	0.0	2	2	0
fam19420	2	2	2	2.0	0.0	0.0	2	2	0
fam19421	2	2	2	2.0	0.0	0.0	2	2	0
fam19422	2	2	2	2.0	0.0	0.0	2	2	0
fam19423	2	2	2	2.0	0.0	0.0	2	2	0
fam19424	2	2	2	2.0	0.0	0.0	2	2	0
fam19425	2	2	2	2.0	0.0	0.0	2	2	0
fam19426	2	2	2	2.0	0.0	0.0	2	2	0
fam19427	2	2	2	2.0	0.0	0.0	2	2	0
fam19428	2	2	2	2.0	0.0	0.0	2	2	0
fam19429	2	2	2	2.0	0.0	0.0	2	2	0
fam19430	2	2	2	2.0	0.0	0.0	2	2	0
fam19431	2	2	2	2.0	0.0	0.0	2	2	0
fam19432	2	2	2	2.0	0.0	0.0	2	2	0
fam19433	2	2	2	2.0	0.0	0.0	2	2	0
fam19434	2	2	2	2.0	0.0	0.0	2	2	0
fam19435	2	2	2	2.0	0.0	0.0	2	2	0
fam19436	2	2	2	2.0	0.0	0.0	2	2	0
fam19437	2	2	2	2.0	0.0	0.0	2	2	0
fam19438	2	2	2	2.0	0.0	0.0	2	2	0
fam19439	2	2	2	2.0	0.0	0.0	2	2	0
fam19440	2	2	2	2.0	0.0	0.0	2	2	0
fam19441	2	2	2	2.0	0.0	0.0	2	2	0
fam19442	2	2	2	2.0	0.0	0.0	2	2	0
fam19443	2	2	2	2.0	0.0	0.0	2	2	0
fam19444	2	2	2	2.0	0.0	0.0	2	2	0
fam19445	2	2	2	2.0	0.0	0.0	2	2	0
fam19446	2	2	2	2.0	0.0	0.0	2	2	0
fam19447	2	2	2	2.0	0.0	0.0	2	2	0
fam19448	2	2	2	2.0	0.0	0.0	2	2	0
fam19449	2	2	2	2.0	0.0	0.0	2	2	0
fam19450	2	2	2	2.0	0.0	0.0	2	2	0
fam19451	2	2	2	2.0	0.0	0.0	2	2	0
fam19452	2	2	2	2.0	0.0	0.0	2	2	0
fam19453	2	2	2	2.0	0.0	0.0	2	2	0
fam19454	2	2	2	2.0	0.0	0.0	2	2	0
fam19455	2	2	2	2.0	0.0	0.0	2	2	0
fam19456	2	2	2	2.0	0.0	0.0	2	2	0
fam19457	2	2	2	2.0	0.0	0.0	2	2	0
fam19458	2	2	2	2.0	0.0	0.0	2	2	0
fam19459	2	2	2	2.0	0.0	0.0	2	2	0
fam19460	2	2	2	2.0	0.0	0.0	2	2	0
fam19461	2	2	2	2.0	0.0	0.0	2	2	0
fam19462	2	2	2	2.0	0.0	0.0	2	2	0
fam19463	2	2	2	2.0	0.0	0.0	2	2	0
fam19464	2	2	2	2.0	0.0	0.0	2	2	0
fam19465	2	2	2	2.0	0.0	0.0	2	2	0
fam19466	2	2	2	2.0	0.0	0.0	2	2	0
fam19467	2	2	2	2.0	0.0	0.0	2	2	0
fam19468	2	2	2	2.0	0.0	0.0	2	2	0
fam19469	2	2	2	2.0	0.0	0.0	2	2	0
fam19470	2	2	2	2.0	0.0	0.0	2	2	0
fam19471	2	2	2	2.0	0.0	0.0	2	2	0
fam19472	2	2	2	2.0	0.0	0.0	2	2	0
fam19473	2	2	2	2.0	0.0	0.0	2	2	0
fam19474	2	2	2	2.0	0.0	0.0	2	2	0
fam19475	2	2	2	2.0	0.0	0.0	2	2	0
fam19476	2	2	2	2.0	0.0	0.0	2	2	0
fam19477	2	2	2	2.0	0.0	0.0	2	2	0
fam19478	2	2	2	2.0	0.0	0.0	2	2	0
fam19479	2	2	2	2.0	0.0	0.0	2	2	0
fam19480	2	2	2	2.0	0.0	0.0	2	2	0
fam19481	2	2	2	2.0	0.0	0.0	2	2	0
fam19482	2	2	2	2.0	0.0	0.0	2	2	0
fam19483	2	2	2	2.0	0.0	0.0	2	2	0
fam19484	2	2	2	2.0	0.0	0.0	2	2	0
fam19485	2	2	2	2.0	0.0	0.0	2	2	0
fam19486	2	2	2	2.0	0.0	0.0	2	2	0
fam19487	2	2	2	2.0	0.0	0.0	2	2	0
fam19488	2	2	2	2.0	0.0	0.0	2	2	0
fam19489	2	2	2	2.0	0.0	0.0	2	2	0
fam19490	2	2	2	2.0	0.0	0.0	2	2	0
fam19491	2	2	2	2.0	0.0	0.0	2	2	0
fam19492	2	2	2	2.0	0.0	0.0	2	2	0
fam19493	2	2	2	2.0	0.0	0.0	2	2	0
fam19494	2	2	2	2.0	0.0	0.0	2	2	0
fam19495	2	2	2	2.0	0.0	0.0	2	2	0
fam19496	2	2	2	2.0	0.0	0.0	2	2	0
fam19497	2	2	2	2.0	0.0	0.0	2	2	0
fam19498	2	2	2	2.0	0.0	0.0	2	2	0
fam19499	2	2	2	2.0	0.0	0.0	2	2	0
fam19500	2	2	2	2.0	0.0	0.0	2	2	0
fam19501	2	2	2	2.0	0.0	0.0	2	2	0
fam19502	2	2	2	2.0	0.0	0.0	2	2	0
fam19503	2	2	2	2.0	0.0	0.0	2	2	0
fam19504	2	2	2	2.0	0.0	0.0	2	2	0
fam19505	2	2	2	2.0	0.0	0.0	2	2	0
fam19506	2	2	2	2.0	0.0	0.0	2	2	0
fam19507	2	2	2	2.0	0.0	0.0	2	2	0
fam19508	2	2	2	2.0	0.0	0.0	2	2	0
fam19509	2	2	2	2.0	0.0	0.0	2	2	0
fam19510	2	2	2	2.0	0.0	0.0	2	2	0
fam19511	2	2	2	2.0	0.0	0.0	2	2	0
fam19512	2	2	2	2.0	0.0	0.0	2	2	0
fam19513	2	2	2	2.0	0.0	0.0	2	2	0
fam19514	2	2	2	2.0	0.0	0.0	2	2	0
fam19515	2	2	2	2.0	0.0	0.0	2	2	0
fam19516	2	2	2	2.0	0.0	0.0	2	2	0
fam19517	2	2	2	2.0	0.0	0.0	2	2	0
fam19518	2	2	2	2.0	0.0	0.0	2	2	0
fam19519	2	2	2	2.0	0.0	0.0	2	2	0
fam19520	2	2	2	2.0	0.0	0.0	2	2	0
fam19521	2	2	2	2.0	0.0	0.0	2	2	0
fam19522	2	2	2	2.0	0.0	0.0	2	2	0
fam19523	2	2	2	2.0	0.0	0.0	2	2	0
fam19524	2	2	2	2.0	0.0	0.0	2	2	0
fam19525	2	2	2	2.0	0.0	0.0	2	2	0
fam19526	2	2	2	2.0	0.0	0.0	2	2	0
fam19527	2	2	2	2.0	0.0	0.0	2	2	0
fam19528	2	2	2	2.0	0.0	0.0	2	2	0
fam19529	2	2	2	2.0	0.0	0.0	2	2	0
fam19530	2	2	2	2.0	0.0	0.0	2	2	0
fam19531	2	2	2	2.0	0.0	0.0	2	2	0
fam19532	2	2	2	2.0	0.0	0.0	2	2	0
fam19533	2	2	2	2.0	0.0	0.0	2	2	0
fam19534	2	2	2	2.0	0.0	0.0	2	2	0
fam19535	2	2	2	2.0	0.0	0.0	2	2	0
fam19536	2	2	2	2.0	0.0	0.0	2	2	0
fam19537	2	2	2	2.0	0.0	0.0	2	2	0
fam19538	2	2	2	2.0	0.0	0.0	2	2	0
fam19539	2	2	2	2.0	0.0	0.0	2	2	0
fam19540	2	2	2	2.0	0.0	0.0	2	2	0
fam19541	2	2	2	2.0	0.0	0.0	2	2	0
fam19542	2	2	2	2.0	0.0	0.0	2	2	0
fam19543	2	2	2	2.0	0.0	0.0	2	2	0
fam19544	2	2	2	2.0	0.0	0.0	2	2	0
fam19545	2	2	2	2.0	0.0	0.0	2	2	0
fam19546	2	2	2	2.0	0.0	0.0	2	2	0
fam19547	2	2	2	2.0	0.0	0.0	2	2	0
fam19548	2	2	2	2.0	0.0	0.0	2	2	0
fam19549	2	2	2	2.0	0.0	0.0	2	2	0
fam19550	2	2	2	2.0	0.0	0.0	2	2	0
fam19551	2	2	2	2.0	0.0	0.0	2	2	0
fam19552	2	2	2	2.0	0.0	0.0	2	2	0
fam19553	2	2	2	2.0	0.0	0.0	2	2	0
fam19554	2	2	2	2.0	0.0	0.0	2	2	0
fam19555	2	2	2	2.0	0.0	0.0	2	2	0
fam19556	2	2	2	2.0	0.0	0.0	2	2	0
fam19557	2	2	2	2.0	0.0	0.0	2	2	0
fam19558	2	2	2	2.0	0.0	0.0	2	2	0
fam19559	2	2	2	2.0	0.0	0.0	2	2	0
fam19560	2	2	2	2.0	0.0	0.0	2	2	0
fam19561	2	2	2	2.0	0.0	0.0	2	2	0
fam19562	2	2	2	2.0	0.0	0.0	2	2	0
fam19563	2	2	2	2.0	0.0	0.0	2	2	0
fam19564	2	2	2	2.0	0.0	0.0	2	2	0
fam19565	2	2	2	2.0	0.0	0.0	2	2	0
fam19566	2	2	2	2.0	0.0	0.0	2	2	0
fam19567	2	2	2	2.0	0.0	0.0	2	2	0
fam19568	2	2	2	2.0	0.0	0.0	2	2	0
fam19569	2	2	2	2.0	0.0	0.0	2	2	0
fam19570	2	2	2	2.0	0.0	0.0	2	2	0
fam19571	2	2	2	2.0	0.0	0.0	2	2	0
fam19572	2	2	2	2.0	0.0	0.0	2	2	0
fam19573	2	2	2	2.0	0.0	0.0	2	2	0
fam19574	2	2	2	2.0	0.0	0.0	2	2	0
fam19575	2	2	2	2.0	0.0	0.0	2	2	0
fam19576	2	2	2	2.0	0.0	0.0	2	2	0
fam19577	2	2	2	2.0	0.0	0.0	2	2	0
fam19578	2	2	2	2.0	0.0	0.0	2	2	0
fam19579	2	2	2	2.0	0.0	0.0	2	2	0
fam19580	2	2	2	2.0	0.0	0.0	2	2	0
fam19581	2	2	2	2.0	0.0	0.0	2	2	0
fam19582	2	2	2	2.0	0.0	0.0	2	2	0
fam19583	2	2	2	2.0	0.0	0.0	2	2	0
fam19584	2	2	2	2.0	0.0	0.0	2	2	0
fam19585	2	2	2	2.0	0.0	0.0	2	2	0
fam19586	2	2	2	2.0	0.0	0.0	2	2	0
fam19587	2	2	2	2.0	0.0	0.0	2	2	0
fam19588	2	2	2	2.0	0.0	0.0	2	2	0
fam19589	2	2	2	2.0	0.0	0.0	2	2	0
fam19590	2	2	2	2.0	0.0	0.0	2	2	0
fam19591	2	2	2	2.0	0.0	0.0	2	2	0
fam19592	2	2	2	2.0	0.0	0.0	2	2	0
fam19593	2	2	2	2.0	0.0	0.0	2	2	0
fam19594	2	2	2	2.0	0.0	0.0	2	2	0
fam19595	2	2	2	2.0	0.0	0.0	2	2	0
fam19596	2	2	2	2.0	0.0	0.0	2	2	0
fam19597	2	2	2	2.0	0.0	0.0	2	2	0
fam19598	2	2	2	2.0	0.0	0.0	2	2	0
fam19599	2	2	2	2.0	0.0	0.0	2	2	0
fam19600	2	2	2	2.0	0.0	0.0	2	2	0
fam19601	2	2	2	2.0	0.0	0.0	2	2	0
fam19602	2	2	2	2.0	0.0	0.0	2	2	0
fam19603	2	2	2	2.0	0.0	0.0	2	2	0
fam19604	2	2	2	2.0	0.0	0.0	2	2	0
fam19605	2	2	2	2.0	0.0	0.0	2	2	0
fam19606	2	2	2	2.0	0.0	0.0	2	2	0
fam19607	2	2	2	2.0	0.0	0.0	2	2	0
fam19608	2	2	2	2.0	0.0	0.0	2	2	0
fam19609	2	2	2	2.0	0.0	0.0	2	2	0
fam19610	2	2	2	2.0	0.0	0.0	2	2	0
fam19611	2	2	2	2.0	0.0	0.0	2	2	0
fam19612	2	2	2	2.0	0.0	0.0	2	2	0
fam19613	2	2	2	2.0	0.0	0.0	2	2	0
fam19614	2	2	2	2.0	0.0	0.0	2	2	0
fam19615	2	2	2	2.0	0.0	0.0	2	2	0
fam19616	2	2	2	2.0	0.0	0.0	2	2	0
fam19617	2	2	2	2.0	0.0	0.0	2	2	0
fam19618	2	2	2	2.0	0.0	0.0	2	2	0
fam19619	2	2	2	2.0	0.0	0.0	2	2	0
fam19620	2	2	2	2.0	0.0	0.0	2	2	0
fam19621	2	2	2	2.0	0.0	0.0	2	2	0
fam19622	2	2	2	2.0	0.0	0.0	2	2	0
fam19623	2	2	2	2.0	0.0	0.0	2	2	0
fam19624	2	2	2	2.0	0.0	0.0	2	2	0
fam19625	2	2	2	2.0	0.0	0.0	2	2	0
fam19626	2	2	2	2.0	0.0	0.0	2	2	0
fam19627	2	2	2	2.0	0.0	0.0	2	2	0
fam19628	2	2	2	2.0	0.0	0.0	2	2	0
fam19629	2	2	2	2.0	0.0	0.0	2	2	0
fam19630	2	2	2	2.0	0.0	0.0	2	2	0
fam19631	2	2	2	2.0	0.0	0.0	2	2	0
fam19632	2	2	2	2.0	0.0	0.0	2	2	0
fam19633	2	2	2	2.0	0.0	0.0	2	2	0
fam19634	2	2	2	2.0	0.0	0.0	2	2	0
fam19635	2	2	2	2.0	0.0	0.0	2	2	0
fam19636	2	2	2	2.0	0.0	0.0	2	2	0
fam19637	2	2	2	2.0	0.0	0.0	2	2	0
fam19638	2	2	2	2.0	0.0	0.0	2	2	0
fam19639	2	2	2	2.0	0.0	0.0	2	2	0
fam19640	2	2	2	2.0	0.0	0.0	2	2	0
fam19641	2	2	2	2.0	0.0	0.0	2	2	0
fam19642	2	2	2	2.0	0.0	0.0	2	2	0
fam19643	2	2	2	2.0	0.0	0.0	2	2	0
fam19644	2	2	2	2.0	0.0	0.0	2	2	0
fam19645	2	2	2	2.0	0.0	0.0	2	2	0
fam19646	2	2	2	2.0	0.0	0.0	2	2	0
fam19647	2	2	2	2.0	0.0	0.0	2	2	0
fam19648	2	2	2	2.0	0.0	0.0	2	2	0
fam19649	2	2	2	2.0	0.0	0.0	2	2	0
fam19650	2	2	2	2.0	0.0	0.0	2	2	0
fam19651	2	2	2	2.0	0.0	0.0	2	2	0
fam19652	2	2	2	2.0	0.0	0.0	2	2	0
fam19653	2	2	3	2.3333333333333335	0.5773502691896258	0.24743582965269678	3	2	1
fam19654	2	2	3	2.3333333333333335	0.5773502691896258	0.24743582965269678	3	2	1
fam19655	2	3	2	2.3333333333333335	0.5773502691896258	0.24743582965269678	3	2	1
fam19656	2	3	2	2.3333333333333335	0.5773502691896258	0.24743582965269678	3	2	1
fam19657	2	3	2	2.3333333333333335	0.5773502691896258	0.24743582965269678	3	2	1
fam19658	2	2	3	2.3333333333333335	0.5773502691896258	0.24743582965269678	3	2	1
fam19659	2	3	2	2.3333333333333335	0.5773502691896258	0.24743582965269678	3	2	1
fam19660	2	3	2	2.3333333333333335	0.5773502691896258	0.24743582965269678	3	2	1
fam19661	2	3	2	2.3333333333333335	0.5773502691896258	0.24743582965269678	3	2	1
fam19662	2	3	2	2.3333333333333335	0.5773502691896258	0.24743582965269678	3	2	1
fam19663	2	3	2	2.3333333333333335	0.5773502691896258	0.24743582965269678	3	2	1
fam19664	2	2	3	2.3333333333333335	0.5773502691896258	0.24743582965269678	3	2	1
fam19665	2	3	2	2.3333333333333335	0.5773502691896258	0.24743582965269678	3	2	1
fam19666	2	3	2	2.3333333333333335	0.5773502691896258	0.24743582965269678	3	2	1
fam19667	2	3	2	2.3333333333333335	0.5773502691896258	0.24743582965269678	3	2	1
fam19668	2	2	3	2.3333333333333335	0.5773502691896258	0.24743582965269678	3	2	1
fam19669	2	3	2	2.3333333333333335	0.5773502691896258	0.24743582965269678	3	2	1
fam19670	2	2	3	2.3333333333333335	0.5773502691896258	0.24743582965269678	3	2	1
fam19671	2	2	3	2.3333333333333335	0.5773502691896258	0.24743582965269678	3	2	1
fam19672	2	3	2	2.3333333333333335	0.5773502691896258	0.24743582965269678	3	2	1
fam19673	2	2	3	2.3333333333333335	0.5773502691896258	0.24743582965269678	3	2	1
fam19674	2	3	2	2.3333333333333335	0.5773502691896258	0.24743582965269678	3	2	1
fam19675	2	2	3	2.3333333333333335	0.5773502691896258	0.24743582965269678	3	2	1
fam19676	2	3	2	2.3333333333333335	0.5773502691896258	0.24743582965269678	3	2	1
fam19677	2	2	3	2.3333333333333335	0.5773502691896258	0.24743582965269678	3	2	1
fam19678	2	2	3	2.3333333333333335	0.5773502691896258	0.24743582965269678	3	2	1
fam19679	2	3	2	2.3333333333333335	0.5773502691896258	0.24743582965269678	3	2	1
fam19680	2	3	2	2.3333333333333335	0.5773502691896258	0.24743582965269678	3	2	1
fam19681	2	3	2	2.3333333333333335	0.5773502691896258	0.24743582965269678	3	2	1
fam19682	2	2	3	2.3333333333333335	0.5773502691896258	0.24743582965269678	3	2	1
fam19683	2	3	2	2.3333333333333335	0.5773502691896258	0.24743582965269678	3	2	1
fam19684	2	3	2	2.3333333333333335	0.5773502691896258	0.24743582965269678	3	2	1
fam19685	2	2	3	2.3333333333333335	0.5773502691896258	0.24743582965269678	3	2	1
fam19686	2	3	2	2.3333333333333335	0.5773502691896258	0.24743582965269678	3	2	1
fam19687	2	3	2	2.3333333333333335	0.5773502691896258	0.24743582965269678	3	2	1
fam19688	2	3	2	2.3333333333333335	0.5773502691896258	0.24743582965269678	3	2	1
fam19689	2	2	3	2.3333333333333335	0.5773502691896258	0.24743582965269678	3	2	1
fam19690	2	3	2	2.3333333333333335	0.5773502691896258	0.24743582965269678	3	2	1
fam19691	2	3	2	2.3333333333333335	0.5773502691896258	0.24743582965269678	3	2	1
fam19692	2	3	2	2.3333333333333335	0.5773502691896258	0.24743582965269678	3	2	1
fam19693	2	3	2	2.3333333333333335	0.5773502691896258	0.24743582965269678	3	2	1
fam19694	2	2	3	2.3333333333333335	0.5773502691896258	0.24743582965269678	3	2	1
fam19695	2	3	2	2.3333333333333335	0.5773502691896258	0.24743582965269678	3	2	1
fam19696	2	2	3	2.3333333333333335	0.5773502691896258	0.24743582965269678	3	2	1
fam19697	2	2	3	2.3333333333333335	0.5773502691896258	0.24743582965269678	3	2	1
fam19698	2	3	2	2.3333333333333335	0.5773502691896258	0.24743582965269678	3	2	1
fam19699	2	3	2	2.3333333333333335	0.5773502691896258	0.24743582965269678	3	2	1
fam19700	2	2	3	2.3333333333333335	0.5773502691896258	0.24743582965269678	3	2	1
fam19701	2	2	3	2.3333333333333335	0.5773502691896258	0.24743582965269678	3	2	1
fam19702	2	3	2	2.3333333333333335	0.5773502691896258	0.24743582965269678	3	2	1
fam19703	2	3	2	2.3333333333333335	0.5773502691896258	0.24743582965269678	3	2	1
fam19704	2	3	2	2.3333333333333335	0.5773502691896258	0.24743582965269678	3	2	1
fam19705	2	2	3	2.3333333333333335	0.5773502691896258	0.24743582965269678	3	2	1
fam19706	2	3	2	2.3333333333333335	0.5773502691896258	0.24743582965269678	3	2	1
fam19707	2	3	2	2.3333333333333335	0.5773502691896258	0.24743582965269678	3	2	1
fam19708	2	2	3	2.3333333333333335	0.5773502691896258	0.24743582965269678	3	2	1
fam19709	2	3	2	2.3333333333333335	0.5773502691896258	0.24743582965269678	3	2	1
fam19710	2	3	2	2.3333333333333335	0.5773502691896258	0.24743582965269678	3	2	1
fam19711	2	2	3	2.3333333333333335	0.5773502691896258	0.24743582965269678	3	2	1
fam19712	2	3	2	2.3333333333333335	0.5773502691896258	0.24743582965269678	3	2	1
fam19713	2	3	2	2.3333333333333335	0.5773502691896258	0.24743582965269678	3	2	1
fam19714	2	3	2	2.3333333333333335	0.5773502691896258	0.24743582965269678	3	2	1
fam19715	2	2	3	2.3333333333333335	0.5773502691896258	0.24743582965269678	3	2	1
fam19716	2	3	2	2.3333333333333335	0.5773502691896258	0.24743582965269678	3	2	1
fam19717	2	2	3	2.3333333333333335	0.5773502691896258	0.24743582965269678	3	2	1
fam19718	2	3	2	2.3333333333333335	0.5773502691896258	0.24743582965269678	3	2	1
fam19719	2	3	2	2.3333333333333335	0.5773502691896258	0.24743582965269678	3	2	1
fam19720	2	2	3	2.3333333333333335	0.5773502691896258	0.24743582965269678	3	2	1
fam19721	2	2	3	2.3333333333333335	0.5773502691896258	0.24743582965269678	3	2	1
fam19722	2	3	2	2.3333333333333335	0.5773502691896258	0.24743582965269678	3	2	1
fam19723	2	3	2	2.3333333333333335	0.5773502691896258	0.24743582965269678	3	2	1
fam19724	2	2	3	2.3333333333333335	0.5773502691896258	0.24743582965269678	3	2	1
fam19725	2	2	3	2.3333333333333335	0.5773502691896258	0.24743582965269678	3	2	1
fam19726	2	2	3	2.3333333333333335	0.5773502691896258	0.24743582965269678	3	2	1
fam19727	2	3	2	2.3333333333333335	0.5773502691896258	0.24743582965269678	3	2	1
fam19728	2	3	2	2.3333333333333335	0.5773502691896258	0.24743582965269678	3	2	1
fam19729	2	3	2	2.3333333333333335	0.5773502691896258	0.24743582965269678	3	2	1
fam19730	2	3	2	2.3333333333333335	0.5773502691896258	0.24743582965269678	3	2	1
fam19731	2	3	2	2.3333333333333335	0.5773502691896258	0.24743582965269678	3	2	1
fam19732	2	2	3	2.3333333333333335	0.5773502691896258	0.24743582965269678	3	2	1
fam19733	2	2	3	2.3333333333333335	0.5773502691896258	0.24743582965269678	3	2	1
fam19734	2	3	2	2.3333333333333335	0.5773502691896258	0.24743582965269678	3	2	1
fam19735	2	3	2	2.3333333333333335	0.5773502691896258	0.24743582965269678	3	2	1
fam19736	2	3	2	2.3333333333333335	0.5773502691896258	0.24743582965269678	3	2	1
fam19737	2	3	2	2.3333333333333335	0.5773502691896258	0.24743582965269678	3	2	1
fam19738	2	2	3	2.3333333333333335	0.5773502691896258	0.24743582965269678	3	2	1
fam19739	2	3	2	2.3333333333333335	0.5773502691896258	0.24743582965269678	3	2	1
fam19740	2	3	2	2.3333333333333335	0.5773502691896258	0.24743582965269678	3	2	1
fam19741	2	3	2	2.3333333333333335	0.5773502691896258	0.24743582965269678	3	2	1
fam19742	2	3	2	2.3333333333333335	0.5773502691896258	0.24743582965269678	3	2	1
fam19743	2	3	2	2.3333333333333335	0.5773502691896258	0.24743582965269678	3	2	1
fam19744	2	3	2	2.3333333333333335	0.5773502691896258	0.24743582965269678	3	2	1
fam19745	2	3	2	2.3333333333333335	0.5773502691896258	0.24743582965269678	3	2	1
fam19746	2	2	3	2.3333333333333335	0.5773502691896258	0.24743582965269678	3	2	1
fam19747	2	2	3	2.3333333333333335	0.5773502691896258	0.24743582965269678	3	2	1
fam19748	2	3	2	2.3333333333333335	0.5773502691896258	0.24743582965269678	3	2	1
fam19749	2	3	2	2.3333333333333335	0.5773502691896258	0.24743582965269678	3	2	1
fam19750	2	3	2	2.3333333333333335	0.5773502691896258	0.24743582965269678	3	2	1
fam19751	2	2	3	2.3333333333333335	0.5773502691896258	0.24743582965269678	3	2	1
fam19752	2	3	2	2.3333333333333335	0.5773502691896258	0.24743582965269678	3	2	1
fam19753	2	3	2	2.3333333333333335	0.5773502691896258	0.24743582965269678	3	2	1
fam19754	2	3	2	2.3333333333333335	0.5773502691896258	0.24743582965269678	3	2	1
fam19755	2	3	2	2.3333333333333335	0.5773502691896258	0.24743582965269678	3	2	1
fam19756	2	3	2	2.3333333333333335	0.5773502691896258	0.24743582965269678	3	2	1
fam19757	2	3	2	2.3333333333333335	0.5773502691896258	0.24743582965269678	3	2	1
fam19758	2	3	2	2.3333333333333335	0.5773502691896258	0.24743582965269678	3	2	1
fam19759	2	3	2	2.3333333333333335	0.5773502691896258	0.24743582965269678	3	2	1
fam19760	2	3	2	2.3333333333333335	0.5773502691896258	0.24743582965269678	3	2	1
fam19761	2	3	2	2.3333333333333335	0.5773502691896258	0.24743582965269678	3	2	1
fam19762	2	3	2	2.3333333333333335	0.5773502691896258	0.24743582965269678	3	2	1
fam19763	2	3	2	2.3333333333333335	0.5773502691896258	0.24743582965269678	3	2	1
fam19764	2	3	2	2.3333333333333335	0.5773502691896258	0.24743582965269678	3	2	1
fam19765	2	3	2	2.3333333333333335	0.5773502691896258	0.24743582965269678	3	2	1
fam19766	2	2	3	2.3333333333333335	0.5773502691896258	0.24743582965269678	3	2	1
fam19767	2	3	2	2.3333333333333335	0.5773502691896258	0.24743582965269678	3	2	1
fam19768	2	2	3	2.3333333333333335	0.5773502691896258	0.24743582965269678	3	2	1
fam19769	2	3	2	2.3333333333333335	0.5773502691896258	0.24743582965269678	3	2	1
fam19770	2	3	2	2.3333333333333335	0.5773502691896258	0.24743582965269678	3	2	1
fam19771	2	3	2	2.3333333333333335	0.5773502691896258	0.24743582965269678	3	2	1
fam19772	2	2	3	2.3333333333333335	0.5773502691896258	0.24743582965269678	3	2	1
fam19773	2	3	2	2.3333333333333335	0.5773502691896258	0.24743582965269678	3	2	1
fam19774	2	3	2	2.3333333333333335	0.5773502691896258	0.24743582965269678	3	2	1
fam19775	2	3	2	2.3333333333333335	0.5773502691896258	0.24743582965269678	3	2	1
fam19776	2	2	3	2.3333333333333335	0.5773502691896258	0.24743582965269678	3	2	1
fam19777	2	3	2	2.3333333333333335	0.5773502691896258	0.24743582965269678	3	2	1
fam19778	2	2	3	2.3333333333333335	0.5773502691896258	0.24743582965269678	3	2	1
fam19779	2	3	2	2.3333333333333335	0.5773502691896258	0.24743582965269678	3	2	1
fam19780	2	3	2	2.3333333333333335	0.5773502691896258	0.24743582965269678	3	2	1
fam19781	2	3	2	2.3333333333333335	0.5773502691896258	0.24743582965269678	3	2	1
fam19782	2	2	3	2.3333333333333335	0.5773502691896258	0.24743582965269678	3	2	1
fam19783	2	2	3	2.3333333333333335	0.5773502691896258	0.24743582965269678	3	2	1
fam19784	2	3	2	2.3333333333333335	0.5773502691896258	0.24743582965269678	3	2	1
fam19785	2	3	2	2.3333333333333335	0.5773502691896258	0.24743582965269678	3	2	1
fam19786	2	3	2	2.3333333333333335	0.5773502691896258	0.24743582965269678	3	2	1
fam19787	2	3	2	2.3333333333333335	0.5773502691896258	0.24743582965269678	3	2	1
fam19788	2	3	2	2.3333333333333335	0.5773502691896258	0.24743582965269678	3	2	1
fam19789	2	2	3	2.3333333333333335	0.5773502691896258	0.24743582965269678	3	2	1
fam19790	2	3	2	2.3333333333333335	0.5773502691896258	0.24743582965269678	3	2	1
fam19791	2	3	2	2.3333333333333335	0.5773502691896258	0.24743582965269678	3	2	1
fam19792	2	3	2	2.3333333333333335	0.5773502691896258	0.24743582965269678	3	2	1
fam19793	2	2	3	2.3333333333333335	0.5773502691896258	0.24743582965269678	3	2	1
fam19794	2	2	3	2.3333333333333335	0.5773502691896258	0.24743582965269678	3	2	1
fam19795	2	2	3	2.3333333333333335	0.5773502691896258	0.24743582965269678	3	2	1
fam19796	2	3	2	2.3333333333333335	0.5773502691896258	0.24743582965269678	3	2	1
fam19797	2	3	2	2.3333333333333335	0.5773502691896258	0.24743582965269678	3	2	1
fam19798	2	3	2	2.3333333333333335	0.5773502691896258	0.24743582965269678	3	2	1
fam19799	2	2	3	2.3333333333333335	0.5773502691896258	0.24743582965269678	3	2	1
fam19800	2	3	2	2.3333333333333335	0.5773502691896258	0.24743582965269678	3	2	1
fam19801	2	2	3	2.3333333333333335	0.5773502691896258	0.24743582965269678	3	2	1
fam19802	2	3	2	2.3333333333333335	0.5773502691896258	0.24743582965269678	3	2	1
fam19803	2	3	2	2.3333333333333335	0.5773502691896258	0.24743582965269678	3	2	1
fam19804	2	3	2	2.3333333333333335	0.5773502691896258	0.24743582965269678	3	2	1
fam19805	2	2	3	2.3333333333333335	0.5773502691896258	0.24743582965269678	3	2	1
fam19806	2	3	2	2.3333333333333335	0.5773502691896258	0.24743582965269678	3	2	1
fam19807	2	2	3	2.3333333333333335	0.5773502691896258	0.24743582965269678	3	2	1
fam19808	2	2	3	2.3333333333333335	0.5773502691896258	0.24743582965269678	3	2	1
fam19809	2	3	2	2.3333333333333335	0.5773502691896258	0.24743582965269678	3	2	1
fam19810	2	3	2	2.3333333333333335	0.5773502691896258	0.24743582965269678	3	2	1
fam19811	2	2	3	2.3333333333333335	0.5773502691896258	0.24743582965269678	3	2	1
fam19812	2	3	2	2.3333333333333335	0.5773502691896258	0.24743582965269678	3	2	1
fam19813	2	3	2	2.3333333333333335	0.5773502691896258	0.24743582965269678	3	2	1
fam19814	2	3	2	2.3333333333333335	0.5773502691896258	0.24743582965269678	3	2	1
fam19815	2	3	2	2.3333333333333335	0.5773502691896258	0.24743582965269678	3	2	1
fam19816	2	3	2	2.3333333333333335	0.5773502691896258	0.24743582965269678	3	2	1
fam19817	2	3	2	2.3333333333333335	0.5773502691896258	0.24743582965269678	3	2	1
fam19818	2	3	2	2.3333333333333335	0.5773502691896258	0.24743582965269678	3	2	1
fam19819	2	3	2	2.3333333333333335	0.5773502691896258	0.24743582965269678	3	2	1
fam19820	2	2	3	2.3333333333333335	0.5773502691896258	0.24743582965269678	3	2	1
fam19821	2	3	2	2.3333333333333335	0.5773502691896258	0.24743582965269678	3	2	1
fam19822	2	3	2	2.3333333333333335	0.5773502691896258	0.24743582965269678	3	2	1
fam19823	2	2	3	2.3333333333333335	0.5773502691896258	0.24743582965269678	3	2	1
fam19824	2	2	3	2.3333333333333335	0.5773502691896258	0.24743582965269678	3	2	1
fam19825	2	2	3	2.3333333333333335	0.5773502691896258	0.24743582965269678	3	2	1
fam19826	2	3	2	2.3333333333333335	0.5773502691896258	0.24743582965269678	3	2	1
fam19827	2	2	3	2.3333333333333335	0.5773502691896258	0.24743582965269678	3	2	1
fam19828	2	3	2	2.3333333333333335	0.5773502691896258	0.24743582965269678	3	2	1
fam19829	2	3	2	2.3333333333333335	0.5773502691896258	0.24743582965269678	3	2	1
fam19830	2	2	3	2.3333333333333335	0.5773502691896258	0.24743582965269678	3	2	1
fam19831	2	2	3	2.3333333333333335	0.5773502691896258	0.24743582965269678	3	2	1
fam19832	2	2	3	2.3333333333333335	0.5773502691896258	0.24743582965269678	3	2	1
fam19833	2	3	2	2.3333333333333335	0.5773502691896258	0.24743582965269678	3	2	1
fam19834	2	2	3	2.3333333333333335	0.5773502691896258	0.24743582965269678	3	2	1
fam19835	2	3	2	2.3333333333333335	0.5773502691896258	0.24743582965269678	3	2	1
fam19836	2	3	2	2.3333333333333335	0.5773502691896258	0.24743582965269678	3	2	1
fam19837	2	3	2	2.3333333333333335	0.5773502691896258	0.24743582965269678	3	2	1
fam19838	3	2	2	2.3333333333333335	0.5773502691896258	0.24743582965269678	3	2	1
fam19839	2	3	2	2.3333333333333335	0.5773502691896258	0.24743582965269678	3	2	1
fam19840	2	3	2	2.3333333333333335	0.5773502691896258	0.24743582965269678	3	2	1
fam19841	2	3	2	2.3333333333333335	0.5773502691896258	0.24743582965269678	3	2	1
fam19842	2	2	3	2.3333333333333335	0.5773502691896258	0.24743582965269678	3	2	1
fam19843	2	3	2	2.3333333333333335	0.5773502691896258	0.24743582965269678	3	2	1
fam19844	2	3	2	2.3333333333333335	0.5773502691896258	0.24743582965269678	3	2	1
fam19845	2	2	3	2.3333333333333335	0.5773502691896258	0.24743582965269678	3	2	1
fam19846	2	3	2	2.3333333333333335	0.5773502691896258	0.24743582965269678	3	2	1
fam19847	2	2	3	2.3333333333333335	0.5773502691896258	0.24743582965269678	3	2	1
fam19848	2	3	2	2.3333333333333335	0.5773502691896258	0.24743582965269678	3	2	1
fam19849	2	3	2	2.3333333333333335	0.5773502691896258	0.24743582965269678	3	2	1
fam19850	2	2	3	2.3333333333333335	0.5773502691896258	0.24743582965269678	3	2	1
fam19851	2	3	2	2.3333333333333335	0.5773502691896258	0.24743582965269678	3	2	1
fam19852	2	3	2	2.3333333333333335	0.5773502691896258	0.24743582965269678	3	2	1
fam19853	2	3	2	2.3333333333333335	0.5773502691896258	0.24743582965269678	3	2	1
fam19854	3	2	2	2.3333333333333335	0.5773502691896258	0.24743582965269678	3	2	1
fam19855	2	3	2	2.3333333333333335	0.5773502691896258	0.24743582965269678	3	2	1
fam19856	2	2	3	2.3333333333333335	0.5773502691896258	0.24743582965269678	3	2	1
fam19857	2	2	3	2.3333333333333335	0.5773502691896258	0.24743582965269678	3	2	1
fam19858	2	3	2	2.3333333333333335	0.5773502691896258	0.24743582965269678	3	2	1
fam19859	2	2	3	2.3333333333333335	0.5773502691896258	0.24743582965269678	3	2	1
fam19860	2	3	2	2.3333333333333335	0.5773502691896258	0.24743582965269678	3	2	1
fam19861	2	2	3	2.3333333333333335	0.5773502691896258	0.24743582965269678	3	2	1
fam19862	2	3	2	2.3333333333333335	0.5773502691896258	0.24743582965269678	3	2	1
fam19863	2	3	2	2.3333333333333335	0.5773502691896258	0.24743582965269678	3	2	1
fam19864	2	3	2	2.3333333333333335	0.5773502691896258	0.24743582965269678	3	2	1
fam19865	2	2	3	2.3333333333333335	0.5773502691896258	0.24743582965269678	3	2	1
fam19866	2	3	2	2.3333333333333335	0.5773502691896258	0.24743582965269678	3	2	1
fam19867	2	2	3	2.3333333333333335	0.5773502691896258	0.24743582965269678	3	2	1
fam19868	2	3	2	2.3333333333333335	0.5773502691896258	0.24743582965269678	3	2	1
fam19869	2	3	2	2.3333333333333335	0.5773502691896258	0.24743582965269678	3	2	1
fam19870	2	3	2	2.3333333333333335	0.5773502691896258	0.24743582965269678	3	2	1
fam19871	2	3	2	2.3333333333333335	0.5773502691896258	0.24743582965269678	3	2	1
fam19872	2	3	2	2.3333333333333335	0.5773502691896258	0.24743582965269678	3	2	1
fam19873	2	3	2	2.3333333333333335	0.5773502691896258	0.24743582965269678	3	2	1
fam19874	2	3	2	2.3333333333333335	0.5773502691896258	0.24743582965269678	3	2	1
fam19875	2	2	3	2.3333333333333335	0.5773502691896258	0.24743582965269678	3	2	1
fam19876	2	3	2	2.3333333333333335	0.5773502691896258	0.24743582965269678	3	2	1
fam19877	2	3	2	2.3333333333333335	0.5773502691896258	0.24743582965269678	3	2	1
fam19878	2	2	3	2.3333333333333335	0.5773502691896258	0.24743582965269678	3	2	1
fam19879	2	3	2	2.3333333333333335	0.5773502691896258	0.24743582965269678	3	2	1
fam19880	2	3	2	2.3333333333333335	0.5773502691896258	0.24743582965269678	3	2	1
fam19881	2	3	2	2.3333333333333335	0.5773502691896258	0.24743582965269678	3	2	1
fam19882	2	3	2	2.3333333333333335	0.5773502691896258	0.24743582965269678	3	2	1
fam19883	2	2	3	2.3333333333333335	0.5773502691896258	0.24743582965269678	3	2	1
fam19884	3	2	2	2.3333333333333335	0.5773502691896258	0.24743582965269678	3	2	1
fam19885	2	2	3	2.3333333333333335	0.5773502691896258	0.24743582965269678	3	2	1
fam19886	2	3	2	2.3333333333333335	0.5773502691896258	0.24743582965269678	3	2	1
fam19887	2	3	2	2.3333333333333335	0.5773502691896258	0.24743582965269678	3	2	1
fam19888	2	2	3	2.3333333333333335	0.5773502691896258	0.24743582965269678	3	2	1
fam19889	2	2	2	2.0	0.0	0.0	2	2	0
fam19890	2	2	2	2.0	0.0	0.0	2	2	0
fam19891	2	2	2	2.0	0.0	0.0	2	2	0
fam19892	2	2	2	2.0	0.0	0.0	2	2	0
fam19893	2	2	2	2.0	0.0	0.0	2	2	0
fam19894	2	2	2	2.0	0.0	0.0	2	2	0
fam19895	2	2	2	2.0	0.0	0.0	2	2	0
fam19896	2	2	2	2.0	0.0	0.0	2	2	0
fam19897	2	2	2	2.0	0.0	0.0	2	2	0
fam19898	2	2	2	2.0	0.0	0.0	2	2	0
fam19899	2	2	2	2.0	0.0	0.0	2	2	0
fam19900	2	2	2	2.0	0.0	0.0	2	2	0
fam19901	2	2	2	2.0	0.0	0.0	2	2	0
fam19902	2	2	2	2.0	0.0	0.0	2	2	0
fam19903	2	2	2	2.0	0.0	0.0	2	2	0
fam19904	2	2	2	2.0	0.0	0.0	2	2	0
fam19905	2	2	2	2.0	0.0	0.0	2	2	0
fam19906	2	2	2	2.0	0.0	0.0	2	2	0
fam19907	2	2	2	2.0	0.0	0.0	2	2	0
fam19908	2	2	2	2.0	0.0	0.0	2	2	0
fam19909	2	2	2	2.0	0.0	0.0	2	2	0
fam19910	2	2	2	2.0	0.0	0.0	2	2	0
fam19911	2	2	2	2.0	0.0	0.0	2	2	0
fam19912	2	2	2	2.0	0.0	0.0	2	2	0
fam19913	2	2	2	2.0	0.0	0.0	2	2	0
fam19914	2	2	2	2.0	0.0	0.0	2	2	0
fam19915	2	2	2	2.0	0.0	0.0	2	2	0
fam19916	2	2	2	2.0	0.0	0.0	2	2	0
fam19917	2	2	2	2.0	0.0	0.0	2	2	0
fam19918	2	2	2	2.0	0.0	0.0	2	2	0
fam19919	2	2	2	2.0	0.0	0.0	2	2	0
fam19920	2	2	2	2.0	0.0	0.0	2	2	0
fam19921	2	2	2	2.0	0.0	0.0	2	2	0
fam19922	2	2	2	2.0	0.0	0.0	2	2	0
fam19923	2	2	2	2.0	0.0	0.0	2	2	0
fam19924	2	2	2	2.0	0.0	0.0	2	2	0
fam19925	2	2	2	2.0	0.0	0.0	2	2	0
fam19926	2	2	2	2.0	0.0	0.0	2	2	0
fam19927	2	2	2	2.0	0.0	0.0	2	2	0
fam19928	2	2	2	2.0	0.0	0.0	2	2	0
fam19929	2	2	2	2.0	0.0	0.0	2	2	0
fam19930	2	2	2	2.0	0.0	0.0	2	2	0
fam19931	2	2	2	2.0	0.0	0.0	2	2	0
fam19932	2	2	2	2.0	0.0	0.0	2	2	0
fam19933	2	2	2	2.0	0.0	0.0	2	2	0
fam19934	2	2	2	2.0	0.0	0.0	2	2	0
fam19935	2	2	2	2.0	0.0	0.0	2	2	0
fam19936	2	2	2	2.0	0.0	0.0	2	2	0
fam19937	2	2	2	2.0	0.0	0.0	2	2	0
fam19938	2	2	2	2.0	0.0	0.0	2	2	0
fam19939	2	2	2	2.0	0.0	0.0	2	2	0
fam19940	2	2	2	2.0	0.0	0.0	2	2	0
fam19941	2	2	2	2.0	0.0	0.0	2	2	0
fam19942	2	2	2	2.0	0.0	0.0	2	2	0
fam19943	2	2	2	2.0	0.0	0.0	2	2	0
fam19944	2	2	2	2.0	0.0	0.0	2	2	0
fam19945	2	2	2	2.0	0.0	0.0	2	2	0
fam19946	2	2	2	2.0	0.0	0.0	2	2	0
fam19947	2	2	2	2.0	0.0	0.0	2	2	0
fam19948	2	2	2	2.0	0.0	0.0	2	2	0
fam19949	2	2	2	2.0	0.0	0.0	2	2	0
fam19950	2	2	2	2.0	0.0	0.0	2	2	0
fam19951	2	2	2	2.0	0.0	0.0	2	2	0
fam19952	2	2	2	2.0	0.0	0.0	2	2	0
fam19953	2	2	2	2.0	0.0	0.0	2	2	0
fam19954	2	2	2	2.0	0.0	0.0	2	2	0
fam19955	2	2	2	2.0	0.0	0.0	2	2	0
fam19956	2	2	2	2.0	0.0	0.0	2	2	0
fam19957	2	2	2	2.0	0.0	0.0	2	2	0
fam19958	2	2	2	2.0	0.0	0.0	2	2	0
fam19959	2	2	2	2.0	0.0	0.0	2	2	0
fam19960	2	2	2	2.0	0.0	0.0	2	2	0
fam19961	2	2	2	2.0	0.0	0.0	2	2	0
fam19962	2	2	2	2.0	0.0	0.0	2	2	0
fam19963	2	2	2	2.0	0.0	0.0	2	2	0
fam19964	2	2	2	2.0	0.0	0.0	2	2	0
fam19965	2	2	2	2.0	0.0	0.0	2	2	0
fam19966	2	2	2	2.0	0.0	0.0	2	2	0
fam19967	2	2	2	2.0	0.0	0.0	2	2	0
fam19968	2	2	2	2.0	0.0	0.0	2	2	0
fam19969	2	2	2	2.0	0.0	0.0	2	2	0
fam19970	2	2	2	2.0	0.0	0.0	2	2	0
fam19971	2	2	2	2.0	0.0	0.0	2	2	0
fam19972	2	2	2	2.0	0.0	0.0	2	2	0
fam19973	2	2	2	2.0	0.0	0.0	2	2	0
fam19974	2	2	2	2.0	0.0	0.0	2	2	0
fam19975	2	2	2	2.0	0.0	0.0	2	2	0
fam19976	2	2	2	2.0	0.0	0.0	2	2	0
fam19977	2	2	2	2.0	0.0	0.0	2	2	0
fam19978	2	2	2	2.0	0.0	0.0	2	2	0
fam19979	2	2	2	2.0	0.0	0.0	2	2	0
fam19980	2	2	2	2.0	0.0	0.0	2	2	0
fam19981	2	2	2	2.0	0.0	0.0	2	2	0
fam19982	2	2	2	2.0	0.0	0.0	2	2	0
fam19983	2	2	2	2.0	0.0	0.0	2	2	0
fam19984	2	2	2	2.0	0.0	0.0	2	2	0
fam19985	2	2	2	2.0	0.0	0.0	2	2	0
fam19986	2	2	2	2.0	0.0	0.0	2	2	0
fam19987	2	2	2	2.0	0.0	0.0	2	2	0
fam19988	2	2	2	2.0	0.0	0.0	2	2	0
fam19989	2	2	2	2.0	0.0	0.0	2	2	0
fam19990	2	2	2	2.0	0.0	0.0	2	2	0
fam19991	2	2	2	2.0	0.0	0.0	2	2	0
fam19992	2	2	2	2.0	0.0	0.0	2	2	0
fam19993	2	2	2	2.0	0.0	0.0	2	2	0
fam19994	2	2	2	2.0	0.0	0.0	2	2	0
fam19995	2	2	2	2.0	0.0	0.0	2	2	0
fam19996	2	2	2	2.0	0.0	0.0	2	2	0
fam19997	2	2	2	2.0	0.0	0.0	2	2	0
fam19998	2	2	2	2.0	0.0	0.0	2	2	0
fam19999	2	2	2	2.0	0.0	0.0	2	2	0
fam20000	2	2	2	2.0	0.0	0.0	2	2	0
fam20001	2	2	2	2.0	0.0	0.0	2	2	0
fam20002	2	2	2	2.0	0.0	0.0	2	2	0
fam20003	2	2	2	2.0	0.0	0.0	2	2	0
fam20004	2	2	2	2.0	0.0	0.0	2	2	0
fam20005	2	2	2	2.0	0.0	0.0	2	2	0
fam20006	2	2	2	2.0	0.0	0.0	2	2	0
fam20007	2	2	2	2.0	0.0	0.0	2	2	0
fam20008	2	2	2	2.0	0.0	0.0	2	2	0
fam20009	2	2	2	2.0	0.0	0.0	2	2	0
fam20010	2	2	2	2.0	0.0	0.0	2	2	0
fam20011	2	2	2	2.0	0.0	0.0	2	2	0
fam20012	2	2	2	2.0	0.0	0.0	2	2	0
fam20013	2	2	2	2.0	0.0	0.0	2	2	0
fam20014	2	2	2	2.0	0.0	0.0	2	2	0
fam20015	2	2	2	2.0	0.0	0.0	2	2	0
fam20016	2	2	2	2.0	0.0	0.0	2	2	0
fam20017	2	2	2	2.0	0.0	0.0	2	2	0
fam20018	2	2	2	2.0	0.0	0.0	2	2	0
fam20019	2	2	2	2.0	0.0	0.0	2	2	0
fam20020	2	2	2	2.0	0.0	0.0	2	2	0
fam20021	2	2	2	2.0	0.0	0.0	2	2	0
fam20022	2	2	2	2.0	0.0	0.0	2	2	0
fam20023	2	2	2	2.0	0.0	0.0	2	2	0
fam20024	2	2	2	2.0	0.0	0.0	2	2	0
fam20025	2	2	2	2.0	0.0	0.0	2	2	0
fam20026	2	2	2	2.0	0.0	0.0	2	2	0
fam20027	2	2	2	2.0	0.0	0.0	2	2	0
fam20028	2	2	2	2.0	0.0	0.0	2	2	0
fam20029	2	2	2	2.0	0.0	0.0	2	2	0
fam20030	2	2	2	2.0	0.0	0.0	2	2	0
fam20031	2	2	2	2.0	0.0	0.0	2	2	0
fam20032	2	2	2	2.0	0.0	0.0	2	2	0
fam20033	2	2	2	2.0	0.0	0.0	2	2	0
fam20034	2	2	2	2.0	0.0	0.0	2	2	0
fam20035	2	2	2	2.0	0.0	0.0	2	2	0
fam20036	2	2	2	2.0	0.0	0.0	2	2	0
fam20037	2	2	2	2.0	0.0	0.0	2	2	0
fam20038	2	2	2	2.0	0.0	0.0	2	2	0
fam20039	2	2	2	2.0	0.0	0.0	2	2	0
fam20040	2	2	2	2.0	0.0	0.0	2	2	0
fam20041	2	2	2	2.0	0.0	0.0	2	2	0
fam20042	2	2	2	2.0	0.0	0.0	2	2	0
fam20043	2	2	2	2.0	0.0	0.0	2	2	0
fam20044	2	2	2	2.0	0.0	0.0	2	2	0
fam20045	2	2	2	2.0	0.0	0.0	2	2	0
fam20046	2	2	2	2.0	0.0	0.0	2	2	0
fam20047	2	2	2	2.0	0.0	0.0	2	2	0
fam20048	2	2	2	2.0	0.0	0.0	2	2	0
fam20049	2	2	2	2.0	0.0	0.0	2	2	0
fam20050	2	2	2	2.0	0.0	0.0	2	2	0
fam20051	2	2	2	2.0	0.0	0.0	2	2	0
fam20052	2	2	2	2.0	0.0	0.0	2	2	0
fam20053	2	2	2	2.0	0.0	0.0	2	2	0
fam20054	2	2	2	2.0	0.0	0.0	2	2	0
fam20055	2	2	2	2.0	0.0	0.0	2	2	0
fam20056	2	2	2	2.0	0.0	0.0	2	2	0
fam20057	2	2	2	2.0	0.0	0.0	2	2	0
fam20058	2	2	2	2.0	0.0	0.0	2	2	0
fam20059	2	2	2	2.0	0.0	0.0	2	2	0
fam20060	2	2	2	2.0	0.0	0.0	2	2	0
fam20061	2	2	2	2.0	0.0	0.0	2	2	0
fam20062	2	2	2	2.0	0.0	0.0	2	2	0
fam20063	2	2	2	2.0	0.0	0.0	2	2	0
fam20064	2	2	2	2.0	0.0	0.0	2	2	0
fam20065	2	2	2	2.0	0.0	0.0	2	2	0
fam20066	2	2	2	2.0	0.0	0.0	2	2	0
fam20067	2	2	2	2.0	0.0	0.0	2	2	0
fam20068	2	2	2	2.0	0.0	0.0	2	2	0
fam20069	2	2	2	2.0	0.0	0.0	2	2	0
fam20070	2	2	2	2.0	0.0	0.0	2	2	0
fam20071	2	2	2	2.0	0.0	0.0	2	2	0
fam20072	2	2	2	2.0	0.0	0.0	2	2	0
fam20073	2	2	2	2.0	0.0	0.0	2	2	0
fam20074	2	2	2	2.0	0.0	0.0	2	2	0
fam20075	2	2	2	2.0	0.0	0.0	2	2	0
fam20076	2	2	2	2.0	0.0	0.0	2	2	0
fam20077	2	2	2	2.0	0.0	0.0	2	2	0
fam20078	2	2	2	2.0	0.0	0.0	2	2	0
fam20079	2	2	2	2.0	0.0	0.0	2	2	0
fam20080	2	2	2	2.0	0.0	0.0	2	2	0
fam20081	2	2	2	2.0	0.0	0.0	2	2	0
fam20082	2	2	2	2.0	0.0	0.0	2	2	0
fam20083	2	2	2	2.0	0.0	0.0	2	2	0
fam20084	2	2	2	2.0	0.0	0.0	2	2	0
fam20085	2	2	2	2.0	0.0	0.0	2	2	0
fam20086	2	2	2	2.0	0.0	0.0	2	2	0
fam20087	2	2	2	2.0	0.0	0.0	2	2	0
fam20088	2	2	2	2.0	0.0	0.0	2	2	0
fam20089	2	2	2	2.0	0.0	0.0	2	2	0
fam20090	2	2	2	2.0	0.0	0.0	2	2	0
fam20091	2	2	2	2.0	0.0	0.0	2	2	0
fam20092	2	2	2	2.0	0.0	0.0	2	2	0
fam20093	2	2	2	2.0	0.0	0.0	2	2	0
fam20094	2	2	2	2.0	0.0	0.0	2	2	0
fam20095	2	2	2	2.0	0.0	0.0	2	2	0
fam20096	2	2	2	2.0	0.0	0.0	2	2	0
fam20097	2	2	2	2.0	0.0	0.0	2	2	0
fam20098	2	2	2	2.0	0.0	0.0	2	2	0
fam20099	2	2	2	2.0	0.0	0.0	2	2	0
fam20100	2	2	2	2.0	0.0	0.0	2	2	0
fam20101	2	2	2	2.0	0.0	0.0	2	2	0
fam20102	2	2	2	2.0	0.0	0.0	2	2	0
fam20103	2	2	2	2.0	0.0	0.0	2	2	0
fam20104	2	2	2	2.0	0.0	0.0	2	2	0
fam20105	2	2	2	2.0	0.0	0.0	2	2	0
fam20106	2	2	2	2.0	0.0	0.0	2	2	0
fam20107	2	2	2	2.0	0.0	0.0	2	2	0
fam20108	2	2	2	2.0	0.0	0.0	2	2	0
fam20109	2	2	2	2.0	0.0	0.0	2	2	0
fam20110	2	2	2	2.0	0.0	0.0	2	2	0
fam20111	2	2	2	2.0	0.0	0.0	2	2	0
fam20112	2	2	2	2.0	0.0	0.0	2	2	0
fam20113	2	2	2	2.0	0.0	0.0	2	2	0
fam20114	2	2	2	2.0	0.0	0.0	2	2	0
fam20115	2	2	2	2.0	0.0	0.0	2	2	0
fam20116	2	2	2	2.0	0.0	0.0	2	2	0
fam20117	2	2	2	2.0	0.0	0.0	2	2	0
fam20118	2	2	2	2.0	0.0	0.0	2	2	0
fam20119	2	2	2	2.0	0.0	0.0	2	2	0
fam20120	2	2	2	2.0	0.0	0.0	2	2	0
fam20121	2	2	2	2.0	0.0	0.0	2	2	0
fam20122	2	2	2	2.0	0.0	0.0	2	2	0
fam20123	2	2	2	2.0	0.0	0.0	2	2	0
fam20124	2	2	2	2.0	0.0	0.0	2	2	0
fam20125	2	2	2	2.0	0.0	0.0	2	2	0
fam20126	2	2	2	2.0	0.0	0.0	2	2	0
fam20127	2	2	2	2.0	0.0	0.0	2	2	0
fam20128	2	2	2	2.0	0.0	0.0	2	2	0
fam20129	2	2	2	2.0	0.0	0.0	2	2	0
fam20130	2	2	2	2.0	0.0	0.0	2	2	0
fam20131	2	2	2	2.0	0.0	0.0	2	2	0
fam20132	2	2	2	2.0	0.0	0.0	2	2	0
fam20133	2	2	2	2.0	0.0	0.0	2	2	0
fam20134	2	2	2	2.0	0.0	0.0	2	2	0
fam20135	2	2	2	2.0	0.0	0.0	2	2	0
fam20136	2	2	2	2.0	0.0	0.0	2	2	0
fam20137	2	2	2	2.0	0.0	0.0	2	2	0
fam20138	2	2	2	2.0	0.0	0.0	2	2	0
fam20139	2	2	2	2.0	0.0	0.0	2	2	0
fam20140	2	2	2	2.0	0.0	0.0	2	2	0
fam20141	2	2	2	2.0	0.0	0.0	2	2	0
fam20142	2	2	2	2.0	0.0	0.0	2	2	0
fam20143	2	2	2	2.0	0.0	0.0	2	2	0
fam20144	2	2	2	2.0	0.0	0.0	2	2	0
fam20145	2	2	2	2.0	0.0	0.0	2	2	0
fam20146	2	2	2	2.0	0.0	0.0	2	2	0
fam20147	2	2	2	2.0	0.0	0.0	2	2	0
fam20148	2	2	2	2.0	0.0	0.0	2	2	0
fam20149	2	2	2	2.0	0.0	0.0	2	2	0
fam20150	2	2	2	2.0	0.0	0.0	2	2	0
fam20151	2	2	2	2.0	0.0	0.0	2	2	0
fam20152	2	2	2	2.0	0.0	0.0	2	2	0
fam20153	2	2	2	2.0	0.0	0.0	2	2	0
fam20154	2	2	2	2.0	0.0	0.0	2	2	0
fam20155	2	2	2	2.0	0.0	0.0	2	2	0
fam20156	2	2	2	2.0	0.0	0.0	2	2	0
fam20157	2	2	2	2.0	0.0	0.0	2	2	0
fam20158	2	2	2	2.0	0.0	0.0	2	2	0
fam20159	2	2	2	2.0	0.0	0.0	2	2	0
fam20160	2	2	2	2.0	0.0	0.0	2	2	0
fam20161	2	2	2	2.0	0.0	0.0	2	2	0
fam20162	2	2	2	2.0	0.0	0.0	2	2	0
fam20163	2	2	2	2.0	0.0	0.0	2	2	0
fam20164	2	2	2	2.0	0.0	0.0	2	2	0
fam20165	2	2	2	2.0	0.0	0.0	2	2	0
fam20166	2	2	2	2.0	0.0	0.0	2	2	0
fam20167	2	2	2	2.0	0.0	0.0	2	2	0
fam20168	2	2	2	2.0	0.0	0.0	2	2	0
fam20169	2	2	2	2.0	0.0	0.0	2	2	0
fam20170	2	2	2	2.0	0.0	0.0	2	2	0
fam20171	2	2	2	2.0	0.0	0.0	2	2	0
fam20172	2	2	2	2.0	0.0	0.0	2	2	0
fam20173	2	2	2	2.0	0.0	0.0	2	2	0
fam20174	2	2	2	2.0	0.0	0.0	2	2	0
fam20175	2	2	2	2.0	0.0	0.0	2	2	0
fam20176	2	2	2	2.0	0.0	0.0	2	2	0
fam20177	2	2	2	2.0	0.0	0.0	2	2	0
fam20178	2	2	2	2.0	0.0	0.0	2	2	0
fam20179	2	2	2	2.0	0.0	0.0	2	2	0
fam20180	2	2	2	2.0	0.0	0.0	2	2	0
fam20181	2	2	2	2.0	0.0	0.0	2	2	0
fam20182	2	2	2	2.0	0.0	0.0	2	2	0
fam20183	2	2	2	2.0	0.0	0.0	2	2	0
fam20184	2	2	2	2.0	0.0	0.0	2	2	0
fam20185	2	2	2	2.0	0.0	0.0	2	2	0
fam20186	2	2	2	2.0	0.0	0.0	2	2	0
fam20187	2	2	2	2.0	0.0	0.0	2	2	0
fam20188	2	2	2	2.0	0.0	0.0	2	2	0
fam20189	2	2	2	2.0	0.0	0.0	2	2	0
fam20190	2	2	2	2.0	0.0	0.0	2	2	0
fam20191	2	2	2	2.0	0.0	0.0	2	2	0
fam20192	2	2	2	2.0	0.0	0.0	2	2	0
fam20193	2	2	2	2.0	0.0	0.0	2	2	0
fam20194	2	2	2	2.0	0.0	0.0	2	2	0
fam20195	2	2	2	2.0	0.0	0.0	2	2	0
fam20196	2	2	2	2.0	0.0	0.0	2	2	0
fam20197	2	2	2	2.0	0.0	0.0	2	2	0
fam20198	2	2	2	2.0	0.0	0.0	2	2	0
fam20199	2	2	2	2.0	0.0	0.0	2	2	0
fam20200	2	2	2	2.0	0.0	0.0	2	2	0
fam20201	2	2	2	2.0	0.0	0.0	2	2	0
fam20202	2	2	2	2.0	0.0	0.0	2	2	0
fam20203	2	2	2	2.0	0.0	0.0	2	2	0
fam20204	2	2	2	2.0	0.0	0.0	2	2	0
fam20205	2	2	2	2.0	0.0	0.0	2	2	0
fam20206	2	2	2	2.0	0.0	0.0	2	2	0
fam20207	2	2	2	2.0	0.0	0.0	2	2	0
fam20208	2	2	2	2.0	0.0	0.0	2	2	0
fam20209	2	2	2	2.0	0.0	0.0	2	2	0
fam20210	2	2	2	2.0	0.0	0.0	2	2	0
fam20211	2	2	2	2.0	0.0	0.0	2	2	0
fam20212	2	2	2	2.0	0.0	0.0	2	2	0
fam20213	2	2	2	2.0	0.0	0.0	2	2	0
fam20214	2	2	2	2.0	0.0	0.0	2	2	0
fam20215	2	2	2	2.0	0.0	0.0	2	2	0
fam20216	2	2	2	2.0	0.0	0.0	2	2	0
fam20217	2	2	2	2.0	0.0	0.0	2	2	0
fam20218	2	2	2	2.0	0.0	0.0	2	2	0
fam20219	2	2	2	2.0	0.0	0.0	2	2	0
fam20220	2	2	2	2.0	0.0	0.0	2	2	0
fam20221	2	2	2	2.0	0.0	0.0	2	2	0
fam20222	2	2	2	2.0	0.0	0.0	2	2	0
fam20223	2	2	2	2.0	0.0	0.0	2	2	0
fam20224	2	2	2	2.0	0.0	0.0	2	2	0
fam20225	2	2	2	2.0	0.0	0.0	2	2	0
fam20226	2	2	2	2.0	0.0	0.0	2	2	0
fam20227	2	2	2	2.0	0.0	0.0	2	2	0
fam20228	2	2	2	2.0	0.0	0.0	2	2	0
fam20229	2	2	2	2.0	0.0	0.0	2	2	0
fam20230	2	2	2	2.0	0.0	0.0	2	2	0
fam20231	2	2	2	2.0	0.0	0.0	2	2	0
fam20232	2	2	2	2.0	0.0	0.0	2	2	0
fam20233	2	2	2	2.0	0.0	0.0	2	2	0
fam20234	2	2	2	2.0	0.0	0.0	2	2	0
fam20235	2	2	2	2.0	0.0	0.0	2	2	0
fam20236	2	2	2	2.0	0.0	0.0	2	2	0
fam20237	2	2	2	2.0	0.0	0.0	2	2	0
fam20238	2	2	2	2.0	0.0	0.0	2	2	0
fam20239	2	2	2	2.0	0.0	0.0	2	2	0
fam20240	2	2	2	2.0	0.0	0.0	2	2	0
fam20241	2	2	2	2.0	0.0	0.0	2	2	0
fam20242	2	2	2	2.0	0.0	0.0	2	2	0
fam20243	2	2	2	2.0	0.0	0.0	2	2	0
fam20244	2	2	2	2.0	0.0	0.0	2	2	0
fam20245	2	2	2	2.0	0.0	0.0	2	2	0
fam20246	2	2	2	2.0	0.0	0.0	2	2	0
fam20247	2	2	2	2.0	0.0	0.0	2	2	0
fam20248	2	2	2	2.0	0.0	0.0	2	2	0
fam20249	2	2	2	2.0	0.0	0.0	2	2	0
fam20250	2	2	2	2.0	0.0	0.0	2	2	0
fam20251	2	2	2	2.0	0.0	0.0	2	2	0
fam20252	2	2	2	2.0	0.0	0.0	2	2	0
fam20253	2	2	2	2.0	0.0	0.0	2	2	0
fam20254	2	2	2	2.0	0.0	0.0	2	2	0
fam20255	2	2	2	2.0	0.0	0.0	2	2	0
fam20256	2	2	2	2.0	0.0	0.0	2	2	0
fam20257	2	2	2	2.0	0.0	0.0	2	2	0
fam20258	2	2	2	2.0	0.0	0.0	2	2	0
fam20259	2	2	2	2.0	0.0	0.0	2	2	0
fam20260	2	2	2	2.0	0.0	0.0	2	2	0
fam20261	2	2	2	2.0	0.0	0.0	2	2	0
fam20262	2	2	2	2.0	0.0	0.0	2	2	0
fam20263	2	2	2	2.0	0.0	0.0	2	2	0
fam20264	2	2	2	2.0	0.0	0.0	2	2	0
fam20265	2	2	2	2.0	0.0	0.0	2	2	0
fam20266	2	2	2	2.0	0.0	0.0	2	2	0
fam20267	2	2	2	2.0	0.0	0.0	2	2	0
fam20268	2	2	2	2.0	0.0	0.0	2	2	0
fam20269	2	2	2	2.0	0.0	0.0	2	2	0
fam20270	2	2	2	2.0	0.0	0.0	2	2	0
fam20271	2	2	2	2.0	0.0	0.0	2	2	0
fam20272	2	2	2	2.0	0.0	0.0	2	2	0
fam20273	2	2	2	2.0	0.0	0.0	2	2	0
fam20274	2	2	2	2.0	0.0	0.0	2	2	0
fam20275	2	2	2	2.0	0.0	0.0	2	2	0
fam20276	2	2	2	2.0	0.0	0.0	2	2	0
fam20277	2	2	2	2.0	0.0	0.0	2	2	0
fam20278	2	2	2	2.0	0.0	0.0	2	2	0
fam20279	2	2	2	2.0	0.0	0.0	2	2	0
fam20280	2	2	2	2.0	0.0	0.0	2	2	0
fam20281	2	2	2	2.0	0.0	0.0	2	2	0
fam20282	2	2	2	2.0	0.0	0.0	2	2	0
fam20283	2	2	2	2.0	0.0	0.0	2	2	0
fam20284	2	2	2	2.0	0.0	0.0	2	2	0
fam20285	2	2	2	2.0	0.0	0.0	2	2	0
fam20286	2	2	2	2.0	0.0	0.0	2	2	0
fam20287	2	2	2	2.0	0.0	0.0	2	2	0
fam20288	2	2	2	2.0	0.0	0.0	2	2	0
fam20289	2	2	2	2.0	0.0	0.0	2	2	0
fam20290	2	2	2	2.0	0.0	0.0	2	2	0
fam20291	2	2	2	2.0	0.0	0.0	2	2	0
fam20292	2	2	2	2.0	0.0	0.0	2	2	0
fam20293	2	2	2	2.0	0.0	0.0	2	2	0
fam20294	2	2	2	2.0	0.0	0.0	2	2	0
fam20295	2	2	2	2.0	0.0	0.0	2	2	0
fam20296	2	2	2	2.0	0.0	0.0	2	2	0
fam20297	2	2	2	2.0	0.0	0.0	2	2	0
fam20298	2	2	2	2.0	0.0	0.0	2	2	0
fam20299	2	2	2	2.0	0.0	0.0	2	2	0
fam20300	2	2	2	2.0	0.0	0.0	2	2	0
fam20301	2	2	2	2.0	0.0	0.0	2	2	0
fam20302	2	2	2	2.0	0.0	0.0	2	2	0
fam20303	2	2	2	2.0	0.0	0.0	2	2	0
fam20304	2	2	2	2.0	0.0	0.0	2	2	0
fam20305	2	2	2	2.0	0.0	0.0	2	2	0
fam20306	2	2	2	2.0	0.0	0.0	2	2	0
fam20307	2	2	2	2.0	0.0	0.0	2	2	0
fam20308	2	2	2	2.0	0.0	0.0	2	2	0
fam20309	2	2	2	2.0	0.0	0.0	2	2	0
fam20310	2	2	2	2.0	0.0	0.0	2	2	0
fam20311	2	2	2	2.0	0.0	0.0	2	2	0
fam20312	2	2	2	2.0	0.0	0.0	2	2	0
fam20313	2	2	2	2.0	0.0	0.0	2	2	0
fam20314	2	2	2	2.0	0.0	0.0	2	2	0
fam20315	2	2	2	2.0	0.0	0.0	2	2	0
fam20316	2	2	2	2.0	0.0	0.0	2	2	0
fam20317	2	2	2	2.0	0.0	0.0	2	2	0
fam20318	2	2	2	2.0	0.0	0.0	2	2	0
fam20319	2	2	2	2.0	0.0	0.0	2	2	0
fam20320	2	2	2	2.0	0.0	0.0	2	2	0
fam20321	2	2	2	2.0	0.0	0.0	2	2	0
fam20322	2	2	2	2.0	0.0	0.0	2	2	0
fam20323	2	2	2	2.0	0.0	0.0	2	2	0
fam20324	2	2	2	2.0	0.0	0.0	2	2	0
fam20325	2	2	2	2.0	0.0	0.0	2	2	0
fam20326	2	2	2	2.0	0.0	0.0	2	2	0
fam20327	2	2	2	2.0	0.0	0.0	2	2	0
fam20328	2	2	2	2.0	0.0	0.0	2	2	0
fam20329	2	2	2	2.0	0.0	0.0	2	2	0
fam20330	2	2	2	2.0	0.0	0.0	2	2	0
fam20331	2	2	2	2.0	0.0	0.0	2	2	0
fam20332	2	2	2	2.0	0.0	0.0	2	2	0
fam20333	2	2	2	2.0	0.0	0.0	2	2	0
fam20334	2	2	2	2.0	0.0	0.0	2	2	0
fam20335	2	2	2	2.0	0.0	0.0	2	2	0
fam20336	2	2	2	2.0	0.0	0.0	2	2	0
fam20337	2	2	2	2.0	0.0	0.0	2	2	0
fam20338	2	2	2	2.0	0.0	0.0	2	2	0
fam20339	2	2	2	2.0	0.0	0.0	2	2	0
fam20340	2	2	2	2.0	0.0	0.0	2	2	0
fam20341	2	2	2	2.0	0.0	0.0	2	2	0
fam20342	2	2	2	2.0	0.0	0.0	2	2	0
fam20343	2	2	2	2.0	0.0	0.0	2	2	0
fam20344	2	2	2	2.0	0.0	0.0	2	2	0
fam20345	2	2	2	2.0	0.0	0.0	2	2	0
fam20346	2	2	2	2.0	0.0	0.0	2	2	0
fam20347	2	2	2	2.0	0.0	0.0	2	2	0
fam20348	2	2	2	2.0	0.0	0.0	2	2	0
fam20349	2	2	2	2.0	0.0	0.0	2	2	0
fam20350	2	2	2	2.0	0.0	0.0	2	2	0
fam20351	2	2	2	2.0	0.0	0.0	2	2	0
fam20352	2	2	2	2.0	0.0	0.0	2	2	0
fam20353	2	2	2	2.0	0.0	0.0	2	2	0
fam20354	2	2	2	2.0	0.0	0.0	2	2	0
fam20355	2	2	2	2.0	0.0	0.0	2	2	0
fam20356	2	2	2	2.0	0.0	0.0	2	2	0
fam20357	2	2	2	2.0	0.0	0.0	2	2	0
fam20358	2	2	2	2.0	0.0	0.0	2	2	0
fam20359	2	2	2	2.0	0.0	0.0	2	2	0
fam20360	2	2	2	2.0	0.0	0.0	2	2	0
fam20361	2	2	2	2.0	0.0	0.0	2	2	0
fam20362	2	2	2	2.0	0.0	0.0	2	2	0
fam20363	2	2	2	2.0	0.0	0.0	2	2	0
fam20364	2	2	2	2.0	0.0	0.0	2	2	0
fam20365	2	2	2	2.0	0.0	0.0	2	2	0
fam20366	2	2	2	2.0	0.0	0.0	2	2	0
fam20367	2	2	2	2.0	0.0	0.0	2	2	0
fam20368	2	2	2	2.0	0.0	0.0	2	2	0
fam20369	2	2	2	2.0	0.0	0.0	2	2	0
fam20370	2	2	2	2.0	0.0	0.0	2	2	0
fam20371	2	2	2	2.0	0.0	0.0	2	2	0
fam20372	2	2	2	2.0	0.0	0.0	2	2	0
fam20373	2	2	2	2.0	0.0	0.0	2	2	0
fam20374	2	2	2	2.0	0.0	0.0	2	2	0
fam20375	2	2	2	2.0	0.0	0.0	2	2	0
fam20376	2	2	2	2.0	0.0	0.0	2	2	0
fam20377	2	2	2	2.0	0.0	0.0	2	2	0
fam20378	2	2	2	2.0	0.0	0.0	2	2	0
fam20379	2	2	2	2.0	0.0	0.0	2	2	0
fam20380	2	2	2	2.0	0.0	0.0	2	2	0
fam20381	2	2	2	2.0	0.0	0.0	2	2	0
fam20382	2	2	2	2.0	0.0	0.0	2	2	0
fam20383	2	2	2	2.0	0.0	0.0	2	2	0
fam20384	2	2	2	2.0	0.0	0.0	2	2	0
fam20385	2	2	2	2.0	0.0	0.0	2	2	0
fam20386	2	2	2	2.0	0.0	0.0	2	2	0
fam20387	2	2	2	2.0	0.0	0.0	2	2	0
fam20388	2	2	2	2.0	0.0	0.0	2	2	0
fam20389	2	2	2	2.0	0.0	0.0	2	2	0
fam20390	2	2	2	2.0	0.0	0.0	2	2	0
fam20391	2	2	2	2.0	0.0	0.0	2	2	0
fam20392	2	2	2	2.0	0.0	0.0	2	2	0
fam20393	2	2	2	2.0	0.0	0.0	2	2	0
fam20394	2	2	2	2.0	0.0	0.0	2	2	0
fam20395	2	2	2	2.0	0.0	0.0	2	2	0
fam20396	2	2	2	2.0	0.0	0.0	2	2	0
fam20397	2	2	2	2.0	0.0	0.0	2	2	0
fam20398	2	2	2	2.0	0.0	0.0	2	2	0
fam20399	2	2	2	2.0	0.0	0.0	2	2	0
fam20400	2	2	2	2.0	0.0	0.0	2	2	0
fam20401	2	2	2	2.0	0.0	0.0	2	2	0
fam20402	2	2	2	2.0	0.0	0.0	2	2	0
fam20403	2	2	2	2.0	0.0	0.0	2	2	0
fam20404	2	2	2	2.0	0.0	0.0	2	2	0
fam20405	2	2	2	2.0	0.0	0.0	2	2	0
fam20406	2	2	2	2.0	0.0	0.0	2	2	0
fam20407	2	2	2	2.0	0.0	0.0	2	2	0
fam20408	2	2	2	2.0	0.0	0.0	2	2	0
fam20409	2	2	2	2.0	0.0	0.0	2	2	0
fam20410	2	2	2	2.0	0.0	0.0	2	2	0
fam20411	2	2	2	2.0	0.0	0.0	2	2	0
fam20412	2	2	2	2.0	0.0	0.0	2	2	0
fam20413	2	2	2	2.0	0.0	0.0	2	2	0
fam20414	2	2	2	2.0	0.0	0.0	2	2	0
fam20415	2	2	2	2.0	0.0	0.0	2	2	0
fam20416	2	2	2	2.0	0.0	0.0	2	2	0
fam20417	2	2	2	2.0	0.0	0.0	2	2	0
fam20418	2	2	2	2.0	0.0	0.0	2	2	0
fam20419	2	2	2	2.0	0.0	0.0	2	2	0
fam20420	2	2	2	2.0	0.0	0.0	2	2	0
fam20421	2	2	2	2.0	0.0	0.0	2	2	0
fam20422	2	2	2	2.0	0.0	0.0	2	2	0
fam20423	2	2	2	2.0	0.0	0.0	2	2	0
fam20424	2	2	2	2.0	0.0	0.0	2	2	0
fam20425	2	2	2	2.0	0.0	0.0	2	2	0
fam20426	2	2	2	2.0	0.0	0.0	2	2	0
fam20427	2	2	2	2.0	0.0	0.0	2	2	0
fam20428	2	2	2	2.0	0.0	0.0	2	2	0
fam20429	2	2	2	2.0	0.0	0.0	2	2	0
fam20430	2	2	2	2.0	0.0	0.0	2	2	0
fam20431	2	2	2	2.0	0.0	0.0	2	2	0
fam20432	2	2	2	2.0	0.0	0.0	2	2	0
fam20433	2	2	2	2.0	0.0	0.0	2	2	0
fam20434	2	2	2	2.0	0.0	0.0	2	2	0
fam20435	2	2	2	2.0	0.0	0.0	2	2	0
fam20436	2	2	2	2.0	0.0	0.0	2	2	0
fam20437	2	2	2	2.0	0.0	0.0	2	2	0
fam20438	2	2	2	2.0	0.0	0.0	2	2	0
fam20439	2	2	2	2.0	0.0	0.0	2	2	0
fam20440	2	2	2	2.0	0.0	0.0	2	2	0
fam20441	2	2	2	2.0	0.0	0.0	2	2	0
fam20442	2	2	2	2.0	0.0	0.0	2	2	0
fam20443	2	2	2	2.0	0.0	0.0	2	2	0
fam20444	2	2	2	2.0	0.0	0.0	2	2	0
fam20445	2	2	2	2.0	0.0	0.0	2	2	0
fam20446	2	2	2	2.0	0.0	0.0	2	2	0
fam20447	2	2	2	2.0	0.0	0.0	2	2	0
fam20448	2	2	2	2.0	0.0	0.0	2	2	0
fam20449	2	2	2	2.0	0.0	0.0	2	2	0
fam20450	2	2	2	2.0	0.0	0.0	2	2	0
fam20451	2	2	2	2.0	0.0	0.0	2	2	0
fam20452	2	2	2	2.0	0.0	0.0	2	2	0
fam20453	2	2	2	2.0	0.0	0.0	2	2	0
fam20454	2	2	2	2.0	0.0	0.0	2	2	0
fam20455	2	2	2	2.0	0.0	0.0	2	2	0
fam20456	2	2	2	2.0	0.0	0.0	2	2	0
fam20457	2	2	2	2.0	0.0	0.0	2	2	0
fam20458	2	2	2	2.0	0.0	0.0	2	2	0
fam20459	2	2	2	2.0	0.0	0.0	2	2	0
fam20460	2	2	2	2.0	0.0	0.0	2	2	0
fam20461	2	2	2	2.0	0.0	0.0	2	2	0
fam20462	2	2	2	2.0	0.0	0.0	2	2	0
fam20463	2	2	2	2.0	0.0	0.0	2	2	0
fam20464	2	2	2	2.0	0.0	0.0	2	2	0
fam20465	2	2	2	2.0	0.0	0.0	2	2	0
fam20466	2	2	2	2.0	0.0	0.0	2	2	0
fam20467	2	2	2	2.0	0.0	0.0	2	2	0
fam20468	2	2	2	2.0	0.0	0.0	2	2	0
fam20469	2	2	2	2.0	0.0	0.0	2	2	0
fam20470	2	2	2	2.0	0.0	0.0	2	2	0
fam20471	2	2	2	2.0	0.0	0.0	2	2	0
fam20472	2	2	2	2.0	0.0	0.0	2	2	0
fam20473	2	2	2	2.0	0.0	0.0	2	2	0
fam20474	2	2	2	2.0	0.0	0.0	2	2	0
fam20475	2	2	2	2.0	0.0	0.0	2	2	0
fam20476	2	2	2	2.0	0.0	0.0	2	2	0
fam20477	2	2	2	2.0	0.0	0.0	2	2	0
fam20478	2	2	2	2.0	0.0	0.0	2	2	0
fam20479	2	2	2	2.0	0.0	0.0	2	2	0
fam20480	2	2	2	2.0	0.0	0.0	2	2	0
fam20481	2	2	2	2.0	0.0	0.0	2	2	0
fam20482	2	2	2	2.0	0.0	0.0	2	2	0
fam20483	2	2	2	2.0	0.0	0.0	2	2	0
fam20484	2	2	2	2.0	0.0	0.0	2	2	0
fam20485	2	2	2	2.0	0.0	0.0	2	2	0
fam20486	2	2	2	2.0	0.0	0.0	2	2	0
fam20487	2	2	2	2.0	0.0	0.0	2	2	0
fam20488	2	2	2	2.0	0.0	0.0	2	2	0
fam20489	2	2	2	2.0	0.0	0.0	2	2	0
fam20490	2	2	2	2.0	0.0	0.0	2	2	0
fam20491	2	2	2	2.0	0.0	0.0	2	2	0
fam20492	2	2	2	2.0	0.0	0.0	2	2	0
fam20493	2	2	2	2.0	0.0	0.0	2	2	0
fam20494	2	2	2	2.0	0.0	0.0	2	2	0
fam20495	2	2	2	2.0	0.0	0.0	2	2	0
fam20496	2	2	2	2.0	0.0	0.0	2	2	0
fam20497	2	2	2	2.0	0.0	0.0	2	2	0
fam20498	2	2	2	2.0	0.0	0.0	2	2	0
fam20499	2	2	2	2.0	0.0	0.0	2	2	0
fam20500	2	2	2	2.0	0.0	0.0	2	2	0
fam20501	2	2	2	2.0	0.0	0.0	2	2	0
fam20502	2	2	2	2.0	0.0	0.0	2	2	0
fam20503	2	2	2	2.0	0.0	0.0	2	2	0
fam20504	2	2	2	2.0	0.0	0.0	2	2	0
fam20505	2	2	2	2.0	0.0	0.0	2	2	0
fam20506	2	2	2	2.0	0.0	0.0	2	2	0
fam20507	2	2	2	2.0	0.0	0.0	2	2	0
fam20508	2	2	2	2.0	0.0	0.0	2	2	0
fam20509	2	2	2	2.0	0.0	0.0	2	2	0
fam20510	2	2	2	2.0	0.0	0.0	2	2	0
fam20511	2	2	2	2.0	0.0	0.0	2	2	0
fam20512	2	2	2	2.0	0.0	0.0	2	2	0
fam20513	2	2	2	2.0	0.0	0.0	2	2	0
fam20514	2	2	2	2.0	0.0	0.0	2	2	0
fam20515	2	2	2	2.0	0.0	0.0	2	2	0
fam20516	2	2	2	2.0	0.0	0.0	2	2	0
fam20517	2	2	2	2.0	0.0	0.0	2	2	0
fam20518	2	2	2	2.0	0.0	0.0	2	2	0
fam20519	2	2	2	2.0	0.0	0.0	2	2	0
fam20520	2	2	2	2.0	0.0	0.0	2	2	0
fam20521	2	2	2	2.0	0.0	0.0	2	2	0
fam20522	2	2	2	2.0	0.0	0.0	2	2	0
fam20523	2	2	2	2.0	0.0	0.0	2	2	0
fam20524	2	2	2	2.0	0.0	0.0	2	2	0
fam20525	2	2	2	2.0	0.0	0.0	2	2	0
fam20526	2	2	2	2.0	0.0	0.0	2	2	0
fam20527	2	2	2	2.0	0.0	0.0	2	2	0
fam20528	2	2	2	2.0	0.0	0.0	2	2	0
fam20529	2	2	2	2.0	0.0	0.0	2	2	0
fam20530	2	2	2	2.0	0.0	0.0	2	2	0
fam20531	2	2	2	2.0	0.0	0.0	2	2	0
fam20532	2	2	2	2.0	0.0	0.0	2	2	0
fam20533	2	2	2	2.0	0.0	0.0	2	2	0
fam20534	2	2	2	2.0	0.0	0.0	2	2	0
fam20535	2	2	2	2.0	0.0	0.0	2	2	0
fam20536	2	2	2	2.0	0.0	0.0	2	2	0
fam20537	2	2	2	2.0	0.0	0.0	2	2	0
fam20538	2	2	2	2.0	0.0	0.0	2	2	0
fam20539	2	2	2	2.0	0.0	0.0	2	2	0
fam20540	2	2	2	2.0	0.0	0.0	2	2	0
fam20541	2	2	2	2.0	0.0	0.0	2	2	0
fam20542	2	2	2	2.0	0.0	0.0	2	2	0
fam20543	2	2	2	2.0	0.0	0.0	2	2	0
fam20544	2	2	2	2.0	0.0	0.0	2	2	0
fam20545	2	2	2	2.0	0.0	0.0	2	2	0
fam20546	2	2	2	2.0	0.0	0.0	2	2	0
fam20547	2	2	2	2.0	0.0	0.0	2	2	0
fam20548	2	2	2	2.0	0.0	0.0	2	2	0
fam20549	2	2	2	2.0	0.0	0.0	2	2	0
fam20550	2	2	2	2.0	0.0	0.0	2	2	0
fam20551	2	2	2	2.0	0.0	0.0	2	2	0
fam20552	2	2	2	2.0	0.0	0.0	2	2	0
fam20553	2	2	2	2.0	0.0	0.0	2	2	0
fam20554	2	2	2	2.0	0.0	0.0	2	2	0
fam20555	2	2	2	2.0	0.0	0.0	2	2	0
fam20556	2	2	2	2.0	0.0	0.0	2	2	0
fam20557	2	2	2	2.0	0.0	0.0	2	2	0
fam20558	2	2	2	2.0	0.0	0.0	2	2	0
fam20559	2	2	2	2.0	0.0	0.0	2	2	0
fam20560	2	2	2	2.0	0.0	0.0	2	2	0
fam20561	2	2	2	2.0	0.0	0.0	2	2	0
fam20562	2	2	2	2.0	0.0	0.0	2	2	0
fam20563	2	2	2	2.0	0.0	0.0	2	2	0
fam20564	2	2	2	2.0	0.0	0.0	2	2	0
fam20565	2	2	2	2.0	0.0	0.0	2	2	0
fam20566	2	2	2	2.0	0.0	0.0	2	2	0
fam20567	2	2	2	2.0	0.0	0.0	2	2	0
fam20568	2	2	2	2.0	0.0	0.0	2	2	0
fam20569	2	2	2	2.0	0.0	0.0	2	2	0
fam20570	2	2	2	2.0	0.0	0.0	2	2	0
fam20571	2	2	2	2.0	0.0	0.0	2	2	0
fam20572	2	2	2	2.0	0.0	0.0	2	2	0
fam20573	2	2	2	2.0	0.0	0.0	2	2	0
fam20574	2	2	2	2.0	0.0	0.0	2	2	0
fam20575	2	2	2	2.0	0.0	0.0	2	2	0
fam20576	2	2	2	2.0	0.0	0.0	2	2	0
fam20577	2	2	2	2.0	0.0	0.0	2	2	0
fam20578	2	2	2	2.0	0.0	0.0	2	2	0
fam20579	2	2	2	2.0	0.0	0.0	2	2	0
fam20580	2	2	2	2.0	0.0	0.0	2	2	0
fam20581	2	2	2	2.0	0.0	0.0	2	2	0
fam20582	2	2	2	2.0	0.0	0.0	2	2	0
fam20583	2	2	2	2.0	0.0	0.0	2	2	0
fam20584	2	2	2	2.0	0.0	0.0	2	2	0
fam20585	2	2	2	2.0	0.0	0.0	2	2	0
fam20586	2	2	2	2.0	0.0	0.0	2	2	0
fam20587	2	2	2	2.0	0.0	0.0	2	2	0
fam20588	2	2	2	2.0	0.0	0.0	2	2	0
fam20589	2	2	2	2.0	0.0	0.0	2	2	0
fam20590	2	2	2	2.0	0.0	0.0	2	2	0
fam20591	2	2	2	2.0	0.0	0.0	2	2	0
fam20592	2	2	2	2.0	0.0	0.0	2	2	0
fam20593	2	2	2	2.0	0.0	0.0	2	2	0
fam20594	2	2	2	2.0	0.0	0.0	2	2	0
fam20595	2	2	2	2.0	0.0	0.0	2	2	0
fam20596	2	2	2	2.0	0.0	0.0	2	2	0
fam20597	2	2	2	2.0	0.0	0.0	2	2	0
fam20598	2	2	2	2.0	0.0	0.0	2	2	0
fam20599	2	2	2	2.0	0.0	0.0	2	2	0
fam20600	2	2	2	2.0	0.0	0.0	2	2	0
fam20601	2	2	2	2.0	0.0	0.0	2	2	0
fam20602	2	2	2	2.0	0.0	0.0	2	2	0
fam20603	2	2	2	2.0	0.0	0.0	2	2	0
fam20604	2	2	2	2.0	0.0	0.0	2	2	0
fam20605	2	2	2	2.0	0.0	0.0	2	2	0
fam20606	2	2	2	2.0	0.0	0.0	2	2	0
fam20607	2	2	2	2.0	0.0	0.0	2	2	0
fam20608	2	2	2	2.0	0.0	0.0	2	2	0
fam20609	2	2	2	2.0	0.0	0.0	2	2	0
fam20610	2	2	2	2.0	0.0	0.0	2	2	0
fam20611	2	2	2	2.0	0.0	0.0	2	2	0
fam20612	2	2	2	2.0	0.0	0.0	2	2	0
fam20613	2	2	2	2.0	0.0	0.0	2	2	0
fam20614	2	2	2	2.0	0.0	0.0	2	2	0
fam20615	2	2	2	2.0	0.0	0.0	2	2	0
fam20616	2	2	2	2.0	0.0	0.0	2	2	0
fam20617	2	2	2	2.0	0.0	0.0	2	2	0
fam20618	2	2	2	2.0	0.0	0.0	2	2	0
fam20619	2	2	2	2.0	0.0	0.0	2	2	0
fam20620	2	2	2	2.0	0.0	0.0	2	2	0
fam20621	2	2	2	2.0	0.0	0.0	2	2	0
fam20622	2	2	2	2.0	0.0	0.0	2	2	0
fam20623	2	2	2	2.0	0.0	0.0	2	2	0
fam20624	2	2	2	2.0	0.0	0.0	2	2	0
fam20625	2	2	2	2.0	0.0	0.0	2	2	0
fam20626	2	2	2	2.0	0.0	0.0	2	2	0
fam20627	2	2	2	2.0	0.0	0.0	2	2	0
fam20628	2	2	2	2.0	0.0	0.0	2	2	0
fam20629	2	2	2	2.0	0.0	0.0	2	2	0
fam20630	2	2	2	2.0	0.0	0.0	2	2	0
fam20631	2	2	2	2.0	0.0	0.0	2	2	0
fam20632	2	2	2	2.0	0.0	0.0	2	2	0
fam20633	2	2	2	2.0	0.0	0.0	2	2	0
fam20634	2	2	2	2.0	0.0	0.0	2	2	0
fam20635	2	2	2	2.0	0.0	0.0	2	2	0
fam20636	2	2	2	2.0	0.0	0.0	2	2	0
fam20637	2	2	2	2.0	0.0	0.0	2	2	0
fam20638	2	2	2	2.0	0.0	0.0	2	2	0
fam20639	2	2	2	2.0	0.0	0.0	2	2	0
fam20640	2	2	2	2.0	0.0	0.0	2	2	0
fam20641	2	2	2	2.0	0.0	0.0	2	2	0
fam20642	2	2	2	2.0	0.0	0.0	2	2	0
fam20643	2	2	2	2.0	0.0	0.0	2	2	0
fam20644	2	2	2	2.0	0.0	0.0	2	2	0
fam20645	2	2	2	2.0	0.0	0.0	2	2	0
fam20646	2	2	2	2.0	0.0	0.0	2	2	0
fam20647	2	2	2	2.0	0.0	0.0	2	2	0
fam20648	2	2	2	2.0	0.0	0.0	2	2	0
fam20649	2	2	2	2.0	0.0	0.0	2	2	0
fam20650	2	2	2	2.0	0.0	0.0	2	2	0
fam20651	2	2	2	2.0	0.0	0.0	2	2	0
fam20652	2	2	2	2.0	0.0	0.0	2	2	0
fam20653	2	2	2	2.0	0.0	0.0	2	2	0
fam20654	2	2	2	2.0	0.0	0.0	2	2	0
fam20655	2	2	2	2.0	0.0	0.0	2	2	0
fam20656	2	2	2	2.0	0.0	0.0	2	2	0
fam20657	2	2	2	2.0	0.0	0.0	2	2	0
fam20658	2	2	2	2.0	0.0	0.0	2	2	0
fam20659	2	2	2	2.0	0.0	0.0	2	2	0
fam20660	2	2	2	2.0	0.0	0.0	2	2	0
fam20661	2	2	2	2.0	0.0	0.0	2	2	0
fam20662	2	2	2	2.0	0.0	0.0	2	2	0
fam20663	2	2	2	2.0	0.0	0.0	2	2	0
fam20664	2	2	2	2.0	0.0	0.0	2	2	0
fam20665	2	2	2	2.0	0.0	0.0	2	2	0
fam20666	2	2	2	2.0	0.0	0.0	2	2	0
fam20667	2	2	2	2.0	0.0	0.0	2	2	0
fam20668	2	2	2	2.0	0.0	0.0	2	2	0
fam20669	2	2	2	2.0	0.0	0.0	2	2	0
fam20670	2	2	2	2.0	0.0	0.0	2	2	0
fam20671	2	2	2	2.0	0.0	0.0	2	2	0
fam20672	2	2	2	2.0	0.0	0.0	2	2	0
fam20673	2	2	2	2.0	0.0	0.0	2	2	0
fam20674	2	2	2	2.0	0.0	0.0	2	2	0
fam20675	2	2	2	2.0	0.0	0.0	2	2	0
fam20676	2	2	2	2.0	0.0	0.0	2	2	0
fam20677	2	2	2	2.0	0.0	0.0	2	2	0
fam20678	2	2	2	2.0	0.0	0.0	2	2	0
fam20679	2	2	2	2.0	0.0	0.0	2	2	0
fam20680	2	2	2	2.0	0.0	0.0	2	2	0
fam20681	2	2	2	2.0	0.0	0.0	2	2	0
fam20682	2	2	2	2.0	0.0	0.0	2	2	0
fam20683	2	2	2	2.0	0.0	0.0	2	2	0
fam20684	2	2	2	2.0	0.0	0.0	2	2	0
fam20685	2	2	2	2.0	0.0	0.0	2	2	0
fam20686	2	2	2	2.0	0.0	0.0	2	2	0
fam20687	2	2	2	2.0	0.0	0.0	2	2	0
fam20688	2	2	2	2.0	0.0	0.0	2	2	0
fam20689	2	2	2	2.0	0.0	0.0	2	2	0
fam20690	2	2	2	2.0	0.0	0.0	2	2	0
fam20691	2	2	2	2.0	0.0	0.0	2	2	0
fam20692	2	2	2	2.0	0.0	0.0	2	2	0
fam20693	2	2	2	2.0	0.0	0.0	2	2	0
fam20694	2	2	2	2.0	0.0	0.0	2	2	0
fam20695	2	2	2	2.0	0.0	0.0	2	2	0
fam20696	2	2	2	2.0	0.0	0.0	2	2	0
fam20697	2	2	2	2.0	0.0	0.0	2	2	0
fam20698	2	2	2	2.0	0.0	0.0	2	2	0
fam20699	2	2	2	2.0	0.0	0.0	2	2	0
fam20700	2	2	2	2.0	0.0	0.0	2	2	0
fam20701	2	2	2	2.0	0.0	0.0	2	2	0
fam20702	2	2	2	2.0	0.0	0.0	2	2	0
fam20703	2	2	2	2.0	0.0	0.0	2	2	0
fam20704	2	2	2	2.0	0.0	0.0	2	2	0
fam20705	2	2	2	2.0	0.0	0.0	2	2	0
fam20706	2	2	2	2.0	0.0	0.0	2	2	0
fam20707	2	2	2	2.0	0.0	0.0	2	2	0
fam20708	2	2	2	2.0	0.0	0.0	2	2	0
fam20709	2	2	2	2.0	0.0	0.0	2	2	0
fam20710	2	2	2	2.0	0.0	0.0	2	2	0
fam20711	2	2	2	2.0	0.0	0.0	2	2	0
fam20712	2	2	2	2.0	0.0	0.0	2	2	0
fam20713	2	2	2	2.0	0.0	0.0	2	2	0
fam20714	2	2	2	2.0	0.0	0.0	2	2	0
fam20715	2	2	2	2.0	0.0	0.0	2	2	0
fam20716	2	2	2	2.0	0.0	0.0	2	2	0
fam20717	2	2	2	2.0	0.0	0.0	2	2	0
fam20718	2	2	2	2.0	0.0	0.0	2	2	0
fam20719	2	2	2	2.0	0.0	0.0	2	2	0
fam20720	2	2	2	2.0	0.0	0.0	2	2	0
fam20721	2	2	2	2.0	0.0	0.0	2	2	0
fam20722	2	2	2	2.0	0.0	0.0	2	2	0
fam20723	2	2	2	2.0	0.0	0.0	2	2	0
fam20724	2	2	2	2.0	0.0	0.0	2	2	0
fam20725	2	2	2	2.0	0.0	0.0	2	2	0
fam20726	2	2	2	2.0	0.0	0.0	2	2	0
fam20727	2	2	2	2.0	0.0	0.0	2	2	0
fam20728	2	2	2	2.0	0.0	0.0	2	2	0
fam20729	2	2	2	2.0	0.0	0.0	2	2	0
fam20730	2	2	2	2.0	0.0	0.0	2	2	0
fam20731	2	2	2	2.0	0.0	0.0	2	2	0
fam20732	2	2	2	2.0	0.0	0.0	2	2	0
fam20733	2	2	2	2.0	0.0	0.0	2	2	0
fam20734	2	2	2	2.0	0.0	0.0	2	2	0
fam20735	2	2	2	2.0	0.0	0.0	2	2	0
fam20736	2	2	2	2.0	0.0	0.0	2	2	0
fam20737	2	2	2	2.0	0.0	0.0	2	2	0
fam20738	2	2	2	2.0	0.0	0.0	2	2	0
fam20739	2	2	2	2.0	0.0	0.0	2	2	0
fam20740	2	2	2	2.0	0.0	0.0	2	2	0
fam20741	2	2	2	2.0	0.0	0.0	2	2	0
fam20742	2	2	2	2.0	0.0	0.0	2	2	0
fam20743	2	2	2	2.0	0.0	0.0	2	2	0
fam20744	2	2	2	2.0	0.0	0.0	2	2	0
fam20745	2	2	2	2.0	0.0	0.0	2	2	0
fam20746	2	2	2	2.0	0.0	0.0	2	2	0
fam20747	2	2	2	2.0	0.0	0.0	2	2	0
fam20748	2	2	2	2.0	0.0	0.0	2	2	0
fam20749	2	2	2	2.0	0.0	0.0	2	2	0
fam20750	2	2	2	2.0	0.0	0.0	2	2	0
fam20751	2	2	2	2.0	0.0	0.0	2	2	0
fam20752	2	2	2	2.0	0.0	0.0	2	2	0
fam20753	2	2	2	2.0	0.0	0.0	2	2	0
fam20754	2	2	2	2.0	0.0	0.0	2	2	0
fam20755	2	2	2	2.0	0.0	0.0	2	2	0
fam20756	2	2	2	2.0	0.0	0.0	2	2	0
fam20757	2	2	2	2.0	0.0	0.0	2	2	0
fam20758	2	2	2	2.0	0.0	0.0	2	2	0
fam20759	2	2	2	2.0	0.0	0.0	2	2	0
fam20760	2	2	2	2.0	0.0	0.0	2	2	0
fam20761	2	2	2	2.0	0.0	0.0	2	2	0
fam20762	2	2	2	2.0	0.0	0.0	2	2	0
fam20763	2	2	2	2.0	0.0	0.0	2	2	0
fam20764	2	2	2	2.0	0.0	0.0	2	2	0
fam20765	2	2	2	2.0	0.0	0.0	2	2	0
fam20766	2	2	2	2.0	0.0	0.0	2	2	0
fam20767	2	2	2	2.0	0.0	0.0	2	2	0
fam20768	2	2	2	2.0	0.0	0.0	2	2	0
fam20769	2	2	2	2.0	0.0	0.0	2	2	0
fam20770	2	2	2	2.0	0.0	0.0	2	2	0
fam20771	2	2	2	2.0	0.0	0.0	2	2	0
fam20772	2	2	2	2.0	0.0	0.0	2	2	0
fam20773	2	2	2	2.0	0.0	0.0	2	2	0
fam20774	2	2	2	2.0	0.0	0.0	2	2	0
fam20775	2	2	2	2.0	0.0	0.0	2	2	0
fam20776	2	2	2	2.0	0.0	0.0	2	2	0
fam20777	2	2	2	2.0	0.0	0.0	2	2	0
fam20778	2	2	2	2.0	0.0	0.0	2	2	0
fam20779	2	2	2	2.0	0.0	0.0	2	2	0
fam20780	2	2	2	2.0	0.0	0.0	2	2	0
fam20781	2	2	2	2.0	0.0	0.0	2	2	0
fam20782	2	2	2	2.0	0.0	0.0	2	2	0
fam20783	2	2	2	2.0	0.0	0.0	2	2	0
fam20784	2	2	2	2.0	0.0	0.0	2	2	0
fam20785	2	2	2	2.0	0.0	0.0	2	2	0
fam20786	2	2	2	2.0	0.0	0.0	2	2	0
fam20787	2	2	2	2.0	0.0	0.0	2	2	0
fam20788	2	2	2	2.0	0.0	0.0	2	2	0
fam20789	2	2	2	2.0	0.0	0.0	2	2	0
fam20790	2	2	2	2.0	0.0	0.0	2	2	0
fam20791	2	2	2	2.0	0.0	0.0	2	2	0
fam20792	2	2	2	2.0	0.0	0.0	2	2	0
fam20793	2	2	2	2.0	0.0	0.0	2	2	0
fam20794	2	2	2	2.0	0.0	0.0	2	2	0
fam20795	2	2	2	2.0	0.0	0.0	2	2	0
fam20796	2	2	2	2.0	0.0	0.0	2	2	0
fam20797	2	2	2	2.0	0.0	0.0	2	2	0
fam20798	2	2	2	2.0	0.0	0.0	2	2	0
fam20799	2	2	2	2.0	0.0	0.0	2	2	0
fam20800	2	2	2	2.0	0.0	0.0	2	2	0
fam20801	2	2	2	2.0	0.0	0.0	2	2	0
fam20802	2	2	2	2.0	0.0	0.0	2	2	0
fam20803	2	2	2	2.0	0.0	0.0	2	2	0
fam20804	2	2	2	2.0	0.0	0.0	2	2	0
fam20805	2	2	2	2.0	0.0	0.0	2	2	0
fam20806	2	2	2	2.0	0.0	0.0	2	2	0
fam20807	2	2	2	2.0	0.0	0.0	2	2	0
fam20808	2	2	2	2.0	0.0	0.0	2	2	0
fam20809	2	2	2	2.0	0.0	0.0	2	2	0
fam20810	2	2	2	2.0	0.0	0.0	2	2	0
fam20811	2	2	2	2.0	0.0	0.0	2	2	0
fam20812	2	2	2	2.0	0.0	0.0	2	2	0
fam20813	2	2	2	2.0	0.0	0.0	2	2	0
fam20814	2	2	2	2.0	0.0	0.0	2	2	0
fam20815	2	2	2	2.0	0.0	0.0	2	2	0
fam20816	2	2	2	2.0	0.0	0.0	2	2	0
fam20817	2	2	2	2.0	0.0	0.0	2	2	0
fam20818	2	2	2	2.0	0.0	0.0	2	2	0
fam20819	2	2	2	2.0	0.0	0.0	2	2	0
fam20820	2	2	2	2.0	0.0	0.0	2	2	0
fam20821	2	2	2	2.0	0.0	0.0	2	2	0
fam20822	2	2	2	2.0	0.0	0.0	2	2	0
fam20823	2	2	2	2.0	0.0	0.0	2	2	0
fam20824	2	2	2	2.0	0.0	0.0	2	2	0
fam20825	2	2	2	2.0	0.0	0.0	2	2	0
fam20826	2	2	2	2.0	0.0	0.0	2	2	0
fam20827	2	2	2	2.0	0.0	0.0	2	2	0
fam20828	2	2	2	2.0	0.0	0.0	2	2	0
fam20829	2	2	2	2.0	0.0	0.0	2	2	0
fam20830	2	2	2	2.0	0.0	0.0	2	2	0
fam20831	2	2	2	2.0	0.0	0.0	2	2	0
fam20832	2	2	2	2.0	0.0	0.0	2	2	0
fam20833	2	2	2	2.0	0.0	0.0	2	2	0
fam20834	2	2	2	2.0	0.0	0.0	2	2	0
fam20835	2	2	2	2.0	0.0	0.0	2	2	0
fam20836	2	2	2	2.0	0.0	0.0	2	2	0
fam20837	2	2	2	2.0	0.0	0.0	2	2	0
fam20838	2	2	2	2.0	0.0	0.0	2	2	0
fam20839	2	2	2	2.0	0.0	0.0	2	2	0
fam20840	2	2	2	2.0	0.0	0.0	2	2	0
fam20841	2	2	2	2.0	0.0	0.0	2	2	0
fam20842	2	2	2	2.0	0.0	0.0	2	2	0
fam20843	2	2	2	2.0	0.0	0.0	2	2	0
fam20844	2	2	2	2.0	0.0	0.0	2	2	0
fam20845	2	2	2	2.0	0.0	0.0	2	2	0
fam20846	2	2	2	2.0	0.0	0.0	2	2	0
fam20847	2	2	2	2.0	0.0	0.0	2	2	0
fam20848	2	2	2	2.0	0.0	0.0	2	2	0
fam20849	2	2	2	2.0	0.0	0.0	2	2	0
fam20850	2	2	2	2.0	0.0	0.0	2	2	0
fam20851	2	2	2	2.0	0.0	0.0	2	2	0
fam20852	2	2	2	2.0	0.0	0.0	2	2	0
fam20853	2	2	2	2.0	0.0	0.0	2	2	0
fam20854	2	2	2	2.0	0.0	0.0	2	2	0
fam20855	2	2	2	2.0	0.0	0.0	2	2	0
fam20856	2	2	2	2.0	0.0	0.0	2	2	0
fam20857	2	2	2	2.0	0.0	0.0	2	2	0
fam20858	2	2	2	2.0	0.0	0.0	2	2	0
fam20859	2	2	2	2.0	0.0	0.0	2	2	0
fam20860	2	2	2	2.0	0.0	0.0	2	2	0
fam20861	2	2	2	2.0	0.0	0.0	2	2	0
fam20862	2	2	2	2.0	0.0	0.0	2	2	0
fam20863	2	2	2	2.0	0.0	0.0	2	2	0
fam20864	2	2	2	2.0	0.0	0.0	2	2	0
fam20865	2	2	2	2.0	0.0	0.0	2	2	0
fam20866	2	2	2	2.0	0.0	0.0	2	2	0
fam20867	2	2	2	2.0	0.0	0.0	2	2	0
fam20868	2	2	2	2.0	0.0	0.0	2	2	0
fam20869	2	2	2	2.0	0.0	0.0	2	2	0
fam20870	2	2	2	2.0	0.0	0.0	2	2	0
fam20871	2	2	2	2.0	0.0	0.0	2	2	0
fam20872	2	2	2	2.0	0.0	0.0	2	2	0
fam20873	2	2	2	2.0	0.0	0.0	2	2	0
fam20874	2	2	2	2.0	0.0	0.0	2	2	0
fam20875	2	2	2	2.0	0.0	0.0	2	2	0
fam20876	2	2	2	2.0	0.0	0.0	2	2	0
fam20877	2	2	2	2.0	0.0	0.0	2	2	0
fam20878	2	2	2	2.0	0.0	0.0	2	2	0
fam20879	2	2	2	2.0	0.0	0.0	2	2	0
fam20880	2	2	2	2.0	0.0	0.0	2	2	0
fam20881	2	2	2	2.0	0.0	0.0	2	2	0
fam20882	2	2	2	2.0	0.0	0.0	2	2	0
fam20883	2	2	2	2.0	0.0	0.0	2	2	0
fam20884	2	2	2	2.0	0.0	0.0	2	2	0
fam20885	2	2	2	2.0	0.0	0.0	2	2	0
fam20886	2	2	2	2.0	0.0	0.0	2	2	0
fam20887	2	2	2	2.0	0.0	0.0	2	2	0
fam20888	2	2	2	2.0	0.0	0.0	2	2	0
fam20889	2	2	2	2.0	0.0	0.0	2	2	0
fam20890	2	2	2	2.0	0.0	0.0	2	2	0
fam20891	2	2	2	2.0	0.0	0.0	2	2	0
fam20892	2	2	2	2.0	0.0	0.0	2	2	0
fam20893	2	2	2	2.0	0.0	0.0	2	2	0
fam20894	2	2	2	2.0	0.0	0.0	2	2	0
fam20895	2	2	2	2.0	0.0	0.0	2	2	0
fam20896	2	2	2	2.0	0.0	0.0	2	2	0
fam20897	2	2	2	2.0	0.0	0.0	2	2	0
fam20898	2	2	2	2.0	0.0	0.0	2	2	0
fam20899	2	2	2	2.0	0.0	0.0	2	2	0
fam20900	2	2	2	2.0	0.0	0.0	2	2	0
fam20901	2	2	2	2.0	0.0	0.0	2	2	0
fam20902	2	2	2	2.0	0.0	0.0	2	2	0
fam20903	2	2	2	2.0	0.0	0.0	2	2	0
fam20904	2	2	2	2.0	0.0	0.0	2	2	0
fam20905	2	2	2	2.0	0.0	0.0	2	2	0
fam20906	2	2	2	2.0	0.0	0.0	2	2	0
fam20907	2	2	2	2.0	0.0	0.0	2	2	0
fam20908	2	2	2	2.0	0.0	0.0	2	2	0
fam20909	2	2	2	2.0	0.0	0.0	2	2	0
fam20910	2	2	2	2.0	0.0	0.0	2	2	0
fam20911	2	2	2	2.0	0.0	0.0	2	2	0
fam20912	2	2	2	2.0	0.0	0.0	2	2	0
fam20913	2	2	2	2.0	0.0	0.0	2	2	0
fam20914	2	2	2	2.0	0.0	0.0	2	2	0
fam20915	2	2	2	2.0	0.0	0.0	2	2	0
fam20916	2	2	2	2.0	0.0	0.0	2	2	0
fam20917	2	2	2	2.0	0.0	0.0	2	2	0
fam20918	2	2	2	2.0	0.0	0.0	2	2	0
fam20919	2	2	2	2.0	0.0	0.0	2	2	0
fam20920	2	2	2	2.0	0.0	0.0	2	2	0
fam20921	2	2	2	2.0	0.0	0.0	2	2	0
fam20922	2	2	2	2.0	0.0	0.0	2	2	0
fam20923	2	2	2	2.0	0.0	0.0	2	2	0
fam20924	2	2	2	2.0	0.0	0.0	2	2	0
fam20925	2	2	2	2.0	0.0	0.0	2	2	0
fam20926	2	2	2	2.0	0.0	0.0	2	2	0
fam20927	2	2	2	2.0	0.0	0.0	2	2	0
fam20928	2	2	2	2.0	0.0	0.0	2	2	0
fam20929	2	2	2	2.0	0.0	0.0	2	2	0
fam20930	2	2	2	2.0	0.0	0.0	2	2	0
fam20931	2	2	2	2.0	0.0	0.0	2	2	0
fam20932	2	2	2	2.0	0.0	0.0	2	2	0
fam20933	2	2	2	2.0	0.0	0.0	2	2	0
fam20934	2	2	2	2.0	0.0	0.0	2	2	0
fam20935	2	2	2	2.0	0.0	0.0	2	2	0
fam20936	2	2	2	2.0	0.0	0.0	2	2	0
fam20937	2	2	2	2.0	0.0	0.0	2	2	0
fam20938	2	2	2	2.0	0.0	0.0	2	2	0
fam20939	2	2	2	2.0	0.0	0.0	2	2	0
fam20940	2	2	2	2.0	0.0	0.0	2	2	0
fam20941	2	2	2	2.0	0.0	0.0	2	2	0
fam20942	2	2	2	2.0	0.0	0.0	2	2	0
fam20943	2	2	2	2.0	0.0	0.0	2	2	0
fam20944	2	2	2	2.0	0.0	0.0	2	2	0
fam20945	2	2	2	2.0	0.0	0.0	2	2	0
fam20946	2	2	2	2.0	0.0	0.0	2	2	0
fam20947	2	2	2	2.0	0.0	0.0	2	2	0
fam20948	2	2	2	2.0	0.0	0.0	2	2	0
fam20949	2	2	2	2.0	0.0	0.0	2	2	0
fam20950	2	2	2	2.0	0.0	0.0	2	2	0
fam20951	2	2	2	2.0	0.0	0.0	2	2	0
fam20952	2	2	2	2.0	0.0	0.0	2	2	0
fam20953	2	2	2	2.0	0.0	0.0	2	2	0
fam20954	2	2	2	2.0	0.0	0.0	2	2	0
fam20955	2	2	2	2.0	0.0	0.0	2	2	0
fam20956	2	2	2	2.0	0.0	0.0	2	2	0
fam20957	2	2	2	2.0	0.0	0.0	2	2	0
fam20958	2	2	2	2.0	0.0	0.0	2	2	0
fam20959	2	2	2	2.0	0.0	0.0	2	2	0
fam20960	2	2	2	2.0	0.0	0.0	2	2	0
fam20961	2	2	2	2.0	0.0	0.0	2	2	0
fam20962	2	2	2	2.0	0.0	0.0	2	2	0
fam20963	2	2	2	2.0	0.0	0.0	2	2	0
fam20964	2	2	2	2.0	0.0	0.0	2	2	0
fam20965	2	2	2	2.0	0.0	0.0	2	2	0
fam20966	2	2	2	2.0	0.0	0.0	2	2	0
fam20967	2	2	2	2.0	0.0	0.0	2	2	0
fam20968	2	2	2	2.0	0.0	0.0	2	2	0
fam20969	2	2	2	2.0	0.0	0.0	2	2	0
fam20970	2	2	2	2.0	0.0	0.0	2	2	0
fam20971	2	2	2	2.0	0.0	0.0	2	2	0
fam20972	2	2	2	2.0	0.0	0.0	2	2	0
fam20973	2	2	2	2.0	0.0	0.0	2	2	0
fam20974	2	2	2	2.0	0.0	0.0	2	2	0
fam20975	2	2	2	2.0	0.0	0.0	2	2	0
fam20976	2	2	2	2.0	0.0	0.0	2	2	0
fam20977	2	2	2	2.0	0.0	0.0	2	2	0
fam20978	2	2	2	2.0	0.0	0.0	2	2	0
fam20979	2	2	2	2.0	0.0	0.0	2	2	0
fam20980	2	2	2	2.0	0.0	0.0	2	2	0
fam20981	2	2	2	2.0	0.0	0.0	2	2	0
fam20982	2	2	2	2.0	0.0	0.0	2	2	0
fam20983	2	2	2	2.0	0.0	0.0	2	2	0
fam20984	2	2	2	2.0	0.0	0.0	2	2	0
fam20985	2	2	2	2.0	0.0	0.0	2	2	0
fam20986	2	2	2	2.0	0.0	0.0	2	2	0
fam20987	2	2	2	2.0	0.0	0.0	2	2	0
fam20988	2	2	2	2.0	0.0	0.0	2	2	0
fam20989	2	2	2	2.0	0.0	0.0	2	2	0
fam20990	2	2	2	2.0	0.0	0.0	2	2	0
fam20991	2	2	2	2.0	0.0	0.0	2	2	0
fam20992	2	2	2	2.0	0.0	0.0	2	2	0
fam20993	2	2	2	2.0	0.0	0.0	2	2	0
fam20994	2	2	2	2.0	0.0	0.0	2	2	0
fam20995	2	2	2	2.0	0.0	0.0	2	2	0
fam20996	2	2	2	2.0	0.0	0.0	2	2	0
fam20997	2	2	2	2.0	0.0	0.0	2	2	0
fam20998	2	2	2	2.0	0.0	0.0	2	2	0
fam20999	2	2	2	2.0	0.0	0.0	2	2	0
fam21000	2	2	2	2.0	0.0	0.0	2	2	0
fam21001	2	2	2	2.0	0.0	0.0	2	2	0
fam21002	2	2	2	2.0	0.0	0.0	2	2	0
fam21003	2	2	2	2.0	0.0	0.0	2	2	0
fam21004	2	2	2	2.0	0.0	0.0	2	2	0
fam21005	2	2	2	2.0	0.0	0.0	2	2	0
fam21006	2	2	2	2.0	0.0	0.0	2	2	0
fam21007	2	2	2	2.0	0.0	0.0	2	2	0
fam21008	2	2	2	2.0	0.0	0.0	2	2	0
fam21009	2	2	2	2.0	0.0	0.0	2	2	0
fam21010	2	2	2	2.0	0.0	0.0	2	2	0
fam21011	2	2	2	2.0	0.0	0.0	2	2	0
fam21012	2	2	2	2.0	0.0	0.0	2	2	0
fam21013	2	2	2	2.0	0.0	0.0	2	2	0
fam21014	2	2	2	2.0	0.0	0.0	2	2	0
fam21015	2	2	2	2.0	0.0	0.0	2	2	0
fam21016	2	2	2	2.0	0.0	0.0	2	2	0
fam21017	2	2	2	2.0	0.0	0.0	2	2	0
fam21018	2	2	2	2.0	0.0	0.0	2	2	0
fam21019	2	2	2	2.0	0.0	0.0	2	2	0
fam21020	2	2	2	2.0	0.0	0.0	2	2	0
fam21021	2	2	2	2.0	0.0	0.0	2	2	0
fam21022	2	2	2	2.0	0.0	0.0	2	2	0
fam21023	2	2	2	2.0	0.0	0.0	2	2	0
fam21024	2	2	2	2.0	0.0	0.0	2	2	0
fam21025	2	2	2	2.0	0.0	0.0	2	2	0
fam21026	2	2	2	2.0	0.0	0.0	2	2	0
fam21027	2	2	2	2.0	0.0	0.0	2	2	0
fam21028	2	2	2	2.0	0.0	0.0	2	2	0
fam21029	2	2	2	2.0	0.0	0.0	2	2	0
fam21030	2	2	2	2.0	0.0	0.0	2	2	0
fam21031	2	2	2	2.0	0.0	0.0	2	2	0
fam21032	2	2	2	2.0	0.0	0.0	2	2	0
fam21033	2	2	2	2.0	0.0	0.0	2	2	0
fam21034	2	2	2	2.0	0.0	0.0	2	2	0
fam21035	2	2	2	2.0	0.0	0.0	2	2	0
fam21036	2	2	2	2.0	0.0	0.0	2	2	0
fam21037	2	2	2	2.0	0.0	0.0	2	2	0
fam21038	2	2	2	2.0	0.0	0.0	2	2	0
fam21039	2	2	2	2.0	0.0	0.0	2	2	0
fam21040	2	2	2	2.0	0.0	0.0	2	2	0
fam21041	2	2	2	2.0	0.0	0.0	2	2	0
fam21042	2	2	2	2.0	0.0	0.0	2	2	0
fam21043	2	2	2	2.0	0.0	0.0	2	2	0
fam21044	2	2	2	2.0	0.0	0.0	2	2	0
fam21045	2	2	2	2.0	0.0	0.0	2	2	0
fam21046	2	2	2	2.0	0.0	0.0	2	2	0
fam21047	2	2	2	2.0	0.0	0.0	2	2	0
fam21048	2	2	2	2.0	0.0	0.0	2	2	0
fam21049	2	2	2	2.0	0.0	0.0	2	2	0
fam21050	2	2	2	2.0	0.0	0.0	2	2	0
fam21051	2	2	2	2.0	0.0	0.0	2	2	0
fam21052	2	2	2	2.0	0.0	0.0	2	2	0
fam21053	2	2	2	2.0	0.0	0.0	2	2	0
fam21054	2	2	2	2.0	0.0	0.0	2	2	0
fam21055	2	2	2	2.0	0.0	0.0	2	2	0
fam21056	2	2	2	2.0	0.0	0.0	2	2	0
fam21057	2	2	2	2.0	0.0	0.0	2	2	0
fam21058	2	2	2	2.0	0.0	0.0	2	2	0
fam21059	2	2	2	2.0	0.0	0.0	2	2	0
fam21060	2	2	2	2.0	0.0	0.0	2	2	0
fam21061	2	2	2	2.0	0.0	0.0	2	2	0
fam21062	2	2	2	2.0	0.0	0.0	2	2	0
fam21063	2	2	2	2.0	0.0	0.0	2	2	0
fam21064	2	2	2	2.0	0.0	0.0	2	2	0
fam21065	2	2	2	2.0	0.0	0.0	2	2	0
fam21066	2	2	2	2.0	0.0	0.0	2	2	0
fam21067	2	2	2	2.0	0.0	0.0	2	2	0
fam21068	2	2	2	2.0	0.0	0.0	2	2	0
fam21069	2	2	2	2.0	0.0	0.0	2	2	0
fam21070	2	2	2	2.0	0.0	0.0	2	2	0
fam21071	2	2	2	2.0	0.0	0.0	2	2	0
fam21072	2	2	2	2.0	0.0	0.0	2	2	0
fam21073	2	2	2	2.0	0.0	0.0	2	2	0
fam21074	2	2	2	2.0	0.0	0.0	2	2	0
fam21075	2	2	2	2.0	0.0	0.0	2	2	0
fam21076	2	2	2	2.0	0.0	0.0	2	2	0
fam21077	2	2	2	2.0	0.0	0.0	2	2	0
fam21078	2	2	2	2.0	0.0	0.0	2	2	0
fam21079	2	2	2	2.0	0.0	0.0	2	2	0
fam21080	2	2	2	2.0	0.0	0.0	2	2	0
fam21081	2	2	2	2.0	0.0	0.0	2	2	0
fam21082	2	2	2	2.0	0.0	0.0	2	2	0
fam21083	2	2	2	2.0	0.0	0.0	2	2	0
fam21084	2	2	2	2.0	0.0	0.0	2	2	0
fam21085	2	2	2	2.0	0.0	0.0	2	2	0
fam21086	2	2	2	2.0	0.0	0.0	2	2	0
fam21087	2	2	2	2.0	0.0	0.0	2	2	0
fam21088	2	2	2	2.0	0.0	0.0	2	2	0
fam21089	2	2	2	2.0	0.0	0.0	2	2	0
fam21090	2	2	2	2.0	0.0	0.0	2	2	0
fam21091	2	2	2	2.0	0.0	0.0	2	2	0
fam21092	2	2	2	2.0	0.0	0.0	2	2	0
fam21093	2	2	2	2.0	0.0	0.0	2	2	0
fam21094	2	2	2	2.0	0.0	0.0	2	2	0
fam21095	2	2	2	2.0	0.0	0.0	2	2	0
fam21096	2	2	2	2.0	0.0	0.0	2	2	0
fam21097	2	2	2	2.0	0.0	0.0	2	2	0
fam21098	2	2	2	2.0	0.0	0.0	2	2	0
fam21099	2	2	2	2.0	0.0	0.0	2	2	0
fam21100	2	2	2	2.0	0.0	0.0	2	2	0
fam21101	2	2	2	2.0	0.0	0.0	2	2	0
fam21102	2	2	2	2.0	0.0	0.0	2	2	0
fam21103	2	2	2	2.0	0.0	0.0	2	2	0
fam21104	2	2	2	2.0	0.0	0.0	2	2	0
fam21105	2	2	2	2.0	0.0	0.0	2	2	0
fam21106	2	2	2	2.0	0.0	0.0	2	2	0
fam21107	2	2	2	2.0	0.0	0.0	2	2	0
fam21108	2	2	2	2.0	0.0	0.0	2	2	0
fam21109	2	2	2	2.0	0.0	0.0	2	2	0
fam21110	2	2	2	2.0	0.0	0.0	2	2	0
fam21111	2	2	2	2.0	0.0	0.0	2	2	0
fam21112	2	2	2	2.0	0.0	0.0	2	2	0
fam21113	2	2	2	2.0	0.0	0.0	2	2	0
fam21114	2	2	2	2.0	0.0	0.0	2	2	0
fam21115	2	2	2	2.0	0.0	0.0	2	2	0
fam21116	2	2	2	2.0	0.0	0.0	2	2	0
fam21117	2	2	2	2.0	0.0	0.0	2	2	0
fam21118	2	2	2	2.0	0.0	0.0	2	2	0
fam21119	2	2	2	2.0	0.0	0.0	2	2	0
fam21120	2	2	2	2.0	0.0	0.0	2	2	0
fam21121	2	2	2	2.0	0.0	0.0	2	2	0
fam21122	2	2	2	2.0	0.0	0.0	2	2	0
fam21123	2	2	2	2.0	0.0	0.0	2	2	0
fam21124	2	2	2	2.0	0.0	0.0	2	2	0
fam21125	2	2	2	2.0	0.0	0.0	2	2	0
fam21126	2	2	2	2.0	0.0	0.0	2	2	0
fam21127	2	2	2	2.0	0.0	0.0	2	2	0
fam21128	2	2	2	2.0	0.0	0.0	2	2	0
fam21129	2	2	2	2.0	0.0	0.0	2	2	0
fam21130	2	2	2	2.0	0.0	0.0	2	2	0
fam21131	2	2	2	2.0	0.0	0.0	2	2	0
fam21132	2	2	2	2.0	0.0	0.0	2	2	0
fam21133	2	2	2	2.0	0.0	0.0	2	2	0
fam21134	2	2	2	2.0	0.0	0.0	2	2	0
fam21135	2	2	2	2.0	0.0	0.0	2	2	0
fam21136	2	2	2	2.0	0.0	0.0	2	2	0
fam21137	2	2	2	2.0	0.0	0.0	2	2	0
fam21138	2	2	2	2.0	0.0	0.0	2	2	0
fam21139	2	2	2	2.0	0.0	0.0	2	2	0
fam21140	2	2	2	2.0	0.0	0.0	2	2	0
fam21141	2	2	2	2.0	0.0	0.0	2	2	0
fam21142	2	2	2	2.0	0.0	0.0	2	2	0
fam21143	2	2	2	2.0	0.0	0.0	2	2	0
fam21144	2	2	2	2.0	0.0	0.0	2	2	0
fam21145	2	2	2	2.0	0.0	0.0	2	2	0
fam21146	2	2	2	2.0	0.0	0.0	2	2	0
fam21147	2	2	2	2.0	0.0	0.0	2	2	0
fam21148	2	2	2	2.0	0.0	0.0	2	2	0
fam21149	2	2	2	2.0	0.0	0.0	2	2	0
fam21150	2	2	2	2.0	0.0	0.0	2	2	0
fam21151	2	2	2	2.0	0.0	0.0	2	2	0
fam21152	2	2	2	2.0	0.0	0.0	2	2	0
fam21153	2	2	2	2.0	0.0	0.0	2	2	0
fam21154	2	2	2	2.0	0.0	0.0	2	2	0
fam21155	2	2	2	2.0	0.0	0.0	2	2	0
fam21156	2	2	2	2.0	0.0	0.0	2	2	0
fam21157	2	2	2	2.0	0.0	0.0	2	2	0
fam21158	2	2	2	2.0	0.0	0.0	2	2	0
fam21159	2	2	2	2.0	0.0	0.0	2	2	0
fam21160	2	2	2	2.0	0.0	0.0	2	2	0
fam21161	2	2	2	2.0	0.0	0.0	2	2	0
fam21162	2	2	2	2.0	0.0	0.0	2	2	0
fam21163	2	2	2	2.0	0.0	0.0	2	2	0
fam21164	2	2	2	2.0	0.0	0.0	2	2	0
fam21165	2	2	2	2.0	0.0	0.0	2	2	0
fam21166	2	2	2	2.0	0.0	0.0	2	2	0
fam21167	2	2	2	2.0	0.0	0.0	2	2	0
fam21168	2	2	2	2.0	0.0	0.0	2	2	0
fam21169	2	2	2	2.0	0.0	0.0	2	2	0
fam21170	2	2	2	2.0	0.0	0.0	2	2	0
fam21171	2	2	2	2.0	0.0	0.0	2	2	0
fam21172	2	2	2	2.0	0.0	0.0	2	2	0
fam21173	2	2	2	2.0	0.0	0.0	2	2	0
fam21174	2	2	2	2.0	0.0	0.0	2	2	0
fam21175	2	2	2	2.0	0.0	0.0	2	2	0
fam21176	2	2	2	2.0	0.0	0.0	2	2	0
fam21177	2	2	2	2.0	0.0	0.0	2	2	0
fam21178	2	2	2	2.0	0.0	0.0	2	2	0
fam21179	2	2	2	2.0	0.0	0.0	2	2	0
fam21180	2	2	2	2.0	0.0	0.0	2	2	0
fam21181	2	2	2	2.0	0.0	0.0	2	2	0
fam21182	2	2	2	2.0	0.0	0.0	2	2	0
fam21183	2	2	2	2.0	0.0	0.0	2	2	0
fam21184	2	2	2	2.0	0.0	0.0	2	2	0
fam21185	2	2	2	2.0	0.0	0.0	2	2	0
fam21186	2	2	2	2.0	0.0	0.0	2	2	0
fam21187	2	2	2	2.0	0.0	0.0	2	2	0
fam21188	2	2	2	2.0	0.0	0.0	2	2	0
fam21189	2	2	2	2.0	0.0	0.0	2	2	0
fam21190	2	2	2	2.0	0.0	0.0	2	2	0
fam21191	2	2	2	2.0	0.0	0.0	2	2	0
fam21192	2	2	2	2.0	0.0	0.0	2	2	0
fam21193	2	2	2	2.0	0.0	0.0	2	2	0
fam21194	2	2	2	2.0	0.0	0.0	2	2	0
fam21195	2	2	2	2.0	0.0	0.0	2	2	0
fam21196	2	2	2	2.0	0.0	0.0	2	2	0
fam21197	2	2	2	2.0	0.0	0.0	2	2	0
fam21198	2	2	2	2.0	0.0	0.0	2	2	0
fam21199	2	2	2	2.0	0.0	0.0	2	2	0
fam21200	2	2	2	2.0	0.0	0.0	2	2	0
fam21201	2	2	2	2.0	0.0	0.0	2	2	0
fam21202	2	2	2	2.0	0.0	0.0	2	2	0
fam21203	2	2	2	2.0	0.0	0.0	2	2	0
fam21204	2	2	2	2.0	0.0	0.0	2	2	0
fam21205	2	2	2	2.0	0.0	0.0	2	2	0
fam21206	2	2	2	2.0	0.0	0.0	2	2	0
fam21207	2	2	2	2.0	0.0	0.0	2	2	0
fam21208	2	2	2	2.0	0.0	0.0	2	2	0
fam21209	2	2	2	2.0	0.0	0.0	2	2	0
fam21210	2	2	2	2.0	0.0	0.0	2	2	0
fam21211	2	2	2	2.0	0.0	0.0	2	2	0
fam21212	2	2	2	2.0	0.0	0.0	2	2	0
fam21213	2	2	2	2.0	0.0	0.0	2	2	0
fam21214	2	2	2	2.0	0.0	0.0	2	2	0
fam21215	2	2	2	2.0	0.0	0.0	2	2	0
fam21216	2	2	2	2.0	0.0	0.0	2	2	0
fam21217	2	2	2	2.0	0.0	0.0	2	2	0
fam21218	2	2	2	2.0	0.0	0.0	2	2	0
fam21219	2	2	2	2.0	0.0	0.0	2	2	0
fam21220	2	2	2	2.0	0.0	0.0	2	2	0
fam21221	2	2	2	2.0	0.0	0.0	2	2	0
fam21222	2	2	2	2.0	0.0	0.0	2	2	0
fam21223	2	2	2	2.0	0.0	0.0	2	2	0
fam21224	2	2	2	2.0	0.0	0.0	2	2	0
fam21225	2	2	2	2.0	0.0	0.0	2	2	0
fam21226	2	2	2	2.0	0.0	0.0	2	2	0
fam21227	2	2	2	2.0	0.0	0.0	2	2	0
fam21228	2	2	2	2.0	0.0	0.0	2	2	0
fam21229	2	2	2	2.0	0.0	0.0	2	2	0
fam21230	2	2	2	2.0	0.0	0.0	2	2	0
fam21231	2	2	2	2.0	0.0	0.0	2	2	0
fam21232	2	2	2	2.0	0.0	0.0	2	2	0
fam21233	2	2	2	2.0	0.0	0.0	2	2	0
fam21234	2	2	2	2.0	0.0	0.0	2	2	0
fam21235	2	2	2	2.0	0.0	0.0	2	2	0
fam21236	2	2	2	2.0	0.0	0.0	2	2	0
fam21237	2	2	2	2.0	0.0	0.0	2	2	0
fam21238	2	2	2	2.0	0.0	0.0	2	2	0
fam21239	2	2	2	2.0	0.0	0.0	2	2	0
fam21240	2	2	2	2.0	0.0	0.0	2	2	0
fam21241	2	2	2	2.0	0.0	0.0	2	2	0
fam21242	2	2	2	2.0	0.0	0.0	2	2	0
fam21243	2	2	2	2.0	0.0	0.0	2	2	0
fam21244	2	2	2	2.0	0.0	0.0	2	2	0
fam21245	2	2	2	2.0	0.0	0.0	2	2	0
fam21246	2	2	2	2.0	0.0	0.0	2	2	0
fam21247	2	2	2	2.0	0.0	0.0	2	2	0
fam21248	2	2	2	2.0	0.0	0.0	2	2	0
fam21249	2	2	2	2.0	0.0	0.0	2	2	0
fam21250	2	2	2	2.0	0.0	0.0	2	2	0
fam21251	2	2	2	2.0	0.0	0.0	2	2	0
fam21252	2	2	2	2.0	0.0	0.0	2	2	0
fam21253	2	2	2	2.0	0.0	0.0	2	2	0
fam21254	2	2	2	2.0	0.0	0.0	2	2	0
fam21255	2	2	2	2.0	0.0	0.0	2	2	0
fam21256	2	2	2	2.0	0.0	0.0	2	2	0
fam21257	2	2	2	2.0	0.0	0.0	2	2	0
fam21258	2	2	2	2.0	0.0	0.0	2	2	0
fam21259	2	2	2	2.0	0.0	0.0	2	2	0
fam21260	2	2	2	2.0	0.0	0.0	2	2	0
fam21261	2	2	2	2.0	0.0	0.0	2	2	0
fam21262	2	2	2	2.0	0.0	0.0	2	2	0
fam21263	2	2	2	2.0	0.0	0.0	2	2	0
fam21264	2	2	2	2.0	0.0	0.0	2	2	0
fam21265	2	2	2	2.0	0.0	0.0	2	2	0
fam21266	2	2	2	2.0	0.0	0.0	2	2	0
fam21267	2	2	2	2.0	0.0	0.0	2	2	0
fam21268	2	2	2	2.0	0.0	0.0	2	2	0
fam21269	2	2	2	2.0	0.0	0.0	2	2	0
fam21270	2	2	2	2.0	0.0	0.0	2	2	0
fam21271	2	2	2	2.0	0.0	0.0	2	2	0
fam21272	2	2	2	2.0	0.0	0.0	2	2	0
fam21273	2	2	2	2.0	0.0	0.0	2	2	0
fam21274	2	2	2	2.0	0.0	0.0	2	2	0
fam21275	2	2	2	2.0	0.0	0.0	2	2	0
fam21276	2	2	2	2.0	0.0	0.0	2	2	0
fam21277	2	2	2	2.0	0.0	0.0	2	2	0
fam21278	2	2	2	2.0	0.0	0.0	2	2	0
fam21279	2	2	2	2.0	0.0	0.0	2	2	0
fam21280	2	2	2	2.0	0.0	0.0	2	2	0
fam21281	2	2	2	2.0	0.0	0.0	2	2	0
fam21282	2	2	2	2.0	0.0	0.0	2	2	0
fam21283	2	2	2	2.0	0.0	0.0	2	2	0
fam21284	2	2	2	2.0	0.0	0.0	2	2	0
fam21285	2	2	2	2.0	0.0	0.0	2	2	0
fam21286	2	2	2	2.0	0.0	0.0	2	2	0
fam21287	2	2	2	2.0	0.0	0.0	2	2	0
fam21288	2	2	2	2.0	0.0	0.0	2	2	0
fam21289	2	2	2	2.0	0.0	0.0	2	2	0
fam21290	2	2	2	2.0	0.0	0.0	2	2	0
fam21291	2	2	2	2.0	0.0	0.0	2	2	0
fam21292	2	2	2	2.0	0.0	0.0	2	2	0
fam21293	2	2	2	2.0	0.0	0.0	2	2	0
fam21294	2	2	2	2.0	0.0	0.0	2	2	0
fam21295	2	2	2	2.0	0.0	0.0	2	2	0
fam21296	2	2	2	2.0	0.0	0.0	2	2	0
fam21297	2	2	2	2.0	0.0	0.0	2	2	0
fam21298	2	2	2	2.0	0.0	0.0	2	2	0
fam21299	2	2	2	2.0	0.0	0.0	2	2	0
fam21300	2	2	2	2.0	0.0	0.0	2	2	0
fam21301	2	2	2	2.0	0.0	0.0	2	2	0
fam21302	2	2	2	2.0	0.0	0.0	2	2	0
fam21303	2	2	2	2.0	0.0	0.0	2	2	0
fam21304	2	2	2	2.0	0.0	0.0	2	2	0
fam21305	2	2	2	2.0	0.0	0.0	2	2	0
fam21306	2	2	2	2.0	0.0	0.0	2	2	0
fam21307	2	2	2	2.0	0.0	0.0	2	2	0
fam21308	2	2	2	2.0	0.0	0.0	2	2	0
fam21309	2	2	2	2.0	0.0	0.0	2	2	0
fam21310	2	2	2	2.0	0.0	0.0	2	2	0
fam21311	2	2	2	2.0	0.0	0.0	2	2	0
fam21312	2	2	2	2.0	0.0	0.0	2	2	0
fam21313	2	2	2	2.0	0.0	0.0	2	2	0
fam21314	2	2	2	2.0	0.0	0.0	2	2	0
fam21315	2	2	2	2.0	0.0	0.0	2	2	0
fam21316	2	2	2	2.0	0.0	0.0	2	2	0
fam21317	2	2	2	2.0	0.0	0.0	2	2	0
fam21318	2	2	2	2.0	0.0	0.0	2	2	0
fam21319	2	2	2	2.0	0.0	0.0	2	2	0
fam21320	2	2	2	2.0	0.0	0.0	2	2	0
fam21321	2	2	2	2.0	0.0	0.0	2	2	0
fam21322	2	2	2	2.0	0.0	0.0	2	2	0
fam21323	2	2	2	2.0	0.0	0.0	2	2	0
fam21324	2	2	2	2.0	0.0	0.0	2	2	0
fam21325	2	2	2	2.0	0.0	0.0	2	2	0
fam21326	2	2	2	2.0	0.0	0.0	2	2	0
fam21327	2	2	2	2.0	0.0	0.0	2	2	0
fam21328	2	2	2	2.0	0.0	0.0	2	2	0
fam21329	2	2	2	2.0	0.0	0.0	2	2	0
fam21330	2	2	2	2.0	0.0	0.0	2	2	0
fam21331	2	2	2	2.0	0.0	0.0	2	2	0
fam21332	2	2	2	2.0	0.0	0.0	2	2	0
fam21333	2	2	2	2.0	0.0	0.0	2	2	0
fam21334	2	2	2	2.0	0.0	0.0	2	2	0
fam21335	2	2	2	2.0	0.0	0.0	2	2	0
fam21336	2	2	2	2.0	0.0	0.0	2	2	0
fam21337	2	2	2	2.0	0.0	0.0	2	2	0
fam21338	2	2	2	2.0	0.0	0.0	2	2	0
fam21339	2	2	2	2.0	0.0	0.0	2	2	0
fam21340	2	2	2	2.0	0.0	0.0	2	2	0
fam21341	2	2	2	2.0	0.0	0.0	2	2	0
fam21342	2	2	2	2.0	0.0	0.0	2	2	0
fam21343	2	2	2	2.0	0.0	0.0	2	2	0
fam21344	2	2	2	2.0	0.0	0.0	2	2	0
fam21345	2	2	2	2.0	0.0	0.0	2	2	0
fam21346	2	2	2	2.0	0.0	0.0	2	2	0
fam21347	2	2	2	2.0	0.0	0.0	2	2	0
fam21348	2	2	2	2.0	0.0	0.0	2	2	0
fam21349	2	2	2	2.0	0.0	0.0	2	2	0
fam21350	2	2	2	2.0	0.0	0.0	2	2	0
fam21351	2	2	2	2.0	0.0	0.0	2	2	0
fam21352	2	2	2	2.0	0.0	0.0	2	2	0
fam21353	2	2	2	2.0	0.0	0.0	2	2	0
fam21354	2	2	2	2.0	0.0	0.0	2	2	0
fam21355	2	2	2	2.0	0.0	0.0	2	2	0
fam21356	2	2	2	2.0	0.0	0.0	2	2	0
fam21357	2	2	2	2.0	0.0	0.0	2	2	0
fam21358	2	2	2	2.0	0.0	0.0	2	2	0
fam21359	2	2	2	2.0	0.0	0.0	2	2	0
fam21360	2	2	2	2.0	0.0	0.0	2	2	0
fam21361	2	2	2	2.0	0.0	0.0	2	2	0
fam21362	2	2	2	2.0	0.0	0.0	2	2	0
fam21363	2	2	2	2.0	0.0	0.0	2	2	0
fam21364	2	2	2	2.0	0.0	0.0	2	2	0
fam21365	2	2	2	2.0	0.0	0.0	2	2	0
fam21366	2	2	2	2.0	0.0	0.0	2	2	0
fam21367	2	2	2	2.0	0.0	0.0	2	2	0
fam21368	2	2	2	2.0	0.0	0.0	2	2	0
fam21369	2	2	2	2.0	0.0	0.0	2	2	0
fam21370	2	2	2	2.0	0.0	0.0	2	2	0
fam21371	2	2	2	2.0	0.0	0.0	2	2	0
fam21372	2	2	2	2.0	0.0	0.0	2	2	0
fam21373	2	2	2	2.0	0.0	0.0	2	2	0
fam21374	2	2	2	2.0	0.0	0.0	2	2	0
fam21375	2	2	2	2.0	0.0	0.0	2	2	0
fam21376	2	2	2	2.0	0.0	0.0	2	2	0
fam21377	2	2	2	2.0	0.0	0.0	2	2	0
fam21378	2	2	2	2.0	0.0	0.0	2	2	0
fam21379	2	2	2	2.0	0.0	0.0	2	2	0
fam21380	2	2	2	2.0	0.0	0.0	2	2	0
fam21381	2	2	2	2.0	0.0	0.0	2	2	0
fam21382	2	2	2	2.0	0.0	0.0	2	2	0
fam21383	2	2	2	2.0	0.0	0.0	2	2	0
fam21384	2	2	2	2.0	0.0	0.0	2	2	0
fam21385	2	2	2	2.0	0.0	0.0	2	2	0
fam21386	2	2	2	2.0	0.0	0.0	2	2	0
fam21387	2	2	2	2.0	0.0	0.0	2	2	0
fam21388	2	2	2	2.0	0.0	0.0	2	2	0
fam21389	2	2	2	2.0	0.0	0.0	2	2	0
fam21390	2	2	2	2.0	0.0	0.0	2	2	0
fam21391	2	2	2	2.0	0.0	0.0	2	2	0
fam21392	2	2	2	2.0	0.0	0.0	2	2	0
fam21393	2	2	2	2.0	0.0	0.0	2	2	0
fam21394	2	2	2	2.0	0.0	0.0	2	2	0
fam21395	2	2	2	2.0	0.0	0.0	2	2	0
fam21396	2	2	2	2.0	0.0	0.0	2	2	0
fam21397	2	2	2	2.0	0.0	0.0	2	2	0
fam21398	2	2	2	2.0	0.0	0.0	2	2	0
fam21399	2	2	2	2.0	0.0	0.0	2	2	0
fam21400	2	2	2	2.0	0.0	0.0	2	2	0
fam21401	2	2	2	2.0	0.0	0.0	2	2	0
fam21402	2	2	2	2.0	0.0	0.0	2	2	0
fam21403	2	2	2	2.0	0.0	0.0	2	2	0
fam21404	2	2	2	2.0	0.0	0.0	2	2	0
fam21405	2	2	2	2.0	0.0	0.0	2	2	0
fam21406	2	2	2	2.0	0.0	0.0	2	2	0
fam21407	2	2	2	2.0	0.0	0.0	2	2	0
fam21408	2	2	2	2.0	0.0	0.0	2	2	0
fam21409	2	2	2	2.0	0.0	0.0	2	2	0
fam21410	2	2	2	2.0	0.0	0.0	2	2	0
fam21411	2	2	2	2.0	0.0	0.0	2	2	0
fam21412	2	2	2	2.0	0.0	0.0	2	2	0
fam21413	2	2	2	2.0	0.0	0.0	2	2	0
fam21414	2	2	2	2.0	0.0	0.0	2	2	0
fam21415	2	2	2	2.0	0.0	0.0	2	2	0
fam21416	2	2	2	2.0	0.0	0.0	2	2	0
fam21417	2	2	2	2.0	0.0	0.0	2	2	0
fam21418	2	2	2	2.0	0.0	0.0	2	2	0
fam21419	2	2	2	2.0	0.0	0.0	2	2	0
fam21420	2	2	2	2.0	0.0	0.0	2	2	0
fam21421	2	2	2	2.0	0.0	0.0	2	2	0
fam21422	2	2	2	2.0	0.0	0.0	2	2	0
fam21423	2	2	2	2.0	0.0	0.0	2	2	0
fam21424	2	2	2	2.0	0.0	0.0	2	2	0
fam21425	2	2	2	2.0	0.0	0.0	2	2	0
fam21426	2	2	2	2.0	0.0	0.0	2	2	0
fam21427	2	2	2	2.0	0.0	0.0	2	2	0
fam21428	2	2	2	2.0	0.0	0.0	2	2	0
fam21429	2	2	2	2.0	0.0	0.0	2	2	0
fam21430	2	2	2	2.0	0.0	0.0	2	2	0
fam21431	2	2	2	2.0	0.0	0.0	2	2	0
fam21432	2	2	2	2.0	0.0	0.0	2	2	0
fam21433	2	2	2	2.0	0.0	0.0	2	2	0
fam21434	2	2	2	2.0	0.0	0.0	2	2	0
fam21435	2	2	2	2.0	0.0	0.0	2	2	0
fam21436	2	2	2	2.0	0.0	0.0	2	2	0
fam21437	2	2	2	2.0	0.0	0.0	2	2	0
fam21438	2	2	2	2.0	0.0	0.0	2	2	0
fam21439	2	2	2	2.0	0.0	0.0	2	2	0
fam21440	2	2	2	2.0	0.0	0.0	2	2	0
fam21441	2	2	2	2.0	0.0	0.0	2	2	0
fam21442	2	2	2	2.0	0.0	0.0	2	2	0
fam21443	2	2	2	2.0	0.0	0.0	2	2	0
fam21444	2	2	2	2.0	0.0	0.0	2	2	0
fam21445	2	2	2	2.0	0.0	0.0	2	2	0
fam21446	2	2	2	2.0	0.0	0.0	2	2	0
fam21447	2	2	2	2.0	0.0	0.0	2	2	0
fam21448	2	2	2	2.0	0.0	0.0	2	2	0
fam21449	2	2	2	2.0	0.0	0.0	2	2	0
fam21450	2	2	2	2.0	0.0	0.0	2	2	0
fam21451	2	2	2	2.0	0.0	0.0	2	2	0
fam21452	2	2	2	2.0	0.0	0.0	2	2	0
fam21453	2	2	2	2.0	0.0	0.0	2	2	0
fam21454	2	2	2	2.0	0.0	0.0	2	2	0
fam21455	2	2	2	2.0	0.0	0.0	2	2	0
fam21456	2	2	2	2.0	0.0	0.0	2	2	0
fam21457	2	2	2	2.0	0.0	0.0	2	2	0
fam21458	2	2	2	2.0	0.0	0.0	2	2	0
fam21459	2	2	2	2.0	0.0	0.0	2	2	0
fam21460	2	2	2	2.0	0.0	0.0	2	2	0
fam21461	2	2	2	2.0	0.0	0.0	2	2	0
fam21462	2	2	2	2.0	0.0	0.0	2	2	0
fam21463	2	2	2	2.0	0.0	0.0	2	2	0
fam21464	2	2	2	2.0	0.0	0.0	2	2	0
fam21465	2	2	2	2.0	0.0	0.0	2	2	0
fam21466	2	2	2	2.0	0.0	0.0	2	2	0
fam21467	2	2	2	2.0	0.0	0.0	2	2	0
fam21468	2	2	2	2.0	0.0	0.0	2	2	0
fam21469	2	2	2	2.0	0.0	0.0	2	2	0
fam21470	2	2	2	2.0	0.0	0.0	2	2	0
fam21471	2	2	2	2.0	0.0	0.0	2	2	0
fam21472	2	2	2	2.0	0.0	0.0	2	2	0
fam21473	2	2	2	2.0	0.0	0.0	2	2	0
fam21474	2	2	2	2.0	0.0	0.0	2	2	0
fam21475	2	2	2	2.0	0.0	0.0	2	2	0
fam21476	2	2	2	2.0	0.0	0.0	2	2	0
fam21477	2	2	2	2.0	0.0	0.0	2	2	0
fam21478	2	2	2	2.0	0.0	0.0	2	2	0
fam21479	2	2	2	2.0	0.0	0.0	2	2	0
fam21480	2	2	2	2.0	0.0	0.0	2	2	0
fam21481	2	2	2	2.0	0.0	0.0	2	2	0
fam21482	2	2	2	2.0	0.0	0.0	2	2	0
fam21483	2	2	2	2.0	0.0	0.0	2	2	0
fam21484	2	2	2	2.0	0.0	0.0	2	2	0
fam21485	2	2	2	2.0	0.0	0.0	2	2	0
fam21486	2	2	2	2.0	0.0	0.0	2	2	0
fam21487	2	2	2	2.0	0.0	0.0	2	2	0
fam21488	2	2	2	2.0	0.0	0.0	2	2	0
fam21489	2	2	2	2.0	0.0	0.0	2	2	0
fam21490	2	2	2	2.0	0.0	0.0	2	2	0
fam21491	2	2	2	2.0	0.0	0.0	2	2	0
fam21492	2	2	2	2.0	0.0	0.0	2	2	0
fam21493	2	2	2	2.0	0.0	0.0	2	2	0
fam21494	2	2	2	2.0	0.0	0.0	2	2	0
fam21495	2	2	2	2.0	0.0	0.0	2	2	0
fam21496	2	2	2	2.0	0.0	0.0	2	2	0
fam21497	2	2	2	2.0	0.0	0.0	2	2	0
fam21498	2	2	2	2.0	0.0	0.0	2	2	0
fam21499	2	2	2	2.0	0.0	0.0	2	2	0
fam21500	2	2	2	2.0	0.0	0.0	2	2	0
fam21501	2	2	2	2.0	0.0	0.0	2	2	0
fam21502	2	2	2	2.0	0.0	0.0	2	2	0
fam21503	2	2	2	2.0	0.0	0.0	2	2	0
fam21504	2	2	2	2.0	0.0	0.0	2	2	0
fam21505	2	2	2	2.0	0.0	0.0	2	2	0
fam21506	2	2	2	2.0	0.0	0.0	2	2	0
fam21507	2	2	2	2.0	0.0	0.0	2	2	0
fam21508	2	2	2	2.0	0.0	0.0	2	2	0
fam21509	2	2	2	2.0	0.0	0.0	2	2	0
fam21510	2	2	2	2.0	0.0	0.0	2	2	0
fam21511	2	2	2	2.0	0.0	0.0	2	2	0
fam21512	2	2	2	2.0	0.0	0.0	2	2	0
fam21513	2	2	2	2.0	0.0	0.0	2	2	0
fam21514	2	2	2	2.0	0.0	0.0	2	2	0
fam21515	2	2	2	2.0	0.0	0.0	2	2	0
fam21516	2	2	2	2.0	0.0	0.0	2	2	0
fam21517	2	2	2	2.0	0.0	0.0	2	2	0
fam21518	2	2	2	2.0	0.0	0.0	2	2	0
fam21519	2	2	2	2.0	0.0	0.0	2	2	0
fam21520	2	2	2	2.0	0.0	0.0	2	2	0
fam21521	2	2	2	2.0	0.0	0.0	2	2	0
fam21522	2	2	2	2.0	0.0	0.0	2	2	0
fam21523	2	2	2	2.0	0.0	0.0	2	2	0
fam21524	2	2	2	2.0	0.0	0.0	2	2	0
fam21525	2	2	2	2.0	0.0	0.0	2	2	0
fam21526	2	2	2	2.0	0.0	0.0	2	2	0
fam21527	2	2	2	2.0	0.0	0.0	2	2	0
fam21528	2	2	2	2.0	0.0	0.0	2	2	0
fam21529	2	2	2	2.0	0.0	0.0	2	2	0
fam21530	2	2	2	2.0	0.0	0.0	2	2	0
fam21531	2	2	2	2.0	0.0	0.0	2	2	0
fam21532	2	2	2	2.0	0.0	0.0	2	2	0
fam21533	2	2	2	2.0	0.0	0.0	2	2	0
fam21534	2	2	2	2.0	0.0	0.0	2	2	0
fam21535	2	2	2	2.0	0.0	0.0	2	2	0
fam21536	2	2	2	2.0	0.0	0.0	2	2	0
fam21537	2	2	2	2.0	0.0	0.0	2	2	0
fam21538	2	2	2	2.0	0.0	0.0	2	2	0
fam21539	2	2	2	2.0	0.0	0.0	2	2	0
fam21540	2	2	2	2.0	0.0	0.0	2	2	0
fam21541	2	2	2	2.0	0.0	0.0	2	2	0
fam21542	2	2	2	2.0	0.0	0.0	2	2	0
fam21543	2	2	2	2.0	0.0	0.0	2	2	0
fam21544	2	2	2	2.0	0.0	0.0	2	2	0
fam21545	2	2	2	2.0	0.0	0.0	2	2	0
fam21546	2	2	2	2.0	0.0	0.0	2	2	0
fam21547	2	2	2	2.0	0.0	0.0	2	2	0
fam21548	2	2	2	2.0	0.0	0.0	2	2	0
fam21549	2	2	2	2.0	0.0	0.0	2	2	0
fam21550	2	2	2	2.0	0.0	0.0	2	2	0
fam21551	2	2	2	2.0	0.0	0.0	2	2	0
fam21552	2	2	2	2.0	0.0	0.0	2	2	0
fam21553	2	2	2	2.0	0.0	0.0	2	2	0
fam21554	2	2	2	2.0	0.0	0.0	2	2	0
fam21555	2	2	2	2.0	0.0	0.0	2	2	0
fam21556	2	2	2	2.0	0.0	0.0	2	2	0
fam21557	2	2	2	2.0	0.0	0.0	2	2	0
fam21558	2	2	2	2.0	0.0	0.0	2	2	0
fam21559	2	2	2	2.0	0.0	0.0	2	2	0
fam21560	2	2	2	2.0	0.0	0.0	2	2	0
fam21561	2	2	2	2.0	0.0	0.0	2	2	0
fam21562	2	2	2	2.0	0.0	0.0	2	2	0
fam21563	2	2	2	2.0	0.0	0.0	2	2	0
fam21564	2	2	2	2.0	0.0	0.0	2	2	0
fam21565	2	2	2	2.0	0.0	0.0	2	2	0
fam21566	2	2	2	2.0	0.0	0.0	2	2	0
fam21567	2	2	2	2.0	0.0	0.0	2	2	0
fam21568	2	2	2	2.0	0.0	0.0	2	2	0
fam21569	2	2	2	2.0	0.0	0.0	2	2	0
fam21570	2	2	2	2.0	0.0	0.0	2	2	0
fam21571	2	2	2	2.0	0.0	0.0	2	2	0
fam21572	2	2	2	2.0	0.0	0.0	2	2	0
fam21573	2	2	2	2.0	0.0	0.0	2	2	0
fam21574	2	2	2	2.0	0.0	0.0	2	2	0
fam21575	2	2	2	2.0	0.0	0.0	2	2	0
fam21576	2	2	2	2.0	0.0	0.0	2	2	0
fam21577	2	2	2	2.0	0.0	0.0	2	2	0
fam21578	2	2	2	2.0	0.0	0.0	2	2	0
fam21579	2	2	2	2.0	0.0	0.0	2	2	0
fam21580	2	2	2	2.0	0.0	0.0	2	2	0
fam21581	2	2	2	2.0	0.0	0.0	2	2	0
fam21582	2	2	2	2.0	0.0	0.0	2	2	0
fam21583	2	2	2	2.0	0.0	0.0	2	2	0
fam21584	2	2	2	2.0	0.0	0.0	2	2	0
fam21585	2	2	2	2.0	0.0	0.0	2	2	0
fam21586	2	2	2	2.0	0.0	0.0	2	2	0
fam21587	2	2	2	2.0	0.0	0.0	2	2	0
fam21588	2	2	2	2.0	0.0	0.0	2	2	0
fam21589	2	2	2	2.0	0.0	0.0	2	2	0
fam21590	2	2	2	2.0	0.0	0.0	2	2	0
fam21591	2	2	2	2.0	0.0	0.0	2	2	0
fam21592	2	2	2	2.0	0.0	0.0	2	2	0
fam21593	2	2	2	2.0	0.0	0.0	2	2	0
fam21594	2	2	2	2.0	0.0	0.0	2	2	0
fam21595	2	2	2	2.0	0.0	0.0	2	2	0
fam21596	2	2	2	2.0	0.0	0.0	2	2	0
fam21597	2	2	2	2.0	0.0	0.0	2	2	0
fam21598	2	2	2	2.0	0.0	0.0	2	2	0
fam21599	2	2	2	2.0	0.0	0.0	2	2	0
fam21600	2	2	2	2.0	0.0	0.0	2	2	0
fam21601	2	2	2	2.0	0.0	0.0	2	2	0
fam21602	2	2	2	2.0	0.0	0.0	2	2	0
fam21603	2	2	2	2.0	0.0	0.0	2	2	0
fam21604	2	2	2	2.0	0.0	0.0	2	2	0
fam21605	2	2	2	2.0	0.0	0.0	2	2	0
fam21606	2	2	2	2.0	0.0	0.0	2	2	0
fam21607	2	2	2	2.0	0.0	0.0	2	2	0
fam21608	2	2	2	2.0	0.0	0.0	2	2	0
fam21609	2	2	2	2.0	0.0	0.0	2	2	0
fam21610	2	2	2	2.0	0.0	0.0	2	2	0
fam21611	2	2	2	2.0	0.0	0.0	2	2	0
fam21612	2	2	2	2.0	0.0	0.0	2	2	0
fam21613	2	2	2	2.0	0.0	0.0	2	2	0
fam21614	2	2	2	2.0	0.0	0.0	2	2	0
fam21615	2	2	2	2.0	0.0	0.0	2	2	0
fam21616	2	2	2	2.0	0.0	0.0	2	2	0
fam21617	2	2	2	2.0	0.0	0.0	2	2	0
fam21618	2	2	2	2.0	0.0	0.0	2	2	0
fam21619	2	2	2	2.0	0.0	0.0	2	2	0
fam21620	2	2	2	2.0	0.0	0.0	2	2	0
fam21621	2	2	2	2.0	0.0	0.0	2	2	0
fam21622	2	2	2	2.0	0.0	0.0	2	2	0
fam21623	2	2	2	2.0	0.0	0.0	2	2	0
fam21624	2	2	2	2.0	0.0	0.0	2	2	0
fam21625	2	2	2	2.0	0.0	0.0	2	2	0
fam21626	2	2	2	2.0	0.0	0.0	2	2	0
fam21627	2	2	2	2.0	0.0	0.0	2	2	0
fam21628	2	2	2	2.0	0.0	0.0	2	2	0
fam21629	2	2	2	2.0	0.0	0.0	2	2	0
fam21630	2	2	2	2.0	0.0	0.0	2	2	0
fam21631	2	2	2	2.0	0.0	0.0	2	2	0
fam21632	2	2	2	2.0	0.0	0.0	2	2	0
fam21633	2	2	2	2.0	0.0	0.0	2	2	0
fam21634	2	2	2	2.0	0.0	0.0	2	2	0
fam21635	2	2	2	2.0	0.0	0.0	2	2	0
fam21636	2	2	2	2.0	0.0	0.0	2	2	0
fam21637	2	2	2	2.0	0.0	0.0	2	2	0
fam21638	2	2	2	2.0	0.0	0.0	2	2	0
fam21639	2	2	2	2.0	0.0	0.0	2	2	0
fam21640	2	2	2	2.0	0.0	0.0	2	2	0
fam21641	2	2	2	2.0	0.0	0.0	2	2	0
fam21642	2	2	2	2.0	0.0	0.0	2	2	0
fam21643	2	2	2	2.0	0.0	0.0	2	2	0
fam21644	2	2	2	2.0	0.0	0.0	2	2	0
fam21645	2	2	2	2.0	0.0	0.0	2	2	0
fam21646	2	2	2	2.0	0.0	0.0	2	2	0
fam21647	2	2	2	2.0	0.0	0.0	2	2	0
fam21648	2	2	2	2.0	0.0	0.0	2	2	0
fam21649	2	2	2	2.0	0.0	0.0	2	2	0
fam21650	2	2	2	2.0	0.0	0.0	2	2	0
fam21651	2	2	2	2.0	0.0	0.0	2	2	0
fam21652	2	2	2	2.0	0.0	0.0	2	2	0
fam21653	2	2	2	2.0	0.0	0.0	2	2	0
fam21654	2	2	2	2.0	0.0	0.0	2	2	0
fam21655	2	2	2	2.0	0.0	0.0	2	2	0
fam21656	2	2	2	2.0	0.0	0.0	2	2	0
fam21657	2	2	2	2.0	0.0	0.0	2	2	0
fam21658	2	2	2	2.0	0.0	0.0	2	2	0
fam21659	2	2	2	2.0	0.0	0.0	2	2	0
fam21660	2	2	2	2.0	0.0	0.0	2	2	0
fam21661	2	2	2	2.0	0.0	0.0	2	2	0
fam21662	2	2	2	2.0	0.0	0.0	2	2	0
fam21663	2	2	2	2.0	0.0	0.0	2	2	0
fam21664	2	2	2	2.0	0.0	0.0	2	2	0
fam21665	2	2	2	2.0	0.0	0.0	2	2	0
fam21666	2	2	2	2.0	0.0	0.0	2	2	0
fam21667	2	2	2	2.0	0.0	0.0	2	2	0
fam21668	2	2	2	2.0	0.0	0.0	2	2	0
fam21669	2	2	2	2.0	0.0	0.0	2	2	0
fam21670	2	2	2	2.0	0.0	0.0	2	2	0
fam21671	2	2	2	2.0	0.0	0.0	2	2	0
fam21672	2	2	2	2.0	0.0	0.0	2	2	0
fam21673	2	2	2	2.0	0.0	0.0	2	2	0
fam21674	2	2	2	2.0	0.0	0.0	2	2	0
fam21675	2	2	2	2.0	0.0	0.0	2	2	0
fam21676	2	2	2	2.0	0.0	0.0	2	2	0
fam21677	2	2	2	2.0	0.0	0.0	2	2	0
fam21678	2	2	2	2.0	0.0	0.0	2	2	0
fam21679	2	2	2	2.0	0.0	0.0	2	2	0
fam21680	2	2	2	2.0	0.0	0.0	2	2	0
fam21681	2	2	2	2.0	0.0	0.0	2	2	0
fam21682	2	2	2	2.0	0.0	0.0	2	2	0
fam21683	2	2	2	2.0	0.0	0.0	2	2	0
fam21684	2	2	2	2.0	0.0	0.0	2	2	0
fam21685	2	2	2	2.0	0.0	0.0	2	2	0
fam21686	2	2	2	2.0	0.0	0.0	2	2	0
fam21687	2	2	2	2.0	0.0	0.0	2	2	0
fam21688	2	2	2	2.0	0.0	0.0	2	2	0
fam21689	2	2	2	2.0	0.0	0.0	2	2	0
fam21690	2	2	2	2.0	0.0	0.0	2	2	0
fam21691	2	2	2	2.0	0.0	0.0	2	2	0
fam21692	2	2	2	2.0	0.0	0.0	2	2	0
fam21693	2	2	2	2.0	0.0	0.0	2	2	0
fam21694	2	2	2	2.0	0.0	0.0	2	2	0
fam21695	2	2	2	2.0	0.0	0.0	2	2	0
fam21696	2	2	2	2.0	0.0	0.0	2	2	0
fam21697	2	2	2	2.0	0.0	0.0	2	2	0
fam21698	2	2	2	2.0	0.0	0.0	2	2	0
fam21699	2	2	2	2.0	0.0	0.0	2	2	0
fam21700	2	2	2	2.0	0.0	0.0	2	2	0
fam21701	2	2	2	2.0	0.0	0.0	2	2	0
fam21702	2	2	2	2.0	0.0	0.0	2	2	0
fam21703	2	2	2	2.0	0.0	0.0	2	2	0
fam21704	2	2	2	2.0	0.0	0.0	2	2	0
fam21705	2	2	2	2.0	0.0	0.0	2	2	0
fam21706	2	2	2	2.0	0.0	0.0	2	2	0
fam21707	2	2	2	2.0	0.0	0.0	2	2	0
fam21708	2	2	2	2.0	0.0	0.0	2	2	0
fam21709	2	2	2	2.0	0.0	0.0	2	2	0
fam21710	2	2	2	2.0	0.0	0.0	2	2	0
fam21711	2	2	2	2.0	0.0	0.0	2	2	0
fam21712	2	2	2	2.0	0.0	0.0	2	2	0
fam21713	2	2	2	2.0	0.0	0.0	2	2	0
fam21714	2	2	2	2.0	0.0	0.0	2	2	0
fam21715	2	2	2	2.0	0.0	0.0	2	2	0
fam21716	2	2	2	2.0	0.0	0.0	2	2	0
fam21717	2	2	2	2.0	0.0	0.0	2	2	0
fam21718	2	2	2	2.0	0.0	0.0	2	2	0
fam21719	2	2	2	2.0	0.0	0.0	2	2	0
fam21720	2	2	2	2.0	0.0	0.0	2	2	0
fam21721	2	2	2	2.0	0.0	0.0	2	2	0
fam21722	2	2	2	2.0	0.0	0.0	2	2	0
fam21723	2	2	2	2.0	0.0	0.0	2	2	0
fam21724	2	2	2	2.0	0.0	0.0	2	2	0
fam21725	2	2	2	2.0	0.0	0.0	2	2	0
fam21726	2	2	2	2.0	0.0	0.0	2	2	0
fam21727	2	2	2	2.0	0.0	0.0	2	2	0
fam21728	2	2	2	2.0	0.0	0.0	2	2	0
fam21729	2	2	2	2.0	0.0	0.0	2	2	0
fam21730	2	2	2	2.0	0.0	0.0	2	2	0
fam21731	2	2	2	2.0	0.0	0.0	2	2	0
fam21732	2	2	2	2.0	0.0	0.0	2	2	0
fam21733	2	2	2	2.0	0.0	0.0	2	2	0
fam21734	2	2	2	2.0	0.0	0.0	2	2	0
fam21735	2	2	2	2.0	0.0	0.0	2	2	0
fam21736	2	2	2	2.0	0.0	0.0	2	2	0
fam21737	2	2	2	2.0	0.0	0.0	2	2	0
fam21738	2	2	2	2.0	0.0	0.0	2	2	0
fam21739	2	2	2	2.0	0.0	0.0	2	2	0
fam21740	2	2	2	2.0	0.0	0.0	2	2	0
fam21741	2	2	2	2.0	0.0	0.0	2	2	0
fam21742	2	2	2	2.0	0.0	0.0	2	2	0
fam21743	2	2	2	2.0	0.0	0.0	2	2	0
fam21744	2	2	2	2.0	0.0	0.0	2	2	0
fam21745	2	2	2	2.0	0.0	0.0	2	2	0
fam21746	2	2	2	2.0	0.0	0.0	2	2	0
fam21747	2	2	2	2.0	0.0	0.0	2	2	0
fam21748	2	2	2	2.0	0.0	0.0	2	2	0
fam21749	2	2	2	2.0	0.0	0.0	2	2	0
fam21750	2	2	2	2.0	0.0	0.0	2	2	0
fam21751	2	2	2	2.0	0.0	0.0	2	2	0
fam21752	2	2	2	2.0	0.0	0.0	2	2	0
fam21753	2	2	2	2.0	0.0	0.0	2	2	0
fam21754	2	2	2	2.0	0.0	0.0	2	2	0
fam21755	2	2	2	2.0	0.0	0.0	2	2	0
fam21756	2	2	2	2.0	0.0	0.0	2	2	0
fam21757	2	2	2	2.0	0.0	0.0	2	2	0
fam21758	2	2	2	2.0	0.0	0.0	2	2	0
fam21759	2	2	2	2.0	0.0	0.0	2	2	0
fam21760	2	2	2	2.0	0.0	0.0	2	2	0
fam21761	2	2	2	2.0	0.0	0.0	2	2	0
fam21762	2	2	2	2.0	0.0	0.0	2	2	0
fam21763	2	2	2	2.0	0.0	0.0	2	2	0
fam21764	2	2	2	2.0	0.0	0.0	2	2	0
fam21765	2	2	2	2.0	0.0	0.0	2	2	0
fam21766	2	2	2	2.0	0.0	0.0	2	2	0
fam21767	2	2	2	2.0	0.0	0.0	2	2	0
fam21768	2	2	2	2.0	0.0	0.0	2	2	0
fam21769	2	2	2	2.0	0.0	0.0	2	2	0
fam21770	2	2	2	2.0	0.0	0.0	2	2	0
fam21771	2	2	2	2.0	0.0	0.0	2	2	0
fam21772	2	2	2	2.0	0.0	0.0	2	2	0
fam21773	2	2	2	2.0	0.0	0.0	2	2	0
fam21774	2	2	2	2.0	0.0	0.0	2	2	0
fam21775	2	2	2	2.0	0.0	0.0	2	2	0
fam21776	2	2	2	2.0	0.0	0.0	2	2	0
fam21777	2	2	2	2.0	0.0	0.0	2	2	0
fam21778	2	2	2	2.0	0.0	0.0	2	2	0
fam21779	2	2	2	2.0	0.0	0.0	2	2	0
fam21780	2	2	2	2.0	0.0	0.0	2	2	0
fam21781	2	2	2	2.0	0.0	0.0	2	2	0
fam21782	2	2	2	2.0	0.0	0.0	2	2	0
fam21783	2	2	2	2.0	0.0	0.0	2	2	0
fam21784	2	2	2	2.0	0.0	0.0	2	2	0
fam21785	2	2	2	2.0	0.0	0.0	2	2	0
fam21786	2	2	2	2.0	0.0	0.0	2	2	0
fam21787	2	2	2	2.0	0.0	0.0	2	2	0
fam21788	2	2	2	2.0	0.0	0.0	2	2	0
fam21789	2	2	2	2.0	0.0	0.0	2	2	0
fam21790	2	2	2	2.0	0.0	0.0	2	2	0
fam21791	2	2	2	2.0	0.0	0.0	2	2	0
fam21792	2	2	2	2.0	0.0	0.0	2	2	0
fam21793	2	2	2	2.0	0.0	0.0	2	2	0
fam21794	2	2	2	2.0	0.0	0.0	2	2	0
fam21795	2	2	2	2.0	0.0	0.0	2	2	0
fam21796	2	2	2	2.0	0.0	0.0	2	2	0
fam21797	2	2	2	2.0	0.0	0.0	2	2	0
fam21798	2	2	2	2.0	0.0	0.0	2	2	0
fam21799	2	2	2	2.0	0.0	0.0	2	2	0
fam21800	2	2	2	2.0	0.0	0.0	2	2	0
fam21801	2	2	2	2.0	0.0	0.0	2	2	0
fam21802	2	2	2	2.0	0.0	0.0	2	2	0
fam21803	2	2	2	2.0	0.0	0.0	2	2	0
fam21804	2	2	2	2.0	0.0	0.0	2	2	0
fam21805	2	2	2	2.0	0.0	0.0	2	2	0
fam21806	2	2	2	2.0	0.0	0.0	2	2	0
fam21807	2	2	2	2.0	0.0	0.0	2	2	0
fam21808	2	2	2	2.0	0.0	0.0	2	2	0
fam21809	2	2	2	2.0	0.0	0.0	2	2	0
fam21810	2	2	2	2.0	0.0	0.0	2	2	0
fam21811	2	2	2	2.0	0.0	0.0	2	2	0
fam21812	2	2	2	2.0	0.0	0.0	2	2	0
fam21813	2	2	2	2.0	0.0	0.0	2	2	0
fam21814	2	2	2	2.0	0.0	0.0	2	2	0
fam21815	2	2	2	2.0	0.0	0.0	2	2	0
fam21816	2	2	2	2.0	0.0	0.0	2	2	0
fam21817	2	2	2	2.0	0.0	0.0	2	2	0
fam21818	2	2	2	2.0	0.0	0.0	2	2	0
fam21819	2	2	2	2.0	0.0	0.0	2	2	0
fam21820	2	2	2	2.0	0.0	0.0	2	2	0
fam21821	2	2	2	2.0	0.0	0.0	2	2	0
fam21822	2	2	2	2.0	0.0	0.0	2	2	0
fam21823	2	2	2	2.0	0.0	0.0	2	2	0
fam21824	2	2	2	2.0	0.0	0.0	2	2	0
fam21825	2	2	2	2.0	0.0	0.0	2	2	0
fam21826	2	2	2	2.0	0.0	0.0	2	2	0
fam21827	2	2	2	2.0	0.0	0.0	2	2	0
fam21828	2	2	2	2.0	0.0	0.0	2	2	0
fam21829	2	2	2	2.0	0.0	0.0	2	2	0
fam21830	2	2	2	2.0	0.0	0.0	2	2	0
fam21831	2	2	2	2.0	0.0	0.0	2	2	0
fam21832	2	2	2	2.0	0.0	0.0	2	2	0
fam21833	2	2	2	2.0	0.0	0.0	2	2	0
fam21834	2	2	2	2.0	0.0	0.0	2	2	0
fam21835	2	2	2	2.0	0.0	0.0	2	2	0
fam21836	2	2	2	2.0	0.0	0.0	2	2	0
fam21837	2	2	2	2.0	0.0	0.0	2	2	0
fam21838	2	2	2	2.0	0.0	0.0	2	2	0
fam21839	2	2	2	2.0	0.0	0.0	2	2	0
fam21840	2	2	2	2.0	0.0	0.0	2	2	0
fam21841	2	2	2	2.0	0.0	0.0	2	2	0
fam21842	2	2	2	2.0	0.0	0.0	2	2	0
fam21843	2	2	2	2.0	0.0	0.0	2	2	0
fam21844	2	2	2	2.0	0.0	0.0	2	2	0
fam21845	2	2	2	2.0	0.0	0.0	2	2	0
fam21846	2	2	2	2.0	0.0	0.0	2	2	0
fam21847	2	2	2	2.0	0.0	0.0	2	2	0
fam21848	2	2	2	2.0	0.0	0.0	2	2	0
fam21849	2	2	2	2.0	0.0	0.0	2	2	0
fam21850	2	2	2	2.0	0.0	0.0	2	2	0
fam21851	2	2	2	2.0	0.0	0.0	2	2	0
fam21852	2	2	2	2.0	0.0	0.0	2	2	0
fam21853	2	2	2	2.0	0.0	0.0	2	2	0
fam21854	2	2	2	2.0	0.0	0.0	2	2	0
fam21855	2	2	2	2.0	0.0	0.0	2	2	0
fam21856	2	2	2	2.0	0.0	0.0	2	2	0
fam21857	2	2	2	2.0	0.0	0.0	2	2	0
fam21858	2	2	2	2.0	0.0	0.0	2	2	0
fam21859	2	2	2	2.0	0.0	0.0	2	2	0
fam21860	2	2	2	2.0	0.0	0.0	2	2	0
fam21861	2	2	2	2.0	0.0	0.0	2	2	0
fam21862	2	2	2	2.0	0.0	0.0	2	2	0
fam21863	2	2	2	2.0	0.0	0.0	2	2	0
fam21864	2	2	2	2.0	0.0	0.0	2	2	0
fam21865	2	2	2	2.0	0.0	0.0	2	2	0
fam21866	2	2	2	2.0	0.0	0.0	2	2	0
fam21867	2	2	2	2.0	0.0	0.0	2	2	0
fam21868	2	2	2	2.0	0.0	0.0	2	2	0
fam21869	2	2	2	2.0	0.0	0.0	2	2	0
fam21870	2	2	2	2.0	0.0	0.0	2	2	0
fam21871	2	2	2	2.0	0.0	0.0	2	2	0
fam21872	2	2	2	2.0	0.0	0.0	2	2	0
fam21873	2	2	2	2.0	0.0	0.0	2	2	0
fam21874	2	2	2	2.0	0.0	0.0	2	2	0
fam21875	2	2	2	2.0	0.0	0.0	2	2	0
fam21876	2	2	2	2.0	0.0	0.0	2	2	0
fam21877	2	2	2	2.0	0.0	0.0	2	2	0
fam21878	2	2	2	2.0	0.0	0.0	2	2	0
fam21879	2	2	2	2.0	0.0	0.0	2	2	0
fam21880	2	2	2	2.0	0.0	0.0	2	2	0
fam21881	2	2	2	2.0	0.0	0.0	2	2	0
fam21882	2	2	2	2.0	0.0	0.0	2	2	0
fam21883	2	2	2	2.0	0.0	0.0	2	2	0
fam21884	2	2	2	2.0	0.0	0.0	2	2	0
fam21885	2	2	2	2.0	0.0	0.0	2	2	0
fam21886	2	2	2	2.0	0.0	0.0	2	2	0
fam21887	2	2	2	2.0	0.0	0.0	2	2	0
fam21888	2	2	2	2.0	0.0	0.0	2	2	0
fam21889	2	2	2	2.0	0.0	0.0	2	2	0
fam21890	2	2	2	2.0	0.0	0.0	2	2	0
fam21891	2	2	2	2.0	0.0	0.0	2	2	0
fam21892	2	2	2	2.0	0.0	0.0	2	2	0
fam21893	2	2	2	2.0	0.0	0.0	2	2	0
fam21894	2	2	2	2.0	0.0	0.0	2	2	0
fam21895	2	2	2	2.0	0.0	0.0	2	2	0
fam21896	2	2	2	2.0	0.0	0.0	2	2	0
fam21897	2	2	2	2.0	0.0	0.0	2	2	0
fam21898	2	2	2	2.0	0.0	0.0	2	2	0
fam21899	2	2	2	2.0	0.0	0.0	2	2	0
fam21900	2	2	2	2.0	0.0	0.0	2	2	0
fam21901	2	2	2	2.0	0.0	0.0	2	2	0
fam21902	2	2	2	2.0	0.0	0.0	2	2	0
fam21903	2	2	2	2.0	0.0	0.0	2	2	0
fam21904	2	2	2	2.0	0.0	0.0	2	2	0
fam21905	2	2	2	2.0	0.0	0.0	2	2	0
fam21906	2	2	2	2.0	0.0	0.0	2	2	0
fam21907	2	2	2	2.0	0.0	0.0	2	2	0
fam21908	2	2	2	2.0	0.0	0.0	2	2	0
fam21909	2	2	2	2.0	0.0	0.0	2	2	0
fam21910	2	2	2	2.0	0.0	0.0	2	2	0
fam21911	2	2	2	2.0	0.0	0.0	2	2	0
fam21912	2	2	2	2.0	0.0	0.0	2	2	0
fam21913	2	2	2	2.0	0.0	0.0	2	2	0
fam21914	2	2	2	2.0	0.0	0.0	2	2	0
fam21915	2	2	2	2.0	0.0	0.0	2	2	0
fam21916	2	2	2	2.0	0.0	0.0	2	2	0
fam21917	2	2	2	2.0	0.0	0.0	2	2	0
fam21918	2	2	2	2.0	0.0	0.0	2	2	0
fam21919	2	2	2	2.0	0.0	0.0	2	2	0
fam21920	2	2	2	2.0	0.0	0.0	2	2	0
fam21921	2	2	2	2.0	0.0	0.0	2	2	0
fam21922	2	2	2	2.0	0.0	0.0	2	2	0
fam21923	2	2	2	2.0	0.0	0.0	2	2	0
fam21924	2	2	2	2.0	0.0	0.0	2	2	0
fam21925	2	2	2	2.0	0.0	0.0	2	2	0
fam21926	2	2	2	2.0	0.0	0.0	2	2	0
fam21927	2	2	2	2.0	0.0	0.0	2	2	0
fam21928	2	2	2	2.0	0.0	0.0	2	2	0
fam21929	2	2	2	2.0	0.0	0.0	2	2	0
fam21930	2	2	2	2.0	0.0	0.0	2	2	0
fam21931	2	2	2	2.0	0.0	0.0	2	2	0
fam21932	2	2	2	2.0	0.0	0.0	2	2	0
fam21933	2	2	2	2.0	0.0	0.0	2	2	0
fam21934	2	2	2	2.0	0.0	0.0	2	2	0
fam21935	2	2	2	2.0	0.0	0.0	2	2	0
fam21936	2	2	2	2.0	0.0	0.0	2	2	0
fam21937	2	2	2	2.0	0.0	0.0	2	2	0
fam21938	2	2	2	2.0	0.0	0.0	2	2	0
fam21939	2	2	2	2.0	0.0	0.0	2	2	0
fam21940	2	2	2	2.0	0.0	0.0	2	2	0
fam21941	2	2	2	2.0	0.0	0.0	2	2	0
fam21942	2	2	2	2.0	0.0	0.0	2	2	0
fam21943	2	2	2	2.0	0.0	0.0	2	2	0
fam21944	2	2	2	2.0	0.0	0.0	2	2	0
fam21945	2	2	2	2.0	0.0	0.0	2	2	0
fam21946	2	2	2	2.0	0.0	0.0	2	2	0
fam21947	2	2	2	2.0	0.0	0.0	2	2	0
fam21948	2	2	2	2.0	0.0	0.0	2	2	0
fam21949	2	2	2	2.0	0.0	0.0	2	2	0
fam21950	2	2	2	2.0	0.0	0.0	2	2	0
fam21951	2	2	2	2.0	0.0	0.0	2	2	0
fam21952	2	2	2	2.0	0.0	0.0	2	2	0
fam21953	2	2	2	2.0	0.0	0.0	2	2	0
fam21954	2	2	2	2.0	0.0	0.0	2	2	0
fam21955	2	2	2	2.0	0.0	0.0	2	2	0
fam21956	2	2	2	2.0	0.0	0.0	2	2	0
fam21957	2	2	2	2.0	0.0	0.0	2	2	0
fam21958	2	2	2	2.0	0.0	0.0	2	2	0
fam21959	2	2	2	2.0	0.0	0.0	2	2	0
fam21960	2	2	2	2.0	0.0	0.0	2	2	0
fam21961	2	2	2	2.0	0.0	0.0	2	2	0
fam21962	2	2	2	2.0	0.0	0.0	2	2	0
fam21963	2	2	2	2.0	0.0	0.0	2	2	0
fam21964	2	2	2	2.0	0.0	0.0	2	2	0
fam21965	2	2	2	2.0	0.0	0.0	2	2	0
fam21966	2	2	2	2.0	0.0	0.0	2	2	0
fam21967	2	2	2	2.0	0.0	0.0	2	2	0
fam21968	2	2	2	2.0	0.0	0.0	2	2	0
fam21969	2	2	2	2.0	0.0	0.0	2	2	0
fam21970	2	2	2	2.0	0.0	0.0	2	2	0
fam21971	2	2	2	2.0	0.0	0.0	2	2	0
fam21972	2	2	2	2.0	0.0	0.0	2	2	0
fam21973	2	2	2	2.0	0.0	0.0	2	2	0
fam21974	2	2	2	2.0	0.0	0.0	2	2	0
fam21975	2	2	2	2.0	0.0	0.0	2	2	0
fam21976	2	2	2	2.0	0.0	0.0	2	2	0
fam21977	2	2	2	2.0	0.0	0.0	2	2	0
fam21978	2	2	2	2.0	0.0	0.0	2	2	0
fam21979	2	2	2	2.0	0.0	0.0	2	2	0
fam21980	2	2	2	2.0	0.0	0.0	2	2	0
fam21981	2	2	2	2.0	0.0	0.0	2	2	0
fam21982	2	2	2	2.0	0.0	0.0	2	2	0
fam21983	2	2	2	2.0	0.0	0.0	2	2	0
fam21984	2	2	2	2.0	0.0	0.0	2	2	0
fam21985	2	2	2	2.0	0.0	0.0	2	2	0
fam21986	2	2	2	2.0	0.0	0.0	2	2	0
fam21987	2	2	2	2.0	0.0	0.0	2	2	0
fam21988	2	2	2	2.0	0.0	0.0	2	2	0
fam21989	2	2	2	2.0	0.0	0.0	2	2	0
fam21990	2	2	2	2.0	0.0	0.0	2	2	0
fam21991	2	2	2	2.0	0.0	0.0	2	2	0
fam21992	2	2	2	2.0	0.0	0.0	2	2	0
fam21993	2	2	2	2.0	0.0	0.0	2	2	0
fam21994	2	2	2	2.0	0.0	0.0	2	2	0
fam21995	2	2	2	2.0	0.0	0.0	2	2	0
fam21996	2	2	2	2.0	0.0	0.0	2	2	0
fam21997	2	2	2	2.0	0.0	0.0	2	2	0
fam21998	2	2	2	2.0	0.0	0.0	2	2	0
fam21999	2	2	2	2.0	0.0	0.0	2	2	0
fam22000	2	2	2	2.0	0.0	0.0	2	2	0
fam22001	2	2	2	2.0	0.0	0.0	2	2	0
fam22002	2	2	2	2.0	0.0	0.0	2	2	0
fam22003	2	2	2	2.0	0.0	0.0	2	2	0
fam22004	2	2	2	2.0	0.0	0.0	2	2	0
fam22005	2	2	2	2.0	0.0	0.0	2	2	0
fam22006	2	2	2	2.0	0.0	0.0	2	2	0
fam22007	2	2	2	2.0	0.0	0.0	2	2	0
fam22008	2	2	2	2.0	0.0	0.0	2	2	0
fam22009	2	2	2	2.0	0.0	0.0	2	2	0
fam22010	2	2	2	2.0	0.0	0.0	2	2	0
fam22011	2	2	2	2.0	0.0	0.0	2	2	0
fam22012	2	2	2	2.0	0.0	0.0	2	2	0
fam22013	2	2	2	2.0	0.0	0.0	2	2	0
fam22014	2	2	2	2.0	0.0	0.0	2	2	0
fam22015	2	2	2	2.0	0.0	0.0	2	2	0
fam22016	2	2	2	2.0	0.0	0.0	2	2	0
fam22017	2	2	2	2.0	0.0	0.0	2	2	0
fam22018	2	2	2	2.0	0.0	0.0	2	2	0
fam22019	2	2	2	2.0	0.0	0.0	2	2	0
fam22020	2	2	2	2.0	0.0	0.0	2	2	0
fam22021	2	2	2	2.0	0.0	0.0	2	2	0
fam22022	2	2	2	2.0	0.0	0.0	2	2	0
fam22023	2	2	2	2.0	0.0	0.0	2	2	0
fam22024	2	2	2	2.0	0.0	0.0	2	2	0
fam22025	2	2	2	2.0	0.0	0.0	2	2	0
fam22026	2	2	2	2.0	0.0	0.0	2	2	0
fam22027	2	2	2	2.0	0.0	0.0	2	2	0
fam22028	2	2	2	2.0	0.0	0.0	2	2	0
fam22029	2	2	2	2.0	0.0	0.0	2	2	0
fam22030	2	2	2	2.0	0.0	0.0	2	2	0
fam22031	2	2	2	2.0	0.0	0.0	2	2	0
fam22032	2	2	2	2.0	0.0	0.0	2	2	0
fam22033	2	2	2	2.0	0.0	0.0	2	2	0
fam22034	2	2	2	2.0	0.0	0.0	2	2	0
fam22035	2	2	2	2.0	0.0	0.0	2	2	0
fam22036	2	2	2	2.0	0.0	0.0	2	2	0
fam22037	2	2	2	2.0	0.0	0.0	2	2	0
fam22038	2	2	2	2.0	0.0	0.0	2	2	0
fam22039	2	2	2	2.0	0.0	0.0	2	2	0
fam22040	2	2	2	2.0	0.0	0.0	2	2	0
fam22041	2	2	2	2.0	0.0	0.0	2	2	0
fam22042	2	2	2	2.0	0.0	0.0	2	2	0
fam22043	2	2	2	2.0	0.0	0.0	2	2	0
fam22044	2	2	2	2.0	0.0	0.0	2	2	0
fam22045	2	2	2	2.0	0.0	0.0	2	2	0
fam22046	2	2	2	2.0	0.0	0.0	2	2	0
fam22047	2	2	2	2.0	0.0	0.0	2	2	0
fam22048	2	2	2	2.0	0.0	0.0	2	2	0
fam22049	2	2	2	2.0	0.0	0.0	2	2	0
fam22050	2	2	2	2.0	0.0	0.0	2	2	0
fam22051	2	2	2	2.0	0.0	0.0	2	2	0
fam22052	2	2	2	2.0	0.0	0.0	2	2	0
fam22053	2	2	2	2.0	0.0	0.0	2	2	0
fam22054	2	2	2	2.0	0.0	0.0	2	2	0
fam22055	2	2	2	2.0	0.0	0.0	2	2	0
fam22056	2	2	2	2.0	0.0	0.0	2	2	0
fam22057	2	2	2	2.0	0.0	0.0	2	2	0
fam22058	2	2	2	2.0	0.0	0.0	2	2	0
fam22059	2	2	2	2.0	0.0	0.0	2	2	0
fam22060	2	2	2	2.0	0.0	0.0	2	2	0
fam22061	2	2	2	2.0	0.0	0.0	2	2	0
fam22062	2	2	2	2.0	0.0	0.0	2	2	0
fam22063	2	2	2	2.0	0.0	0.0	2	2	0
fam22064	2	2	2	2.0	0.0	0.0	2	2	0
fam22065	2	2	2	2.0	0.0	0.0	2	2	0
fam22066	2	2	2	2.0	0.0	0.0	2	2	0
fam22067	2	2	2	2.0	0.0	0.0	2	2	0
fam22068	2	2	2	2.0	0.0	0.0	2	2	0
fam22069	2	2	2	2.0	0.0	0.0	2	2	0
fam22070	2	2	2	2.0	0.0	0.0	2	2	0
fam22071	2	2	2	2.0	0.0	0.0	2	2	0
fam22072	2	2	2	2.0	0.0	0.0	2	2	0
fam22073	2	2	2	2.0	0.0	0.0	2	2	0
fam22074	2	2	2	2.0	0.0	0.0	2	2	0
fam22075	2	2	2	2.0	0.0	0.0	2	2	0
fam22076	2	2	2	2.0	0.0	0.0	2	2	0
fam22077	2	2	2	2.0	0.0	0.0	2	2	0
fam22078	2	2	2	2.0	0.0	0.0	2	2	0
fam22079	2	2	2	2.0	0.0	0.0	2	2	0
fam22080	2	2	2	2.0	0.0	0.0	2	2	0
fam22081	2	2	2	2.0	0.0	0.0	2	2	0
fam22082	2	2	2	2.0	0.0	0.0	2	2	0
fam22083	2	2	2	2.0	0.0	0.0	2	2	0
fam22084	2	2	2	2.0	0.0	0.0	2	2	0
fam22085	2	2	2	2.0	0.0	0.0	2	2	0
fam22086	2	2	2	2.0	0.0	0.0	2	2	0
fam22087	2	2	2	2.0	0.0	0.0	2	2	0
fam22088	2	2	2	2.0	0.0	0.0	2	2	0
fam22089	2	2	2	2.0	0.0	0.0	2	2	0
fam22090	2	2	2	2.0	0.0	0.0	2	2	0
fam22091	2	2	2	2.0	0.0	0.0	2	2	0
fam22092	2	2	2	2.0	0.0	0.0	2	2	0
fam22093	2	2	2	2.0	0.0	0.0	2	2	0
fam22094	2	2	2	2.0	0.0	0.0	2	2	0
fam22095	2	2	2	2.0	0.0	0.0	2	2	0
fam22096	2	2	2	2.0	0.0	0.0	2	2	0
fam22097	2	2	2	2.0	0.0	0.0	2	2	0
fam22098	2	2	2	2.0	0.0	0.0	2	2	0
fam22099	2	2	2	2.0	0.0	0.0	2	2	0
fam22100	2	2	2	2.0	0.0	0.0	2	2	0
fam22101	2	2	2	2.0	0.0	0.0	2	2	0
fam22102	2	2	2	2.0	0.0	0.0	2	2	0
fam22103	2	2	2	2.0	0.0	0.0	2	2	0
fam22104	2	2	2	2.0	0.0	0.0	2	2	0
fam22105	2	2	2	2.0	0.0	0.0	2	2	0
fam22106	2	2	2	2.0	0.0	0.0	2	2	0
fam22107	2	2	2	2.0	0.0	0.0	2	2	0
fam22108	2	2	2	2.0	0.0	0.0	2	2	0
fam22109	2	2	2	2.0	0.0	0.0	2	2	0
fam22110	2	2	2	2.0	0.0	0.0	2	2	0
fam22111	2	2	2	2.0	0.0	0.0	2	2	0
fam22112	2	2	2	2.0	0.0	0.0	2	2	0
fam22113	2	2	2	2.0	0.0	0.0	2	2	0
fam22114	2	2	2	2.0	0.0	0.0	2	2	0
fam22115	2	2	2	2.0	0.0	0.0	2	2	0
fam22116	2	2	2	2.0	0.0	0.0	2	2	0
fam22117	2	2	2	2.0	0.0	0.0	2	2	0
fam22118	2	2	2	2.0	0.0	0.0	2	2	0
fam22119	2	2	2	2.0	0.0	0.0	2	2	0
fam22120	2	2	2	2.0	0.0	0.0	2	2	0
fam22121	2	2	2	2.0	0.0	0.0	2	2	0
fam22122	2	2	2	2.0	0.0	0.0	2	2	0
fam22123	2	2	2	2.0	0.0	0.0	2	2	0
fam22124	2	2	2	2.0	0.0	0.0	2	2	0
fam22125	2	2	2	2.0	0.0	0.0	2	2	0
fam22126	2	2	2	2.0	0.0	0.0	2	2	0
fam22127	2	2	2	2.0	0.0	0.0	2	2	0
fam22128	2	2	2	2.0	0.0	0.0	2	2	0
fam22129	2	2	2	2.0	0.0	0.0	2	2	0
fam22130	2	2	2	2.0	0.0	0.0	2	2	0
fam22131	2	2	2	2.0	0.0	0.0	2	2	0
fam22132	2	2	2	2.0	0.0	0.0	2	2	0
fam22133	2	2	2	2.0	0.0	0.0	2	2	0
fam22134	2	2	2	2.0	0.0	0.0	2	2	0
fam22135	2	2	2	2.0	0.0	0.0	2	2	0
fam22136	2	2	2	2.0	0.0	0.0	2	2	0
fam22137	2	2	2	2.0	0.0	0.0	2	2	0
fam22138	2	2	2	2.0	0.0	0.0	2	2	0
fam22139	2	2	2	2.0	0.0	0.0	2	2	0
fam22140	2	2	2	2.0	0.0	0.0	2	2	0
fam22141	2	2	2	2.0	0.0	0.0	2	2	0
fam22142	2	2	2	2.0	0.0	0.0	2	2	0
fam22143	2	2	2	2.0	0.0	0.0	2	2	0
fam22144	2	2	2	2.0	0.0	0.0	2	2	0
fam22145	2	2	2	2.0	0.0	0.0	2	2	0
fam22146	2	2	2	2.0	0.0	0.0	2	2	0
fam22147	2	2	2	2.0	0.0	0.0	2	2	0
fam22148	2	2	2	2.0	0.0	0.0	2	2	0
fam22149	2	2	2	2.0	0.0	0.0	2	2	0
fam22150	2	2	2	2.0	0.0	0.0	2	2	0
fam22151	2	2	2	2.0	0.0	0.0	2	2	0
fam22152	2	2	2	2.0	0.0	0.0	2	2	0
fam22153	2	2	2	2.0	0.0	0.0	2	2	0
fam22154	2	2	2	2.0	0.0	0.0	2	2	0
fam22155	2	2	2	2.0	0.0	0.0	2	2	0
fam22156	2	2	2	2.0	0.0	0.0	2	2	0
fam22157	2	2	2	2.0	0.0	0.0	2	2	0
fam22158	2	2	2	2.0	0.0	0.0	2	2	0
fam22159	2	2	2	2.0	0.0	0.0	2	2	0
fam22160	2	2	2	2.0	0.0	0.0	2	2	0
fam22161	2	2	2	2.0	0.0	0.0	2	2	0
fam22162	2	2	2	2.0	0.0	0.0	2	2	0
fam22163	2	2	2	2.0	0.0	0.0	2	2	0
fam22164	2	2	2	2.0	0.0	0.0	2	2	0
fam22165	2	2	2	2.0	0.0	0.0	2	2	0
fam22166	2	2	2	2.0	0.0	0.0	2	2	0
fam22167	2	2	2	2.0	0.0	0.0	2	2	0
fam22168	2	2	2	2.0	0.0	0.0	2	2	0
fam22169	2	2	2	2.0	0.0	0.0	2	2	0
fam22170	2	2	2	2.0	0.0	0.0	2	2	0
fam22171	2	2	2	2.0	0.0	0.0	2	2	0
fam22172	2	2	2	2.0	0.0	0.0	2	2	0
fam22173	2	2	2	2.0	0.0	0.0	2	2	0
fam22174	2	2	2	2.0	0.0	0.0	2	2	0
fam22175	2	2	2	2.0	0.0	0.0	2	2	0
fam22176	2	2	2	2.0	0.0	0.0	2	2	0
fam22177	2	2	2	2.0	0.0	0.0	2	2	0
fam22178	2	2	2	2.0	0.0	0.0	2	2	0
fam22179	2	2	2	2.0	0.0	0.0	2	2	0
fam22180	2	2	2	2.0	0.0	0.0	2	2	0
fam22181	2	2	2	2.0	0.0	0.0	2	2	0
fam22182	2	2	2	2.0	0.0	0.0	2	2	0
fam22183	2	2	2	2.0	0.0	0.0	2	2	0
fam22184	2	2	2	2.0	0.0	0.0	2	2	0
fam22185	2	2	2	2.0	0.0	0.0	2	2	0
fam22186	2	2	2	2.0	0.0	0.0	2	2	0
fam22187	2	2	2	2.0	0.0	0.0	2	2	0
fam22188	2	2	2	2.0	0.0	0.0	2	2	0
fam22189	2	2	2	2.0	0.0	0.0	2	2	0
fam22190	2	2	2	2.0	0.0	0.0	2	2	0
fam22191	2	2	2	2.0	0.0	0.0	2	2	0
fam22192	2	2	2	2.0	0.0	0.0	2	2	0
fam22193	2	2	2	2.0	0.0	0.0	2	2	0
fam22194	2	2	2	2.0	0.0	0.0	2	2	0
fam22195	2	2	2	2.0	0.0	0.0	2	2	0
fam22196	2	2	2	2.0	0.0	0.0	2	2	0
fam22197	2	2	2	2.0	0.0	0.0	2	2	0
fam22198	2	2	2	2.0	0.0	0.0	2	2	0
fam22199	2	2	2	2.0	0.0	0.0	2	2	0
fam22200	2	2	2	2.0	0.0	0.0	2	2	0
fam22201	2	2	2	2.0	0.0	0.0	2	2	0
fam22202	2	2	2	2.0	0.0	0.0	2	2	0
fam22203	2	2	2	2.0	0.0	0.0	2	2	0
fam22204	2	2	2	2.0	0.0	0.0	2	2	0
fam22205	2	2	2	2.0	0.0	0.0	2	2	0
fam22206	2	2	2	2.0	0.0	0.0	2	2	0
fam22207	2	2	2	2.0	0.0	0.0	2	2	0
fam22208	2	2	2	2.0	0.0	0.0	2	2	0
fam22209	2	2	2	2.0	0.0	0.0	2	2	0
fam22210	2	2	2	2.0	0.0	0.0	2	2	0
fam22211	2	2	2	2.0	0.0	0.0	2	2	0
fam22212	2	2	2	2.0	0.0	0.0	2	2	0
fam22213	2	2	2	2.0	0.0	0.0	2	2	0
fam22214	2	2	2	2.0	0.0	0.0	2	2	0
fam22215	2	2	2	2.0	0.0	0.0	2	2	0
fam22216	2	2	2	2.0	0.0	0.0	2	2	0
fam22217	2	2	2	2.0	0.0	0.0	2	2	0
fam22218	2	2	2	2.0	0.0	0.0	2	2	0
fam22219	2	2	2	2.0	0.0	0.0	2	2	0
fam22220	2	2	2	2.0	0.0	0.0	2	2	0
fam22221	2	2	2	2.0	0.0	0.0	2	2	0
fam22222	2	2	2	2.0	0.0	0.0	2	2	0
fam22223	2	2	2	2.0	0.0	0.0	2	2	0
fam22224	2	2	2	2.0	0.0	0.0	2	2	0
fam22225	2	2	2	2.0	0.0	0.0	2	2	0
fam22226	2	2	2	2.0	0.0	0.0	2	2	0
fam22227	2	2	2	2.0	0.0	0.0	2	2	0
fam22228	2	2	2	2.0	0.0	0.0	2	2	0
fam22229	2	2	2	2.0	0.0	0.0	2	2	0
fam22230	2	2	2	2.0	0.0	0.0	2	2	0
fam22231	2	2	2	2.0	0.0	0.0	2	2	0
fam22232	2	2	2	2.0	0.0	0.0	2	2	0
fam22233	2	2	2	2.0	0.0	0.0	2	2	0
fam22234	2	2	2	2.0	0.0	0.0	2	2	0
fam22235	2	2	2	2.0	0.0	0.0	2	2	0
fam22236	2	2	2	2.0	0.0	0.0	2	2	0
fam22237	2	2	2	2.0	0.0	0.0	2	2	0
fam22238	2	2	2	2.0	0.0	0.0	2	2	0
fam22239	2	2	2	2.0	0.0	0.0	2	2	0
fam22240	2	2	2	2.0	0.0	0.0	2	2	0
fam22241	2	2	2	2.0	0.0	0.0	2	2	0
fam22242	2	2	2	2.0	0.0	0.0	2	2	0
fam22243	2	2	2	2.0	0.0	0.0	2	2	0
fam22244	2	2	2	2.0	0.0	0.0	2	2	0
fam22245	2	2	2	2.0	0.0	0.0	2	2	0
fam22246	2	2	2	2.0	0.0	0.0	2	2	0
fam22247	2	2	2	2.0	0.0	0.0	2	2	0
fam22248	2	2	2	2.0	0.0	0.0	2	2	0
fam22249	2	2	2	2.0	0.0	0.0	2	2	0
fam22250	2	2	2	2.0	0.0	0.0	2	2	0
fam22251	2	2	2	2.0	0.0	0.0	2	2	0
fam22252	2	2	2	2.0	0.0	0.0	2	2	0
fam22253	2	2	2	2.0	0.0	0.0	2	2	0
fam22254	2	2	2	2.0	0.0	0.0	2	2	0
fam22255	2	2	2	2.0	0.0	0.0	2	2	0
fam22256	2	2	2	2.0	0.0	0.0	2	2	0
fam22257	2	2	2	2.0	0.0	0.0	2	2	0
fam22258	2	2	2	2.0	0.0	0.0	2	2	0
fam22259	2	2	2	2.0	0.0	0.0	2	2	0
fam22260	2	2	2	2.0	0.0	0.0	2	2	0
fam22261	2	2	2	2.0	0.0	0.0	2	2	0
fam22262	2	2	2	2.0	0.0	0.0	2	2	0
fam22263	2	2	2	2.0	0.0	0.0	2	2	0
fam22264	2	2	2	2.0	0.0	0.0	2	2	0
fam22265	2	2	2	2.0	0.0	0.0	2	2	0
fam22266	2	2	2	2.0	0.0	0.0	2	2	0
fam22267	2	2	2	2.0	0.0	0.0	2	2	0
fam22268	2	2	2	2.0	0.0	0.0	2	2	0
fam22269	2	2	2	2.0	0.0	0.0	2	2	0
fam22270	2	2	2	2.0	0.0	0.0	2	2	0
fam22271	2	2	2	2.0	0.0	0.0	2	2	0
fam22272	2	2	2	2.0	0.0	0.0	2	2	0
fam22273	2	2	2	2.0	0.0	0.0	2	2	0
fam22274	2	2	2	2.0	0.0	0.0	2	2	0
fam22275	2	2	2	2.0	0.0	0.0	2	2	0
fam22276	2	2	2	2.0	0.0	0.0	2	2	0
fam22277	2	2	2	2.0	0.0	0.0	2	2	0
fam22278	2	2	2	2.0	0.0	0.0	2	2	0
fam22279	2	2	2	2.0	0.0	0.0	2	2	0
fam22280	2	2	2	2.0	0.0	0.0	2	2	0
fam22281	2	2	2	2.0	0.0	0.0	2	2	0
fam22282	2	2	2	2.0	0.0	0.0	2	2	0
fam22283	2	2	2	2.0	0.0	0.0	2	2	0
fam22284	2	2	2	2.0	0.0	0.0	2	2	0
fam22285	2	2	2	2.0	0.0	0.0	2	2	0
fam22286	2	2	2	2.0	0.0	0.0	2	2	0
fam22287	2	2	2	2.0	0.0	0.0	2	2	0
fam22288	2	2	2	2.0	0.0	0.0	2	2	0
fam22289	2	2	2	2.0	0.0	0.0	2	2	0
fam22290	2	2	2	2.0	0.0	0.0	2	2	0
fam22291	2	2	2	2.0	0.0	0.0	2	2	0
fam22292	2	2	2	2.0	0.0	0.0	2	2	0
fam22293	2	2	2	2.0	0.0	0.0	2	2	0
fam22294	2	2	2	2.0	0.0	0.0	2	2	0
fam22295	2	2	2	2.0	0.0	0.0	2	2	0
fam22296	2	2	2	2.0	0.0	0.0	2	2	0
fam22297	2	2	2	2.0	0.0	0.0	2	2	0
fam22298	2	2	2	2.0	0.0	0.0	2	2	0
fam22299	2	2	2	2.0	0.0	0.0	2	2	0
fam22300	2	2	2	2.0	0.0	0.0	2	2	0
fam22301	2	2	2	2.0	0.0	0.0	2	2	0
fam22302	2	2	2	2.0	0.0	0.0	2	2	0
fam22303	2	2	2	2.0	0.0	0.0	2	2	0
fam22304	2	2	2	2.0	0.0	0.0	2	2	0
fam22305	2	2	2	2.0	0.0	0.0	2	2	0
fam22306	2	2	2	2.0	0.0	0.0	2	2	0
fam22307	2	2	2	2.0	0.0	0.0	2	2	0
fam22308	2	2	2	2.0	0.0	0.0	2	2	0
fam22309	2	2	2	2.0	0.0	0.0	2	2	0
fam22310	2	2	2	2.0	0.0	0.0	2	2	0
fam22311	2	2	2	2.0	0.0	0.0	2	2	0
fam22312	2	2	2	2.0	0.0	0.0	2	2	0
fam22313	2	2	2	2.0	0.0	0.0	2	2	0
fam22314	2	2	2	2.0	0.0	0.0	2	2	0
fam22315	2	2	2	2.0	0.0	0.0	2	2	0
fam22316	2	2	2	2.0	0.0	0.0	2	2	0
fam22317	2	2	2	2.0	0.0	0.0	2	2	0
fam22318	2	2	2	2.0	0.0	0.0	2	2	0
fam22319	2	2	2	2.0	0.0	0.0	2	2	0
fam22320	2	2	2	2.0	0.0	0.0	2	2	0
fam22321	2	2	2	2.0	0.0	0.0	2	2	0
fam22322	2	2	2	2.0	0.0	0.0	2	2	0
fam22323	2	2	2	2.0	0.0	0.0	2	2	0
fam22324	2	2	2	2.0	0.0	0.0	2	2	0
fam22325	2	2	2	2.0	0.0	0.0	2	2	0
fam22326	2	2	2	2.0	0.0	0.0	2	2	0
fam22327	2	2	2	2.0	0.0	0.0	2	2	0
fam22328	2	2	2	2.0	0.0	0.0	2	2	0
fam22329	2	2	2	2.0	0.0	0.0	2	2	0
fam22330	2	2	2	2.0	0.0	0.0	2	2	0
fam22331	2	2	2	2.0	0.0	0.0	2	2	0
fam22332	2	2	2	2.0	0.0	0.0	2	2	0
fam22333	2	2	2	2.0	0.0	0.0	2	2	0
fam22334	2	2	2	2.0	0.0	0.0	2	2	0
fam22335	2	2	2	2.0	0.0	0.0	2	2	0
fam22336	2	2	2	2.0	0.0	0.0	2	2	0
fam22337	2	2	2	2.0	0.0	0.0	2	2	0
fam22338	2	2	2	2.0	0.0	0.0	2	2	0
fam22339	2	2	2	2.0	0.0	0.0	2	2	0
fam22340	2	2	2	2.0	0.0	0.0	2	2	0
fam22341	2	2	2	2.0	0.0	0.0	2	2	0
fam22342	2	2	2	2.0	0.0	0.0	2	2	0
fam22343	2	2	2	2.0	0.0	0.0	2	2	0
fam22344	2	2	2	2.0	0.0	0.0	2	2	0
fam22345	2	2	2	2.0	0.0	0.0	2	2	0
fam22346	2	2	2	2.0	0.0	0.0	2	2	0
fam22347	2	2	2	2.0	0.0	0.0	2	2	0
fam22348	2	2	2	2.0	0.0	0.0	2	2	0
fam22349	2	2	2	2.0	0.0	0.0	2	2	0
fam22350	2	2	2	2.0	0.0	0.0	2	2	0
fam22351	2	2	2	2.0	0.0	0.0	2	2	0
fam22352	2	2	2	2.0	0.0	0.0	2	2	0
fam22353	2	2	2	2.0	0.0	0.0	2	2	0
fam22354	2	2	2	2.0	0.0	0.0	2	2	0
fam22355	2	2	2	2.0	0.0	0.0	2	2	0
fam22356	2	2	2	2.0	0.0	0.0	2	2	0
fam22357	2	2	2	2.0	0.0	0.0	2	2	0
fam22358	2	2	2	2.0	0.0	0.0	2	2	0
fam22359	2	2	2	2.0	0.0	0.0	2	2	0
fam22360	2	2	2	2.0	0.0	0.0	2	2	0
fam22361	2	2	2	2.0	0.0	0.0	2	2	0
fam22362	2	2	2	2.0	0.0	0.0	2	2	0
fam22363	2	2	2	2.0	0.0	0.0	2	2	0
fam22364	2	2	2	2.0	0.0	0.0	2	2	0
fam22365	2	2	2	2.0	0.0	0.0	2	2	0
fam22366	2	2	2	2.0	0.0	0.0	2	2	0
fam22367	2	2	2	2.0	0.0	0.0	2	2	0
fam22368	2	2	2	2.0	0.0	0.0	2	2	0
fam22369	2	2	2	2.0	0.0	0.0	2	2	0
fam22370	2	2	2	2.0	0.0	0.0	2	2	0
fam22371	2	2	2	2.0	0.0	0.0	2	2	0
fam22372	2	2	2	2.0	0.0	0.0	2	2	0
fam22373	2	2	2	2.0	0.0	0.0	2	2	0
fam22374	2	2	2	2.0	0.0	0.0	2	2	0
fam22375	2	2	2	2.0	0.0	0.0	2	2	0
fam22376	2	2	2	2.0	0.0	0.0	2	2	0
fam22377	2	2	2	2.0	0.0	0.0	2	2	0
fam22378	2	2	2	2.0	0.0	0.0	2	2	0
fam22379	2	2	2	2.0	0.0	0.0	2	2	0
fam22380	2	2	2	2.0	0.0	0.0	2	2	0
fam22381	2	2	2	2.0	0.0	0.0	2	2	0
fam22382	2	2	2	2.0	0.0	0.0	2	2	0
fam22383	2	2	2	2.0	0.0	0.0	2	2	0
fam22384	2	2	2	2.0	0.0	0.0	2	2	0
fam22385	2	2	2	2.0	0.0	0.0	2	2	0
fam22386	2	2	2	2.0	0.0	0.0	2	2	0
fam22387	2	2	2	2.0	0.0	0.0	2	2	0
fam22388	2	2	2	2.0	0.0	0.0	2	2	0
fam22389	2	2	2	2.0	0.0	0.0	2	2	0
fam22390	2	2	2	2.0	0.0	0.0	2	2	0
fam22391	2	2	2	2.0	0.0	0.0	2	2	0
fam22392	2	2	2	2.0	0.0	0.0	2	2	0
fam22393	2	2	2	2.0	0.0	0.0	2	2	0
fam22394	2	2	2	2.0	0.0	0.0	2	2	0
fam22395	2	2	2	2.0	0.0	0.0	2	2	0
fam22396	2	2	2	2.0	0.0	0.0	2	2	0
fam22397	2	2	2	2.0	0.0	0.0	2	2	0
fam22398	2	2	2	2.0	0.0	0.0	2	2	0
fam22399	2	2	2	2.0	0.0	0.0	2	2	0
fam22400	2	2	2	2.0	0.0	0.0	2	2	0
fam22401	2	2	2	2.0	0.0	0.0	2	2	0
fam22402	2	2	2	2.0	0.0	0.0	2	2	0
fam22403	2	2	2	2.0	0.0	0.0	2	2	0
fam22404	2	2	2	2.0	0.0	0.0	2	2	0
fam22405	2	2	2	2.0	0.0	0.0	2	2	0
fam22406	2	2	2	2.0	0.0	0.0	2	2	0
fam22407	2	2	2	2.0	0.0	0.0	2	2	0
fam22408	2	2	2	2.0	0.0	0.0	2	2	0
fam22409	2	2	2	2.0	0.0	0.0	2	2	0
fam22410	2	2	2	2.0	0.0	0.0	2	2	0
fam22411	2	2	2	2.0	0.0	0.0	2	2	0
fam22412	2	2	2	2.0	0.0	0.0	2	2	0
fam22413	2	2	2	2.0	0.0	0.0	2	2	0
fam22414	2	2	2	2.0	0.0	0.0	2	2	0
fam22415	2	2	2	2.0	0.0	0.0	2	2	0
fam22416	2	2	2	2.0	0.0	0.0	2	2	0
fam22417	2	2	2	2.0	0.0	0.0	2	2	0
fam22418	2	2	2	2.0	0.0	0.0	2	2	0
fam22419	2	2	2	2.0	0.0	0.0	2	2	0
fam22420	2	2	2	2.0	0.0	0.0	2	2	0
fam22421	2	2	2	2.0	0.0	0.0	2	2	0
fam22422	2	2	2	2.0	0.0	0.0	2	2	0
fam22423	2	2	2	2.0	0.0	0.0	2	2	0
fam22424	2	2	2	2.0	0.0	0.0	2	2	0
fam22425	2	2	2	2.0	0.0	0.0	2	2	0
fam22426	2	2	2	2.0	0.0	0.0	2	2	0
fam22427	2	2	2	2.0	0.0	0.0	2	2	0
fam22428	2	2	2	2.0	0.0	0.0	2	2	0
fam22429	2	2	2	2.0	0.0	0.0	2	2	0
fam22430	2	2	2	2.0	0.0	0.0	2	2	0
fam22431	2	2	2	2.0	0.0	0.0	2	2	0
fam22432	2	2	2	2.0	0.0	0.0	2	2	0
fam22433	2	2	2	2.0	0.0	0.0	2	2	0
fam22434	2	2	2	2.0	0.0	0.0	2	2	0
fam22435	2	2	2	2.0	0.0	0.0	2	2	0
fam22436	2	2	2	2.0	0.0	0.0	2	2	0
fam22437	2	2	2	2.0	0.0	0.0	2	2	0
fam22438	2	2	2	2.0	0.0	0.0	2	2	0
fam22439	2	2	2	2.0	0.0	0.0	2	2	0
fam22440	2	2	2	2.0	0.0	0.0	2	2	0
fam22441	2	2	2	2.0	0.0	0.0	2	2	0
fam22442	2	2	2	2.0	0.0	0.0	2	2	0
fam22443	2	2	2	2.0	0.0	0.0	2	2	0
fam22444	2	2	2	2.0	0.0	0.0	2	2	0
fam22445	2	2	2	2.0	0.0	0.0	2	2	0
fam22446	2	2	2	2.0	0.0	0.0	2	2	0
fam22447	2	2	2	2.0	0.0	0.0	2	2	0
fam22448	2	2	2	2.0	0.0	0.0	2	2	0
fam22449	2	2	2	2.0	0.0	0.0	2	2	0
fam22450	2	2	2	2.0	0.0	0.0	2	2	0
fam22451	2	2	2	2.0	0.0	0.0	2	2	0
fam22452	2	2	2	2.0	0.0	0.0	2	2	0
fam22453	2	2	2	2.0	0.0	0.0	2	2	0
fam22454	2	2	2	2.0	0.0	0.0	2	2	0
fam22455	2	2	2	2.0	0.0	0.0	2	2	0
fam22456	2	2	2	2.0	0.0	0.0	2	2	0
fam22457	2	2	2	2.0	0.0	0.0	2	2	0
fam22458	2	2	2	2.0	0.0	0.0	2	2	0
fam22459	2	2	2	2.0	0.0	0.0	2	2	0
fam22460	2	2	2	2.0	0.0	0.0	2	2	0
fam22461	2	2	2	2.0	0.0	0.0	2	2	0
fam22462	2	2	2	2.0	0.0	0.0	2	2	0
fam22463	2	2	2	2.0	0.0	0.0	2	2	0
fam22464	2	2	2	2.0	0.0	0.0	2	2	0
fam22465	2	2	2	2.0	0.0	0.0	2	2	0
fam22466	2	2	2	2.0	0.0	0.0	2	2	0
fam22467	2	2	2	2.0	0.0	0.0	2	2	0
fam22468	2	2	2	2.0	0.0	0.0	2	2	0
fam22469	2	2	2	2.0	0.0	0.0	2	2	0
fam22470	2	2	2	2.0	0.0	0.0	2	2	0
fam22471	2	2	2	2.0	0.0	0.0	2	2	0
fam22472	2	2	2	2.0	0.0	0.0	2	2	0
fam22473	2	2	2	2.0	0.0	0.0	2	2	0
fam22474	2	2	2	2.0	0.0	0.0	2	2	0
fam22475	2	2	2	2.0	0.0	0.0	2	2	0
fam22476	2	2	2	2.0	0.0	0.0	2	2	0
fam22477	2	2	2	2.0	0.0	0.0	2	2	0
fam22478	2	2	2	2.0	0.0	0.0	2	2	0
fam22479	2	2	2	2.0	0.0	0.0	2	2	0
fam22480	2	2	2	2.0	0.0	0.0	2	2	0
fam22481	2	2	2	2.0	0.0	0.0	2	2	0
fam22482	2	2	2	2.0	0.0	0.0	2	2	0
fam22483	2	2	2	2.0	0.0	0.0	2	2	0
fam22484	2	2	2	2.0	0.0	0.0	2	2	0
fam22485	2	2	2	2.0	0.0	0.0	2	2	0
fam22486	2	2	2	2.0	0.0	0.0	2	2	0
fam22487	2	2	2	2.0	0.0	0.0	2	2	0
fam22488	2	2	2	2.0	0.0	0.0	2	2	0
fam22489	2	2	2	2.0	0.0	0.0	2	2	0
fam22490	2	2	2	2.0	0.0	0.0	2	2	0
fam22491	2	2	2	2.0	0.0	0.0	2	2	0
fam22492	2	2	2	2.0	0.0	0.0	2	2	0
fam22493	2	2	2	2.0	0.0	0.0	2	2	0
fam22494	2	2	2	2.0	0.0	0.0	2	2	0
fam22495	2	2	2	2.0	0.0	0.0	2	2	0
fam22496	2	2	2	2.0	0.0	0.0	2	2	0
fam22497	2	2	2	2.0	0.0	0.0	2	2	0
fam22498	2	2	2	2.0	0.0	0.0	2	2	0
fam22499	2	2	2	2.0	0.0	0.0	2	2	0
fam22500	2	2	2	2.0	0.0	0.0	2	2	0
fam22501	2	2	2	2.0	0.0	0.0	2	2	0
fam22502	2	2	2	2.0	0.0	0.0	2	2	0
fam22503	2	2	2	2.0	0.0	0.0	2	2	0
fam22504	2	2	2	2.0	0.0	0.0	2	2	0
fam22505	2	2	2	2.0	0.0	0.0	2	2	0
fam22506	2	2	2	2.0	0.0	0.0	2	2	0
fam22507	2	2	2	2.0	0.0	0.0	2	2	0
fam22508	2	2	2	2.0	0.0	0.0	2	2	0
fam22509	2	2	2	2.0	0.0	0.0	2	2	0
fam22510	2	2	2	2.0	0.0	0.0	2	2	0
fam22511	2	2	2	2.0	0.0	0.0	2	2	0
fam22512	2	2	2	2.0	0.0	0.0	2	2	0
fam22513	2	2	2	2.0	0.0	0.0	2	2	0
fam22514	2	2	2	2.0	0.0	0.0	2	2	0
fam22515	2	2	2	2.0	0.0	0.0	2	2	0
fam22516	2	2	2	2.0	0.0	0.0	2	2	0
fam22517	2	2	2	2.0	0.0	0.0	2	2	0
fam22518	2	2	2	2.0	0.0	0.0	2	2	0
fam22519	2	2	2	2.0	0.0	0.0	2	2	0
fam22520	2	2	2	2.0	0.0	0.0	2	2	0
fam22521	2	2	2	2.0	0.0	0.0	2	2	0
fam22522	2	2	2	2.0	0.0	0.0	2	2	0
fam22523	2	2	2	2.0	0.0	0.0	2	2	0
fam22524	2	2	2	2.0	0.0	0.0	2	2	0
fam22525	2	2	2	2.0	0.0	0.0	2	2	0
fam22526	2	2	2	2.0	0.0	0.0	2	2	0
fam22527	2	2	2	2.0	0.0	0.0	2	2	0
fam22528	2	2	2	2.0	0.0	0.0	2	2	0
fam22529	2	2	2	2.0	0.0	0.0	2	2	0
fam22530	2	2	2	2.0	0.0	0.0	2	2	0
fam22531	2	2	2	2.0	0.0	0.0	2	2	0
fam22532	2	2	2	2.0	0.0	0.0	2	2	0
fam22533	2	2	2	2.0	0.0	0.0	2	2	0
fam22534	2	2	2	2.0	0.0	0.0	2	2	0
fam22535	2	2	2	2.0	0.0	0.0	2	2	0
fam22536	2	2	2	2.0	0.0	0.0	2	2	0
fam22537	2	2	2	2.0	0.0	0.0	2	2	0
fam22538	2	2	2	2.0	0.0	0.0	2	2	0
fam22539	2	2	2	2.0	0.0	0.0	2	2	0
fam22540	2	2	2	2.0	0.0	0.0	2	2	0
fam22541	2	2	2	2.0	0.0	0.0	2	2	0
fam22542	2	2	2	2.0	0.0	0.0	2	2	0
fam22543	2	2	2	2.0	0.0	0.0	2	2	0
fam22544	2	2	2	2.0	0.0	0.0	2	2	0
fam22545	2	2	2	2.0	0.0	0.0	2	2	0
fam22546	2	2	2	2.0	0.0	0.0	2	2	0
fam22547	2	2	2	2.0	0.0	0.0	2	2	0
fam22548	2	2	2	2.0	0.0	0.0	2	2	0
fam22549	2	2	2	2.0	0.0	0.0	2	2	0
fam22550	2	2	2	2.0	0.0	0.0	2	2	0
fam22551	2	2	2	2.0	0.0	0.0	2	2	0
fam22552	2	2	2	2.0	0.0	0.0	2	2	0
fam22553	2	2	2	2.0	0.0	0.0	2	2	0
fam22554	2	2	2	2.0	0.0	0.0	2	2	0
fam22555	2	2	2	2.0	0.0	0.0	2	2	0
fam22556	2	2	2	2.0	0.0	0.0	2	2	0
fam22557	2	2	2	2.0	0.0	0.0	2	2	0
fam22558	2	2	2	2.0	0.0	0.0	2	2	0
fam22559	2	2	2	2.0	0.0	0.0	2	2	0
fam22560	2	2	2	2.0	0.0	0.0	2	2	0
fam22561	2	2	2	2.0	0.0	0.0	2	2	0
fam22562	2	2	2	2.0	0.0	0.0	2	2	0
fam22563	2	2	2	2.0	0.0	0.0	2	2	0
fam22564	2	2	2	2.0	0.0	0.0	2	2	0
fam22565	2	2	2	2.0	0.0	0.0	2	2	0
fam22566	2	2	2	2.0	0.0	0.0	2	2	0
fam22567	2	2	2	2.0	0.0	0.0	2	2	0
fam22568	2	2	2	2.0	0.0	0.0	2	2	0
fam22569	2	2	2	2.0	0.0	0.0	2	2	0
fam22570	2	2	2	2.0	0.0	0.0	2	2	0
fam22571	2	2	2	2.0	0.0	0.0	2	2	0
fam22572	2	2	2	2.0	0.0	0.0	2	2	0
fam22573	2	2	2	2.0	0.0	0.0	2	2	0
fam22574	2	2	2	2.0	0.0	0.0	2	2	0
fam22575	2	2	2	2.0	0.0	0.0	2	2	0
fam22576	2	2	2	2.0	0.0	0.0	2	2	0
fam22577	2	2	2	2.0	0.0	0.0	2	2	0
fam22578	2	2	2	2.0	0.0	0.0	2	2	0
fam22579	2	2	2	2.0	0.0	0.0	2	2	0
fam22580	2	2	2	2.0	0.0	0.0	2	2	0
fam22581	2	2	2	2.0	0.0	0.0	2	2	0
fam22582	2	2	2	2.0	0.0	0.0	2	2	0
fam22583	2	2	2	2.0	0.0	0.0	2	2	0
fam22584	2	2	2	2.0	0.0	0.0	2	2	0
fam22585	2	2	2	2.0	0.0	0.0	2	2	0
fam22586	2	2	2	2.0	0.0	0.0	2	2	0
fam22587	2	2	2	2.0	0.0	0.0	2	2	0
fam22588	2	2	2	2.0	0.0	0.0	2	2	0
fam22589	2	2	2	2.0	0.0	0.0	2	2	0
fam22590	2	2	2	2.0	0.0	0.0	2	2	0
fam22591	2	2	2	2.0	0.0	0.0	2	2	0
fam22592	2	2	2	2.0	0.0	0.0	2	2	0
fam22593	2	2	2	2.0	0.0	0.0	2	2	0
fam22594	2	2	2	2.0	0.0	0.0	2	2	0
fam22595	2	2	2	2.0	0.0	0.0	2	2	0
fam22596	2	2	2	2.0	0.0	0.0	2	2	0
fam22597	2	2	2	2.0	0.0	0.0	2	2	0
fam22598	2	2	2	2.0	0.0	0.0	2	2	0
fam22599	2	2	2	2.0	0.0	0.0	2	2	0
fam22600	2	2	2	2.0	0.0	0.0	2	2	0
fam22601	2	2	2	2.0	0.0	0.0	2	2	0
fam22602	2	2	2	2.0	0.0	0.0	2	2	0
fam22603	2	2	2	2.0	0.0	0.0	2	2	0
fam22604	2	2	2	2.0	0.0	0.0	2	2	0
fam22605	2	2	2	2.0	0.0	0.0	2	2	0
fam22606	2	2	2	2.0	0.0	0.0	2	2	0
fam22607	2	2	2	2.0	0.0	0.0	2	2	0
fam22608	2	2	2	2.0	0.0	0.0	2	2	0
fam22609	2	2	2	2.0	0.0	0.0	2	2	0
fam22610	2	2	2	2.0	0.0	0.0	2	2	0
fam22611	2	2	2	2.0	0.0	0.0	2	2	0
fam22612	2	2	2	2.0	0.0	0.0	2	2	0
fam22613	2	2	2	2.0	0.0	0.0	2	2	0
fam22614	2	2	2	2.0	0.0	0.0	2	2	0
fam22615	2	2	2	2.0	0.0	0.0	2	2	0
fam22616	2	2	2	2.0	0.0	0.0	2	2	0
fam22617	2	2	2	2.0	0.0	0.0	2	2	0
fam22618	2	2	2	2.0	0.0	0.0	2	2	0
fam22619	2	2	2	2.0	0.0	0.0	2	2	0
fam22620	2	2	2	2.0	0.0	0.0	2	2	0
fam22621	2	2	2	2.0	0.0	0.0	2	2	0
fam22622	2	2	2	2.0	0.0	0.0	2	2	0
fam22623	2	2	2	2.0	0.0	0.0	2	2	0
fam22624	2	2	2	2.0	0.0	0.0	2	2	0
fam22625	2	2	2	2.0	0.0	0.0	2	2	0
fam22626	2	2	2	2.0	0.0	0.0	2	2	0
fam22627	2	2	2	2.0	0.0	0.0	2	2	0
fam22628	2	2	2	2.0	0.0	0.0	2	2	0
fam22629	2	2	2	2.0	0.0	0.0	2	2	0
fam22630	2	2	2	2.0	0.0	0.0	2	2	0
fam22631	2	2	2	2.0	0.0	0.0	2	2	0
fam22632	2	2	2	2.0	0.0	0.0	2	2	0
fam22633	2	2	2	2.0	0.0	0.0	2	2	0
fam22634	2	2	2	2.0	0.0	0.0	2	2	0
fam22635	2	2	2	2.0	0.0	0.0	2	2	0
fam22636	2	2	2	2.0	0.0	0.0	2	2	0
fam22637	2	2	2	2.0	0.0	0.0	2	2	0
fam22638	2	2	2	2.0	0.0	0.0	2	2	0
fam22639	2	2	2	2.0	0.0	0.0	2	2	0
fam22640	2	2	2	2.0	0.0	0.0	2	2	0
fam22641	2	2	2	2.0	0.0	0.0	2	2	0
fam22642	2	2	2	2.0	0.0	0.0	2	2	0
fam22643	2	2	2	2.0	0.0	0.0	2	2	0
fam22644	2	2	2	2.0	0.0	0.0	2	2	0
fam22645	2	2	2	2.0	0.0	0.0	2	2	0
fam22646	2	2	2	2.0	0.0	0.0	2	2	0
fam22647	2	2	2	2.0	0.0	0.0	2	2	0
fam22648	2	2	2	2.0	0.0	0.0	2	2	0
fam22649	2	2	2	2.0	0.0	0.0	2	2	0
fam22650	2	2	2	2.0	0.0	0.0	2	2	0
fam22651	2	2	2	2.0	0.0	0.0	2	2	0
fam22652	2	2	2	2.0	0.0	0.0	2	2	0
fam22653	2	2	2	2.0	0.0	0.0	2	2	0
fam22654	2	2	2	2.0	0.0	0.0	2	2	0
fam22655	2	2	2	2.0	0.0	0.0	2	2	0
fam22656	2	2	2	2.0	0.0	0.0	2	2	0
fam22657	2	2	2	2.0	0.0	0.0	2	2	0
fam22658	2	2	2	2.0	0.0	0.0	2	2	0
fam22659	2	2	2	2.0	0.0	0.0	2	2	0
fam22660	2	2	2	2.0	0.0	0.0	2	2	0
fam22661	2	2	2	2.0	0.0	0.0	2	2	0
fam22662	2	2	2	2.0	0.0	0.0	2	2	0
fam22663	2	2	2	2.0	0.0	0.0	2	2	0
fam22664	2	2	2	2.0	0.0	0.0	2	2	0
fam22665	2	2	2	2.0	0.0	0.0	2	2	0
fam22666	2	2	2	2.0	0.0	0.0	2	2	0
fam22667	2	2	2	2.0	0.0	0.0	2	2	0
fam22668	2	2	2	2.0	0.0	0.0	2	2	0
fam22669	2	2	2	2.0	0.0	0.0	2	2	0
fam22670	2	2	2	2.0	0.0	0.0	2	2	0
fam22671	2	2	2	2.0	0.0	0.0	2	2	0
fam22672	2	2	2	2.0	0.0	0.0	2	2	0
fam22673	2	2	2	2.0	0.0	0.0	2	2	0
fam22674	2	2	2	2.0	0.0	0.0	2	2	0
fam22675	2	2	2	2.0	0.0	0.0	2	2	0
fam22676	2	2	2	2.0	0.0	0.0	2	2	0
fam22677	2	2	2	2.0	0.0	0.0	2	2	0
fam22678	2	2	2	2.0	0.0	0.0	2	2	0
fam22679	2	2	2	2.0	0.0	0.0	2	2	0
fam22680	2	2	2	2.0	0.0	0.0	2	2	0
fam22681	2	2	2	2.0	0.0	0.0	2	2	0
fam22682	2	2	2	2.0	0.0	0.0	2	2	0
fam22683	2	2	2	2.0	0.0	0.0	2	2	0
fam22684	2	2	2	2.0	0.0	0.0	2	2	0
fam22685	2	2	2	2.0	0.0	0.0	2	2	0
fam22686	2	2	2	2.0	0.0	0.0	2	2	0
fam22687	2	2	2	2.0	0.0	0.0	2	2	0
fam22688	2	2	2	2.0	0.0	0.0	2	2	0
fam22689	2	2	2	2.0	0.0	0.0	2	2	0
fam22690	2	2	2	2.0	0.0	0.0	2	2	0
fam22691	2	2	2	2.0	0.0	0.0	2	2	0
fam22692	2	2	2	2.0	0.0	0.0	2	2	0
fam22693	2	2	2	2.0	0.0	0.0	2	2	0
fam22694	2	2	2	2.0	0.0	0.0	2	2	0
fam22695	2	2	2	2.0	0.0	0.0	2	2	0
fam22696	2	2	2	2.0	0.0	0.0	2	2	0
fam22697	2	2	2	2.0	0.0	0.0	2	2	0
fam22698	2	2	2	2.0	0.0	0.0	2	2	0
fam22699	2	2	2	2.0	0.0	0.0	2	2	0
fam22700	2	2	2	2.0	0.0	0.0	2	2	0
fam22701	2	2	2	2.0	0.0	0.0	2	2	0
fam22702	2	2	2	2.0	0.0	0.0	2	2	0
fam22703	2	2	2	2.0	0.0	0.0	2	2	0
fam22704	2	2	2	2.0	0.0	0.0	2	2	0
fam22705	2	2	2	2.0	0.0	0.0	2	2	0
fam22706	2	2	2	2.0	0.0	0.0	2	2	0
fam22707	2	2	2	2.0	0.0	0.0	2	2	0
fam22708	2	2	2	2.0	0.0	0.0	2	2	0
fam22709	2	2	2	2.0	0.0	0.0	2	2	0
fam22710	2	2	2	2.0	0.0	0.0	2	2	0
fam22711	2	2	2	2.0	0.0	0.0	2	2	0
fam22712	2	2	2	2.0	0.0	0.0	2	2	0
fam22713	2	2	2	2.0	0.0	0.0	2	2	0
fam22714	2	2	2	2.0	0.0	0.0	2	2	0
fam22715	2	2	2	2.0	0.0	0.0	2	2	0
fam22716	2	2	2	2.0	0.0	0.0	2	2	0
fam22717	2	2	2	2.0	0.0	0.0	2	2	0
fam22718	2	2	2	2.0	0.0	0.0	2	2	0
fam22719	2	2	2	2.0	0.0	0.0	2	2	0
fam22720	2	2	2	2.0	0.0	0.0	2	2	0
fam22721	2	2	2	2.0	0.0	0.0	2	2	0
fam22722	2	2	2	2.0	0.0	0.0	2	2	0
fam22723	2	2	2	2.0	0.0	0.0	2	2	0
fam22724	2	2	2	2.0	0.0	0.0	2	2	0
fam22725	2	2	2	2.0	0.0	0.0	2	2	0
fam22726	2	2	2	2.0	0.0	0.0	2	2	0
fam22727	2	2	2	2.0	0.0	0.0	2	2	0
fam22728	2	2	2	2.0	0.0	0.0	2	2	0
fam22729	2	2	2	2.0	0.0	0.0	2	2	0
fam22730	2	2	2	2.0	0.0	0.0	2	2	0
fam22731	2	2	2	2.0	0.0	0.0	2	2	0
fam22732	2	2	2	2.0	0.0	0.0	2	2	0
fam22733	2	2	2	2.0	0.0	0.0	2	2	0
fam22734	2	2	2	2.0	0.0	0.0	2	2	0
fam22735	2	2	2	2.0	0.0	0.0	2	2	0
fam22736	2	2	2	2.0	0.0	0.0	2	2	0
fam22737	2	2	2	2.0	0.0	0.0	2	2	0
fam22738	2	2	2	2.0	0.0	0.0	2	2	0
fam22739	2	2	2	2.0	0.0	0.0	2	2	0
fam22740	2	2	2	2.0	0.0	0.0	2	2	0
fam22741	2	2	2	2.0	0.0	0.0	2	2	0
fam22742	2	2	2	2.0	0.0	0.0	2	2	0
fam22743	2	2	2	2.0	0.0	0.0	2	2	0
fam22744	2	2	2	2.0	0.0	0.0	2	2	0
fam22745	2	2	2	2.0	0.0	0.0	2	2	0
fam22746	2	2	2	2.0	0.0	0.0	2	2	0
fam22747	2	2	2	2.0	0.0	0.0	2	2	0
fam22748	2	2	2	2.0	0.0	0.0	2	2	0
fam22749	2	2	2	2.0	0.0	0.0	2	2	0
fam22750	2	2	2	2.0	0.0	0.0	2	2	0
fam22751	2	2	2	2.0	0.0	0.0	2	2	0
fam22752	2	2	2	2.0	0.0	0.0	2	2	0
fam22753	2	2	2	2.0	0.0	0.0	2	2	0
fam22754	2	2	2	2.0	0.0	0.0	2	2	0
fam22755	2	2	2	2.0	0.0	0.0	2	2	0
fam22756	2	2	2	2.0	0.0	0.0	2	2	0
fam22757	2	2	2	2.0	0.0	0.0	2	2	0
fam22758	2	2	2	2.0	0.0	0.0	2	2	0
fam22759	2	2	2	2.0	0.0	0.0	2	2	0
fam22760	2	2	2	2.0	0.0	0.0	2	2	0
fam22761	2	2	2	2.0	0.0	0.0	2	2	0
fam22762	2	2	2	2.0	0.0	0.0	2	2	0
fam22763	2	2	2	2.0	0.0	0.0	2	2	0
fam22764	2	2	2	2.0	0.0	0.0	2	2	0
fam22765	2	2	2	2.0	0.0	0.0	2	2	0
fam22766	2	2	2	2.0	0.0	0.0	2	2	0
fam22767	2	2	2	2.0	0.0	0.0	2	2	0
fam22768	2	2	2	2.0	0.0	0.0	2	2	0
fam22769	2	2	2	2.0	0.0	0.0	2	2	0
fam22770	2	2	2	2.0	0.0	0.0	2	2	0
fam22771	2	2	2	2.0	0.0	0.0	2	2	0
fam22772	2	2	2	2.0	0.0	0.0	2	2	0
fam22773	2	2	2	2.0	0.0	0.0	2	2	0
fam22774	2	2	2	2.0	0.0	0.0	2	2	0
fam22775	2	2	2	2.0	0.0	0.0	2	2	0
fam22776	2	2	2	2.0	0.0	0.0	2	2	0
fam22777	2	2	2	2.0	0.0	0.0	2	2	0
fam22778	2	2	2	2.0	0.0	0.0	2	2	0
fam22779	2	2	2	2.0	0.0	0.0	2	2	0
fam22780	2	2	2	2.0	0.0	0.0	2	2	0
fam22781	2	2	2	2.0	0.0	0.0	2	2	0
fam22782	2	2	2	2.0	0.0	0.0	2	2	0
fam22783	2	2	2	2.0	0.0	0.0	2	2	0
fam22784	2	2	2	2.0	0.0	0.0	2	2	0
fam22785	2	2	2	2.0	0.0	0.0	2	2	0
fam22786	2	2	2	2.0	0.0	0.0	2	2	0
fam22787	2	2	2	2.0	0.0	0.0	2	2	0
fam22788	2	2	2	2.0	0.0	0.0	2	2	0
fam22789	2	2	2	2.0	0.0	0.0	2	2	0
fam22790	2	2	2	2.0	0.0	0.0	2	2	0
fam22791	2	2	2	2.0	0.0	0.0	2	2	0
fam22792	2	2	2	2.0	0.0	0.0	2	2	0
fam22793	2	2	2	2.0	0.0	0.0	2	2	0
fam22794	2	2	2	2.0	0.0	0.0	2	2	0
fam22795	2	2	2	2.0	0.0	0.0	2	2	0
fam22796	2	2	2	2.0	0.0	0.0	2	2	0
fam22797	2	2	2	2.0	0.0	0.0	2	2	0
fam22798	2	2	2	2.0	0.0	0.0	2	2	0
fam22799	2	2	2	2.0	0.0	0.0	2	2	0
fam22800	2	2	2	2.0	0.0	0.0	2	2	0
fam22801	2	2	2	2.0	0.0	0.0	2	2	0
fam22802	2	2	2	2.0	0.0	0.0	2	2	0
fam22803	2	2	2	2.0	0.0	0.0	2	2	0
fam22804	2	2	2	2.0	0.0	0.0	2	2	0
fam22805	2	2	2	2.0	0.0	0.0	2	2	0
fam22806	2	2	2	2.0	0.0	0.0	2	2	0
fam22807	2	2	2	2.0	0.0	0.0	2	2	0
fam22808	2	2	2	2.0	0.0	0.0	2	2	0
fam22809	2	2	2	2.0	0.0	0.0	2	2	0
fam22810	2	2	2	2.0	0.0	0.0	2	2	0
fam22811	2	2	2	2.0	0.0	0.0	2	2	0
fam22812	2	2	2	2.0	0.0	0.0	2	2	0
fam22813	2	2	2	2.0	0.0	0.0	2	2	0
fam22814	2	2	2	2.0	0.0	0.0	2	2	0
fam22815	2	2	2	2.0	0.0	0.0	2	2	0
fam22816	2	2	2	2.0	0.0	0.0	2	2	0
fam22817	2	2	2	2.0	0.0	0.0	2	2	0
fam22818	2	2	2	2.0	0.0	0.0	2	2	0
fam22819	2	2	2	2.0	0.0	0.0	2	2	0
fam22820	2	2	2	2.0	0.0	0.0	2	2	0
fam22821	2	2	2	2.0	0.0	0.0	2	2	0
fam22822	2	2	2	2.0	0.0	0.0	2	2	0
fam22823	2	2	2	2.0	0.0	0.0	2	2	0
fam22824	2	2	2	2.0	0.0	0.0	2	2	0
fam22825	2	2	2	2.0	0.0	0.0	2	2	0
fam22826	2	2	2	2.0	0.0	0.0	2	2	0
fam22827	2	2	2	2.0	0.0	0.0	2	2	0
fam22828	2	2	2	2.0	0.0	0.0	2	2	0
fam22829	2	2	2	2.0	0.0	0.0	2	2	0
fam22830	2	2	2	2.0	0.0	0.0	2	2	0
fam22831	2	2	2	2.0	0.0	0.0	2	2	0
fam22832	2	2	2	2.0	0.0	0.0	2	2	0
fam22833	2	2	2	2.0	0.0	0.0	2	2	0
fam22834	2	2	2	2.0	0.0	0.0	2	2	0
fam22835	2	2	2	2.0	0.0	0.0	2	2	0
fam22836	2	2	2	2.0	0.0	0.0	2	2	0
fam22837	2	2	2	2.0	0.0	0.0	2	2	0
fam22838	2	2	2	2.0	0.0	0.0	2	2	0
fam22839	2	2	2	2.0	0.0	0.0	2	2	0
fam22840	2	2	2	2.0	0.0	0.0	2	2	0
fam22841	2	2	2	2.0	0.0	0.0	2	2	0
fam22842	2	2	2	2.0	0.0	0.0	2	2	0
fam22843	2	2	2	2.0	0.0	0.0	2	2	0
fam22844	2	2	2	2.0	0.0	0.0	2	2	0
fam22845	2	2	2	2.0	0.0	0.0	2	2	0
fam22846	2	2	2	2.0	0.0	0.0	2	2	0
fam22847	2	2	2	2.0	0.0	0.0	2	2	0
fam22848	2	2	2	2.0	0.0	0.0	2	2	0
fam22849	2	2	2	2.0	0.0	0.0	2	2	0
fam22850	2	2	2	2.0	0.0	0.0	2	2	0
fam22851	2	2	2	2.0	0.0	0.0	2	2	0
fam22852	2	2	2	2.0	0.0	0.0	2	2	0
fam22853	2	2	2	2.0	0.0	0.0	2	2	0
fam22854	2	2	2	2.0	0.0	0.0	2	2	0
fam22855	2	2	2	2.0	0.0	0.0	2	2	0
fam22856	2	2	2	2.0	0.0	0.0	2	2	0
fam22857	2	2	2	2.0	0.0	0.0	2	2	0
fam22858	2	2	2	2.0	0.0	0.0	2	2	0
fam22859	2	2	2	2.0	0.0	0.0	2	2	0
fam22860	2	2	2	2.0	0.0	0.0	2	2	0
fam22861	2	2	2	2.0	0.0	0.0	2	2	0
fam22862	2	2	2	2.0	0.0	0.0	2	2	0
fam22863	2	2	2	2.0	0.0	0.0	2	2	0
fam22864	2	2	2	2.0	0.0	0.0	2	2	0
fam22865	2	2	2	2.0	0.0	0.0	2	2	0
fam22866	2	2	2	2.0	0.0	0.0	2	2	0
fam22867	2	2	2	2.0	0.0	0.0	2	2	0
fam22868	2	2	2	2.0	0.0	0.0	2	2	0
fam22869	2	2	2	2.0	0.0	0.0	2	2	0
fam22870	2	2	2	2.0	0.0	0.0	2	2	0
fam22871	2	2	2	2.0	0.0	0.0	2	2	0
fam22872	2	2	2	2.0	0.0	0.0	2	2	0
fam22873	2	2	2	2.0	0.0	0.0	2	2	0
fam22874	2	2	2	2.0	0.0	0.0	2	2	0
fam22875	2	2	2	2.0	0.0	0.0	2	2	0
fam22876	2	2	2	2.0	0.0	0.0	2	2	0
fam22877	2	2	2	2.0	0.0	0.0	2	2	0
fam22878	2	2	2	2.0	0.0	0.0	2	2	0
fam22879	2	2	2	2.0	0.0	0.0	2	2	0
fam22880	2	2	2	2.0	0.0	0.0	2	2	0
fam22881	2	2	2	2.0	0.0	0.0	2	2	0
fam22882	2	2	2	2.0	0.0	0.0	2	2	0
fam22883	2	2	2	2.0	0.0	0.0	2	2	0
fam22884	2	2	2	2.0	0.0	0.0	2	2	0
fam22885	2	2	2	2.0	0.0	0.0	2	2	0
fam22886	2	2	2	2.0	0.0	0.0	2	2	0
fam22887	2	2	2	2.0	0.0	0.0	2	2	0
fam22888	2	2	2	2.0	0.0	0.0	2	2	0
fam22889	2	2	2	2.0	0.0	0.0	2	2	0
fam22890	2	2	2	2.0	0.0	0.0	2	2	0
fam22891	2	2	2	2.0	0.0	0.0	2	2	0
fam22892	2	2	2	2.0	0.0	0.0	2	2	0
fam22893	2	2	2	2.0	0.0	0.0	2	2	0
fam22894	2	2	2	2.0	0.0	0.0	2	2	0
fam22895	2	2	2	2.0	0.0	0.0	2	2	0
fam22896	2	2	2	2.0	0.0	0.0	2	2	0
fam22897	2	2	2	2.0	0.0	0.0	2	2	0
fam22898	2	2	2	2.0	0.0	0.0	2	2	0
fam22899	2	2	2	2.0	0.0	0.0	2	2	0
fam22900	2	2	2	2.0	0.0	0.0	2	2	0
fam22901	2	2	2	2.0	0.0	0.0	2	2	0
fam22902	2	2	2	2.0	0.0	0.0	2	2	0
fam22903	2	2	2	2.0	0.0	0.0	2	2	0
fam22904	2	2	2	2.0	0.0	0.0	2	2	0
fam22905	2	2	2	2.0	0.0	0.0	2	2	0
fam22906	2	2	2	2.0	0.0	0.0	2	2	0
fam22907	2	2	2	2.0	0.0	0.0	2	2	0
fam22908	2	2	2	2.0	0.0	0.0	2	2	0
fam22909	2	2	2	2.0	0.0	0.0	2	2	0
fam22910	2	2	2	2.0	0.0	0.0	2	2	0
fam22911	2	2	2	2.0	0.0	0.0	2	2	0
fam22912	2	2	2	2.0	0.0	0.0	2	2	0
fam22913	2	2	2	2.0	0.0	0.0	2	2	0
fam22914	2	2	2	2.0	0.0	0.0	2	2	0
fam22915	2	2	2	2.0	0.0	0.0	2	2	0
fam22916	2	2	2	2.0	0.0	0.0	2	2	0
fam22917	2	2	2	2.0	0.0	0.0	2	2	0
fam22918	2	2	2	2.0	0.0	0.0	2	2	0
fam22919	2	2	2	2.0	0.0	0.0	2	2	0
fam22920	2	2	2	2.0	0.0	0.0	2	2	0
fam22921	2	2	2	2.0	0.0	0.0	2	2	0
fam22922	2	2	2	2.0	0.0	0.0	2	2	0
fam22923	2	2	2	2.0	0.0	0.0	2	2	0
fam22924	2	2	2	2.0	0.0	0.0	2	2	0
fam22925	2	2	2	2.0	0.0	0.0	2	2	0
fam22926	2	2	2	2.0	0.0	0.0	2	2	0
fam22927	2	2	2	2.0	0.0	0.0	2	2	0
fam22928	2	2	2	2.0	0.0	0.0	2	2	0
fam22929	2	2	2	2.0	0.0	0.0	2	2	0
fam22930	2	2	2	2.0	0.0	0.0	2	2	0
fam22931	2	2	2	2.0	0.0	0.0	2	2	0
fam22932	2	2	2	2.0	0.0	0.0	2	2	0
fam22933	2	2	2	2.0	0.0	0.0	2	2	0
fam22934	2	2	2	2.0	0.0	0.0	2	2	0
fam22935	2	2	2	2.0	0.0	0.0	2	2	0
fam22936	2	2	2	2.0	0.0	0.0	2	2	0
fam22937	2	2	2	2.0	0.0	0.0	2	2	0
fam22938	2	2	2	2.0	0.0	0.0	2	2	0
fam22939	2	2	2	2.0	0.0	0.0	2	2	0
fam22940	2	2	2	2.0	0.0	0.0	2	2	0
fam22941	2	2	2	2.0	0.0	0.0	2	2	0
fam22942	2	2	2	2.0	0.0	0.0	2	2	0
fam22943	2	2	2	2.0	0.0	0.0	2	2	0
fam22944	2	2	2	2.0	0.0	0.0	2	2	0
fam22945	2	2	2	2.0	0.0	0.0	2	2	0
fam22946	2	2	2	2.0	0.0	0.0	2	2	0
fam22947	2	2	2	2.0	0.0	0.0	2	2	0
fam22948	2	2	2	2.0	0.0	0.0	2	2	0
fam22949	2	2	2	2.0	0.0	0.0	2	2	0
fam22950	2	2	2	2.0	0.0	0.0	2	2	0
fam22951	2	2	2	2.0	0.0	0.0	2	2	0
fam22952	2	2	2	2.0	0.0	0.0	2	2	0
fam22953	2	2	2	2.0	0.0	0.0	2	2	0
fam22954	2	2	2	2.0	0.0	0.0	2	2	0
fam22955	2	2	2	2.0	0.0	0.0	2	2	0
fam22956	2	2	2	2.0	0.0	0.0	2	2	0
fam22957	2	2	2	2.0	0.0	0.0	2	2	0
fam22958	2	2	2	2.0	0.0	0.0	2	2	0
fam22959	2	2	2	2.0	0.0	0.0	2	2	0
fam22960	2	2	2	2.0	0.0	0.0	2	2	0
fam22961	2	2	2	2.0	0.0	0.0	2	2	0
fam22962	2	2	2	2.0	0.0	0.0	2	2	0
fam22963	2	2	2	2.0	0.0	0.0	2	2	0
fam22964	2	2	2	2.0	0.0	0.0	2	2	0
fam22965	2	2	2	2.0	0.0	0.0	2	2	0
fam22966	2	2	2	2.0	0.0	0.0	2	2	0
fam22967	2	2	2	2.0	0.0	0.0	2	2	0
fam22968	2	2	2	2.0	0.0	0.0	2	2	0
fam22969	2	2	2	2.0	0.0	0.0	2	2	0
fam22970	2	2	2	2.0	0.0	0.0	2	2	0
fam22971	2	2	2	2.0	0.0	0.0	2	2	0
fam22972	2	2	2	2.0	0.0	0.0	2	2	0
fam22973	2	2	2	2.0	0.0	0.0	2	2	0
fam22974	2	2	2	2.0	0.0	0.0	2	2	0
fam22975	2	2	2	2.0	0.0	0.0	2	2	0
fam22976	2	2	2	2.0	0.0	0.0	2	2	0
fam22977	2	2	2	2.0	0.0	0.0	2	2	0
fam22978	2	2	2	2.0	0.0	0.0	2	2	0
fam22979	2	2	2	2.0	0.0	0.0	2	2	0
fam22980	2	2	2	2.0	0.0	0.0	2	2	0
fam22981	2	2	2	2.0	0.0	0.0	2	2	0
fam22982	2	2	2	2.0	0.0	0.0	2	2	0
fam22983	2	2	2	2.0	0.0	0.0	2	2	0
fam22984	2	2	2	2.0	0.0	0.0	2	2	0
fam22985	2	2	2	2.0	0.0	0.0	2	2	0
fam22986	2	2	2	2.0	0.0	0.0	2	2	0
fam22987	2	2	2	2.0	0.0	0.0	2	2	0
fam22988	2	2	2	2.0	0.0	0.0	2	2	0
fam22989	2	2	2	2.0	0.0	0.0	2	2	0
fam22990	2	2	2	2.0	0.0	0.0	2	2	0
fam22991	2	2	2	2.0	0.0	0.0	2	2	0
fam22992	2	2	2	2.0	0.0	0.0	2	2	0
fam22993	2	2	2	2.0	0.0	0.0	2	2	0
fam22994	2	2	2	2.0	0.0	0.0	2	2	0
fam22995	2	2	2	2.0	0.0	0.0	2	2	0
fam22996	2	2	2	2.0	0.0	0.0	2	2	0
fam22997	2	2	2	2.0	0.0	0.0	2	2	0
fam22998	2	2	2	2.0	0.0	0.0	2	2	0
fam22999	2	2	2	2.0	0.0	0.0	2	2	0
fam23000	2	2	2	2.0	0.0	0.0	2	2	0
fam23001	2	2	2	2.0	0.0	0.0	2	2	0
fam23002	2	2	2	2.0	0.0	0.0	2	2	0
fam23003	2	2	2	2.0	0.0	0.0	2	2	0
fam23004	2	2	2	2.0	0.0	0.0	2	2	0
fam23005	2	2	2	2.0	0.0	0.0	2	2	0
fam23006	2	2	2	2.0	0.0	0.0	2	2	0
fam23007	2	2	2	2.0	0.0	0.0	2	2	0
fam23008	2	2	2	2.0	0.0	0.0	2	2	0
fam23009	2	2	2	2.0	0.0	0.0	2	2	0
fam23010	2	2	2	2.0	0.0	0.0	2	2	0
fam23011	2	2	2	2.0	0.0	0.0	2	2	0
fam23012	2	2	2	2.0	0.0	0.0	2	2	0
fam23013	2	2	2	2.0	0.0	0.0	2	2	0
fam23014	2	2	2	2.0	0.0	0.0	2	2	0
fam23015	2	2	2	2.0	0.0	0.0	2	2	0
fam23016	2	2	2	2.0	0.0	0.0	2	2	0
fam23017	2	2	2	2.0	0.0	0.0	2	2	0
fam23018	2	2	2	2.0	0.0	0.0	2	2	0
fam23019	2	2	2	2.0	0.0	0.0	2	2	0
fam23020	2	2	2	2.0	0.0	0.0	2	2	0
fam23021	2	2	2	2.0	0.0	0.0	2	2	0
fam23022	2	2	2	2.0	0.0	0.0	2	2	0
fam23023	2	2	2	2.0	0.0	0.0	2	2	0
fam23024	2	2	2	2.0	0.0	0.0	2	2	0
fam23025	2	2	2	2.0	0.0	0.0	2	2	0
fam23026	2	2	2	2.0	0.0	0.0	2	2	0
fam23027	2	2	2	2.0	0.0	0.0	2	2	0
fam23028	2	2	2	2.0	0.0	0.0	2	2	0
fam23029	2	2	2	2.0	0.0	0.0	2	2	0
fam23030	2	2	2	2.0	0.0	0.0	2	2	0
fam23031	2	2	2	2.0	0.0	0.0	2	2	0
fam23032	2	2	2	2.0	0.0	0.0	2	2	0
fam23033	2	2	2	2.0	0.0	0.0	2	2	0
fam23034	2	2	2	2.0	0.0	0.0	2	2	0
fam23035	2	2	2	2.0	0.0	0.0	2	2	0
fam23036	2	2	2	2.0	0.0	0.0	2	2	0
fam23037	2	2	2	2.0	0.0	0.0	2	2	0
fam23038	2	2	2	2.0	0.0	0.0	2	2	0
fam23039	2	2	2	2.0	0.0	0.0	2	2	0
fam23040	2	2	2	2.0	0.0	0.0	2	2	0
fam23041	2	2	2	2.0	0.0	0.0	2	2	0
fam23042	2	2	2	2.0	0.0	0.0	2	2	0
fam23043	2	2	2	2.0	0.0	0.0	2	2	0
fam23044	2	2	2	2.0	0.0	0.0	2	2	0
fam23045	2	2	2	2.0	0.0	0.0	2	2	0
fam23046	2	2	2	2.0	0.0	0.0	2	2	0
fam23047	2	2	2	2.0	0.0	0.0	2	2	0
fam23048	2	2	2	2.0	0.0	0.0	2	2	0
fam23049	2	2	2	2.0	0.0	0.0	2	2	0
fam23050	2	2	2	2.0	0.0	0.0	2	2	0
fam23051	2	2	2	2.0	0.0	0.0	2	2	0
fam23052	2	2	2	2.0	0.0	0.0	2	2	0
fam23053	2	2	2	2.0	0.0	0.0	2	2	0
fam23054	2	2	2	2.0	0.0	0.0	2	2	0
fam23055	2	2	2	2.0	0.0	0.0	2	2	0
fam23056	2	2	2	2.0	0.0	0.0	2	2	0
fam23057	2	2	2	2.0	0.0	0.0	2	2	0
fam23058	2	2	2	2.0	0.0	0.0	2	2	0
fam23059	2	2	2	2.0	0.0	0.0	2	2	0
fam23060	2	2	2	2.0	0.0	0.0	2	2	0
fam23061	2	2	2	2.0	0.0	0.0	2	2	0
fam23062	2	2	2	2.0	0.0	0.0	2	2	0
fam23063	2	2	2	2.0	0.0	0.0	2	2	0
fam23064	2	2	2	2.0	0.0	0.0	2	2	0
fam23065	2	2	2	2.0	0.0	0.0	2	2	0
fam23066	2	2	2	2.0	0.0	0.0	2	2	0
fam23067	2	2	2	2.0	0.0	0.0	2	2	0
fam23068	2	2	2	2.0	0.0	0.0	2	2	0
fam23069	2	2	2	2.0	0.0	0.0	2	2	0
fam23070	2	2	2	2.0	0.0	0.0	2	2	0
fam23071	2	2	2	2.0	0.0	0.0	2	2	0
fam23072	2	2	2	2.0	0.0	0.0	2	2	0
fam23073	2	2	2	2.0	0.0	0.0	2	2	0
fam23074	2	2	2	2.0	0.0	0.0	2	2	0
fam23075	2	2	2	2.0	0.0	0.0	2	2	0
fam23076	2	2	2	2.0	0.0	0.0	2	2	0
fam23077	2	2	2	2.0	0.0	0.0	2	2	0
fam23078	2	2	2	2.0	0.0	0.0	2	2	0
fam23079	2	2	2	2.0	0.0	0.0	2	2	0
fam23080	2	2	2	2.0	0.0	0.0	2	2	0
fam23081	2	2	2	2.0	0.0	0.0	2	2	0
fam23082	2	2	2	2.0	0.0	0.0	2	2	0
fam23083	2	2	2	2.0	0.0	0.0	2	2	0
fam23084	2	2	2	2.0	0.0	0.0	2	2	0
fam23085	2	2	2	2.0	0.0	0.0	2	2	0
fam23086	2	2	2	2.0	0.0	0.0	2	2	0
fam23087	2	2	2	2.0	0.0	0.0	2	2	0
fam23088	2	2	2	2.0	0.0	0.0	2	2	0
fam23089	2	2	2	2.0	0.0	0.0	2	2	0
fam23090	2	2	2	2.0	0.0	0.0	2	2	0
fam23091	2	2	2	2.0	0.0	0.0	2	2	0
fam23092	2	2	2	2.0	0.0	0.0	2	2	0
fam23093	2	2	2	2.0	0.0	0.0	2	2	0
fam23094	2	2	2	2.0	0.0	0.0	2	2	0
fam23095	2	2	2	2.0	0.0	0.0	2	2	0
fam23096	2	2	2	2.0	0.0	0.0	2	2	0
fam23097	2	2	2	2.0	0.0	0.0	2	2	0
fam23098	2	2	2	2.0	0.0	0.0	2	2	0
fam23099	2	2	2	2.0	0.0	0.0	2	2	0
fam23100	2	2	2	2.0	0.0	0.0	2	2	0
fam23101	2	2	2	2.0	0.0	0.0	2	2	0
fam23102	2	2	2	2.0	0.0	0.0	2	2	0
fam23103	2	2	2	2.0	0.0	0.0	2	2	0
fam23104	2	2	2	2.0	0.0	0.0	2	2	0
fam23105	2	2	2	2.0	0.0	0.0	2	2	0
fam23106	2	2	2	2.0	0.0	0.0	2	2	0
fam23107	2	2	2	2.0	0.0	0.0	2	2	0
fam23108	2	2	2	2.0	0.0	0.0	2	2	0
fam23109	2	2	2	2.0	0.0	0.0	2	2	0
fam23110	2	2	2	2.0	0.0	0.0	2	2	0
fam23111	2	2	2	2.0	0.0	0.0	2	2	0
fam23112	2	2	2	2.0	0.0	0.0	2	2	0
fam23113	2	2	2	2.0	0.0	0.0	2	2	0
fam23114	2	2	2	2.0	0.0	0.0	2	2	0
fam23115	2	2	2	2.0	0.0	0.0	2	2	0
fam23116	2	2	2	2.0	0.0	0.0	2	2	0
fam23117	2	2	2	2.0	0.0	0.0	2	2	0
fam23118	2	2	2	2.0	0.0	0.0	2	2	0
fam23119	2	2	2	2.0	0.0	0.0	2	2	0
fam23120	2	2	2	2.0	0.0	0.0	2	2	0
fam23121	2	2	2	2.0	0.0	0.0	2	2	0
fam23122	2	2	2	2.0	0.0	0.0	2	2	0
fam23123	2	2	2	2.0	0.0	0.0	2	2	0
fam23124	2	2	2	2.0	0.0	0.0	2	2	0
fam23125	2	2	2	2.0	0.0	0.0	2	2	0
fam23126	2	2	2	2.0	0.0	0.0	2	2	0
fam23127	2	2	2	2.0	0.0	0.0	2	2	0
fam23128	2	2	2	2.0	0.0	0.0	2	2	0
fam23129	2	2	2	2.0	0.0	0.0	2	2	0
fam23130	2	2	2	2.0	0.0	0.0	2	2	0
fam23131	2	2	2	2.0	0.0	0.0	2	2	0
fam23132	2	2	2	2.0	0.0	0.0	2	2	0
fam23133	2	2	2	2.0	0.0	0.0	2	2	0
fam23134	2	2	2	2.0	0.0	0.0	2	2	0
fam23135	2	2	2	2.0	0.0	0.0	2	2	0
fam23136	2	2	2	2.0	0.0	0.0	2	2	0
fam23137	2	2	2	2.0	0.0	0.0	2	2	0
fam23138	2	2	2	2.0	0.0	0.0	2	2	0
fam23139	2	2	2	2.0	0.0	0.0	2	2	0
fam23140	2	2	2	2.0	0.0	0.0	2	2	0
fam23141	2	2	2	2.0	0.0	0.0	2	2	0
fam23142	2	2	2	2.0	0.0	0.0	2	2	0
fam23143	2	2	2	2.0	0.0	0.0	2	2	0
fam23144	2	2	2	2.0	0.0	0.0	2	2	0
fam23145	2	2	2	2.0	0.0	0.0	2	2	0
fam23146	2	2	2	2.0	0.0	0.0	2	2	0
fam23147	2	2	2	2.0	0.0	0.0	2	2	0
fam23148	2	2	2	2.0	0.0	0.0	2	2	0
fam23149	2	2	2	2.0	0.0	0.0	2	2	0
fam23150	2	2	2	2.0	0.0	0.0	2	2	0
fam23151	2	2	2	2.0	0.0	0.0	2	2	0
fam23152	2	2	2	2.0	0.0	0.0	2	2	0
fam23153	2	2	2	2.0	0.0	0.0	2	2	0
fam23154	2	2	2	2.0	0.0	0.0	2	2	0
fam23155	2	2	2	2.0	0.0	0.0	2	2	0
fam23156	2	2	2	2.0	0.0	0.0	2	2	0
fam23157	2	2	2	2.0	0.0	0.0	2	2	0
fam23158	2	2	2	2.0	0.0	0.0	2	2	0
fam23159	2	2	2	2.0	0.0	0.0	2	2	0
fam23160	2	2	2	2.0	0.0	0.0	2	2	0
fam23161	2	2	2	2.0	0.0	0.0	2	2	0
fam23162	2	2	2	2.0	0.0	0.0	2	2	0
fam23163	2	2	2	2.0	0.0	0.0	2	2	0
fam23164	2	2	2	2.0	0.0	0.0	2	2	0
fam23165	2	2	2	2.0	0.0	0.0	2	2	0
fam23166	2	2	2	2.0	0.0	0.0	2	2	0
fam23167	2	2	2	2.0	0.0	0.0	2	2	0
fam23168	2	2	2	2.0	0.0	0.0	2	2	0
fam23169	2	2	2	2.0	0.0	0.0	2	2	0
fam23170	2	2	2	2.0	0.0	0.0	2	2	0
fam23171	2	2	2	2.0	0.0	0.0	2	2	0
fam23172	2	2	2	2.0	0.0	0.0	2	2	0
fam23173	2	2	2	2.0	0.0	0.0	2	2	0
fam23174	2	2	2	2.0	0.0	0.0	2	2	0
fam23175	2	2	2	2.0	0.0	0.0	2	2	0
fam23176	2	2	2	2.0	0.0	0.0	2	2	0
fam23177	2	2	2	2.0	0.0	0.0	2	2	0
fam23178	2	2	2	2.0	0.0	0.0	2	2	0
fam23179	2	2	2	2.0	0.0	0.0	2	2	0
fam23180	2	2	2	2.0	0.0	0.0	2	2	0
fam23181	2	2	2	2.0	0.0	0.0	2	2	0
fam23182	2	2	2	2.0	0.0	0.0	2	2	0
fam23183	2	2	2	2.0	0.0	0.0	2	2	0
fam23184	2	2	2	2.0	0.0	0.0	2	2	0
fam23185	2	2	2	2.0	0.0	0.0	2	2	0
fam23186	2	2	2	2.0	0.0	0.0	2	2	0
fam23187	2	2	2	2.0	0.0	0.0	2	2	0
fam23188	2	2	2	2.0	0.0	0.0	2	2	0
fam23189	2	2	2	2.0	0.0	0.0	2	2	0
fam23190	2	2	2	2.0	0.0	0.0	2	2	0
fam23191	2	2	2	2.0	0.0	0.0	2	2	0
fam23192	2	2	2	2.0	0.0	0.0	2	2	0
fam23193	2	2	2	2.0	0.0	0.0	2	2	0
fam23194	2	2	2	2.0	0.0	0.0	2	2	0
fam23195	2	2	2	2.0	0.0	0.0	2	2	0
fam23196	2	2	2	2.0	0.0	0.0	2	2	0
fam23197	2	2	2	2.0	0.0	0.0	2	2	0
fam23198	2	2	2	2.0	0.0	0.0	2	2	0
fam23199	2	2	2	2.0	0.0	0.0	2	2	0
fam23200	2	2	2	2.0	0.0	0.0	2	2	0
fam23201	2	2	2	2.0	0.0	0.0	2	2	0
fam23202	2	2	2	2.0	0.0	0.0	2	2	0
fam23203	2	2	2	2.0	0.0	0.0	2	2	0
fam23204	2	2	2	2.0	0.0	0.0	2	2	0
fam23205	2	2	2	2.0	0.0	0.0	2	2	0
fam23206	2	2	2	2.0	0.0	0.0	2	2	0
fam23207	2	2	2	2.0	0.0	0.0	2	2	0
fam23208	2	2	2	2.0	0.0	0.0	2	2	0
fam23209	2	2	2	2.0	0.0	0.0	2	2	0
fam23210	2	2	2	2.0	0.0	0.0	2	2	0
fam23211	2	2	2	2.0	0.0	0.0	2	2	0
fam23212	2	2	2	2.0	0.0	0.0	2	2	0
fam23213	2	2	2	2.0	0.0	0.0	2	2	0
fam23214	2	2	2	2.0	0.0	0.0	2	2	0
fam23215	2	2	2	2.0	0.0	0.0	2	2	0
fam23216	2	2	2	2.0	0.0	0.0	2	2	0
fam23217	2	2	2	2.0	0.0	0.0	2	2	0
fam23218	2	2	2	2.0	0.0	0.0	2	2	0
fam23219	2	2	2	2.0	0.0	0.0	2	2	0
fam23220	2	2	2	2.0	0.0	0.0	2	2	0
fam23221	2	2	2	2.0	0.0	0.0	2	2	0
fam23222	2	2	2	2.0	0.0	0.0	2	2	0
fam23223	2	2	2	2.0	0.0	0.0	2	2	0
fam23224	2	2	2	2.0	0.0	0.0	2	2	0
fam23225	2	2	2	2.0	0.0	0.0	2	2	0
fam23226	2	2	2	2.0	0.0	0.0	2	2	0
fam23227	2	2	2	2.0	0.0	0.0	2	2	0
fam23228	2	2	2	2.0	0.0	0.0	2	2	0
fam23229	2	2	2	2.0	0.0	0.0	2	2	0
fam23230	2	2	2	2.0	0.0	0.0	2	2	0
fam23231	2	2	2	2.0	0.0	0.0	2	2	0
fam23232	2	2	2	2.0	0.0	0.0	2	2	0
fam23233	2	2	2	2.0	0.0	0.0	2	2	0
fam23234	2	2	2	2.0	0.0	0.0	2	2	0
fam23235	2	2	2	2.0	0.0	0.0	2	2	0
fam23236	2	2	2	2.0	0.0	0.0	2	2	0
fam23237	2	2	2	2.0	0.0	0.0	2	2	0
fam23238	2	2	2	2.0	0.0	0.0	2	2	0
fam23239	2	2	2	2.0	0.0	0.0	2	2	0
fam23240	2	2	2	2.0	0.0	0.0	2	2	0
fam23241	2	2	2	2.0	0.0	0.0	2	2	0
fam23242	2	2	2	2.0	0.0	0.0	2	2	0
fam23243	2	2	2	2.0	0.0	0.0	2	2	0
fam23244	2	2	2	2.0	0.0	0.0	2	2	0
fam23245	2	2	2	2.0	0.0	0.0	2	2	0
fam23246	2	2	2	2.0	0.0	0.0	2	2	0
fam23247	2	2	2	2.0	0.0	0.0	2	2	0
fam23248	2	2	2	2.0	0.0	0.0	2	2	0
fam23249	2	2	2	2.0	0.0	0.0	2	2	0
fam23250	2	2	2	2.0	0.0	0.0	2	2	0
fam23251	2	2	2	2.0	0.0	0.0	2	2	0
fam23252	2	2	2	2.0	0.0	0.0	2	2	0
fam23253	2	2	2	2.0	0.0	0.0	2	2	0
fam23254	2	2	2	2.0	0.0	0.0	2	2	0
fam23255	2	2	2	2.0	0.0	0.0	2	2	0
fam23256	2	2	2	2.0	0.0	0.0	2	2	0
fam23257	2	2	2	2.0	0.0	0.0	2	2	0
fam23258	2	2	2	2.0	0.0	0.0	2	2	0
fam23259	2	2	2	2.0	0.0	0.0	2	2	0
fam23260	2	2	2	2.0	0.0	0.0	2	2	0
fam23261	2	2	2	2.0	0.0	0.0	2	2	0
fam23262	2	2	2	2.0	0.0	0.0	2	2	0
fam23263	2	2	2	2.0	0.0	0.0	2	2	0
fam23264	2	2	2	2.0	0.0	0.0	2	2	0
fam23265	2	2	2	2.0	0.0	0.0	2	2	0
fam23266	2	2	2	2.0	0.0	0.0	2	2	0
fam23267	2	2	2	2.0	0.0	0.0	2	2	0
fam23268	2	2	2	2.0	0.0	0.0	2	2	0
fam23269	2	2	2	2.0	0.0	0.0	2	2	0
fam23270	2	2	2	2.0	0.0	0.0	2	2	0
fam23271	2	2	2	2.0	0.0	0.0	2	2	0
fam23272	2	2	2	2.0	0.0	0.0	2	2	0
fam23273	2	2	2	2.0	0.0	0.0	2	2	0
fam23274	2	2	2	2.0	0.0	0.0	2	2	0
fam23275	2	2	2	2.0	0.0	0.0	2	2	0
fam23276	2	2	2	2.0	0.0	0.0	2	2	0
fam23277	2	2	2	2.0	0.0	0.0	2	2	0
fam23278	2	2	2	2.0	0.0	0.0	2	2	0
fam23279	2	2	2	2.0	0.0	0.0	2	2	0
fam23280	2	2	2	2.0	0.0	0.0	2	2	0
fam23281	2	2	2	2.0	0.0	0.0	2	2	0
fam23282	2	2	2	2.0	0.0	0.0	2	2	0
fam23283	2	2	2	2.0	0.0	0.0	2	2	0
fam23284	2	2	2	2.0	0.0	0.0	2	2	0
fam23285	2	2	2	2.0	0.0	0.0	2	2	0
fam23286	2	2	2	2.0	0.0	0.0	2	2	0
fam23287	2	2	2	2.0	0.0	0.0	2	2	0
fam23288	2	2	2	2.0	0.0	0.0	2	2	0
fam23289	2	2	2	2.0	0.0	0.0	2	2	0
fam23290	2	2	2	2.0	0.0	0.0	2	2	0
fam23291	2	2	2	2.0	0.0	0.0	2	2	0
fam23292	2	2	2	2.0	0.0	0.0	2	2	0
fam23293	2	2	2	2.0	0.0	0.0	2	2	0
fam23294	2	2	2	2.0	0.0	0.0	2	2	0
fam23295	2	2	2	2.0	0.0	0.0	2	2	0
fam23296	2	2	2	2.0	0.0	0.0	2	2	0
fam23297	2	2	2	2.0	0.0	0.0	2	2	0
fam23298	2	2	2	2.0	0.0	0.0	2	2	0
fam23299	2	2	2	2.0	0.0	0.0	2	2	0
fam23300	2	2	2	2.0	0.0	0.0	2	2	0
fam23301	2	2	2	2.0	0.0	0.0	2	2	0
fam23302	2	2	2	2.0	0.0	0.0	2	2	0
fam23303	2	2	2	2.0	0.0	0.0	2	2	0
fam23304	2	2	2	2.0	0.0	0.0	2	2	0
fam23305	2	2	2	2.0	0.0	0.0	2	2	0
fam23306	2	2	2	2.0	0.0	0.0	2	2	0
fam23307	2	2	2	2.0	0.0	0.0	2	2	0
fam23308	2	2	2	2.0	0.0	0.0	2	2	0
fam23309	2	2	2	2.0	0.0	0.0	2	2	0
fam23310	2	2	2	2.0	0.0	0.0	2	2	0
fam23311	2	2	2	2.0	0.0	0.0	2	2	0
fam23312	2	2	2	2.0	0.0	0.0	2	2	0
fam23313	2	2	2	2.0	0.0	0.0	2	2	0
fam23314	2	2	2	2.0	0.0	0.0	2	2	0
fam23315	2	2	2	2.0	0.0	0.0	2	2	0
fam23316	2	2	2	2.0	0.0	0.0	2	2	0
fam23317	2	2	2	2.0	0.0	0.0	2	2	0
fam23318	2	2	2	2.0	0.0	0.0	2	2	0
fam23319	2	2	2	2.0	0.0	0.0	2	2	0
fam23320	2	2	2	2.0	0.0	0.0	2	2	0
fam23321	2	2	2	2.0	0.0	0.0	2	2	0
fam23322	2	2	2	2.0	0.0	0.0	2	2	0
fam23323	2	2	2	2.0	0.0	0.0	2	2	0
fam23324	2	2	2	2.0	0.0	0.0	2	2	0
fam23325	2	2	2	2.0	0.0	0.0	2	2	0
fam23326	2	2	2	2.0	0.0	0.0	2	2	0
fam23327	2	2	2	2.0	0.0	0.0	2	2	0
fam23328	2	2	2	2.0	0.0	0.0	2	2	0
fam23329	2	2	2	2.0	0.0	0.0	2	2	0
fam23330	2	2	2	2.0	0.0	0.0	2	2	0
fam23331	2	2	2	2.0	0.0	0.0	2	2	0
fam23332	2	2	2	2.0	0.0	0.0	2	2	0
fam23333	2	2	2	2.0	0.0	0.0	2	2	0
fam23334	2	2	2	2.0	0.0	0.0	2	2	0
fam23335	2	2	2	2.0	0.0	0.0	2	2	0
fam23336	2	2	2	2.0	0.0	0.0	2	2	0
fam23337	2	2	2	2.0	0.0	0.0	2	2	0
fam23338	2	2	2	2.0	0.0	0.0	2	2	0
fam23339	2	2	2	2.0	0.0	0.0	2	2	0
fam23340	2	2	2	2.0	0.0	0.0	2	2	0
fam23341	2	2	2	2.0	0.0	0.0	2	2	0
fam23342	2	2	2	2.0	0.0	0.0	2	2	0
fam23343	2	2	2	2.0	0.0	0.0	2	2	0
fam23344	2	2	2	2.0	0.0	0.0	2	2	0
fam23345	2	2	2	2.0	0.0	0.0	2	2	0
fam23346	2	2	2	2.0	0.0	0.0	2	2	0
fam23347	2	2	2	2.0	0.0	0.0	2	2	0
fam23348	2	2	2	2.0	0.0	0.0	2	2	0
fam23349	2	2	2	2.0	0.0	0.0	2	2	0
fam23350	2	2	2	2.0	0.0	0.0	2	2	0
fam23351	2	2	2	2.0	0.0	0.0	2	2	0
fam23352	2	2	2	2.0	0.0	0.0	2	2	0
fam23353	2	2	2	2.0	0.0	0.0	2	2	0
fam23354	2	2	2	2.0	0.0	0.0	2	2	0
fam23355	2	2	2	2.0	0.0	0.0	2	2	0
fam23356	2	2	2	2.0	0.0	0.0	2	2	0
fam23357	2	2	2	2.0	0.0	0.0	2	2	0
fam23358	2	2	2	2.0	0.0	0.0	2	2	0
fam23359	2	2	2	2.0	0.0	0.0	2	2	0
fam23360	2	2	2	2.0	0.0	0.0	2	2	0
fam23361	2	2	2	2.0	0.0	0.0	2	2	0
fam23362	2	2	2	2.0	0.0	0.0	2	2	0
fam23363	2	2	2	2.0	0.0	0.0	2	2	0
fam23364	2	2	2	2.0	0.0	0.0	2	2	0
fam23365	2	2	2	2.0	0.0	0.0	2	2	0
fam23366	2	2	2	2.0	0.0	0.0	2	2	0
fam23367	2	2	2	2.0	0.0	0.0	2	2	0
fam23368	2	2	2	2.0	0.0	0.0	2	2	0
fam23369	2	2	2	2.0	0.0	0.0	2	2	0
fam23370	2	2	2	2.0	0.0	0.0	2	2	0
fam23371	2	2	2	2.0	0.0	0.0	2	2	0
fam23372	2	2	2	2.0	0.0	0.0	2	2	0
fam23373	2	2	2	2.0	0.0	0.0	2	2	0
fam23374	2	2	2	2.0	0.0	0.0	2	2	0
fam23375	2	2	2	2.0	0.0	0.0	2	2	0
fam23376	2	2	2	2.0	0.0	0.0	2	2	0
fam23377	2	2	2	2.0	0.0	0.0	2	2	0
fam23378	2	2	2	2.0	0.0	0.0	2	2	0
fam23379	2	2	2	2.0	0.0	0.0	2	2	0
fam23380	2	2	2	2.0	0.0	0.0	2	2	0
fam23381	2	2	2	2.0	0.0	0.0	2	2	0
fam23382	2	2	2	2.0	0.0	0.0	2	2	0
fam23383	2	2	2	2.0	0.0	0.0	2	2	0
fam23384	2	2	2	2.0	0.0	0.0	2	2	0
fam23385	2	2	2	2.0	0.0	0.0	2	2	0
fam23386	2	2	2	2.0	0.0	0.0	2	2	0
fam23387	2	2	2	2.0	0.0	0.0	2	2	0
fam23388	2	2	2	2.0	0.0	0.0	2	2	0
fam23389	2	2	2	2.0	0.0	0.0	2	2	0
fam23390	2	2	2	2.0	0.0	0.0	2	2	0
fam23391	2	2	2	2.0	0.0	0.0	2	2	0
fam23392	2	2	2	2.0	0.0	0.0	2	2	0
fam23393	2	2	2	2.0	0.0	0.0	2	2	0
fam23394	2	2	2	2.0	0.0	0.0	2	2	0
fam23395	2	2	2	2.0	0.0	0.0	2	2	0
fam23396	2	2	2	2.0	0.0	0.0	2	2	0
fam23397	2	2	2	2.0	0.0	0.0	2	2	0
fam23398	2	2	2	2.0	0.0	0.0	2	2	0
fam23399	2	2	2	2.0	0.0	0.0	2	2	0
fam23400	2	2	2	2.0	0.0	0.0	2	2	0
fam23401	2	2	2	2.0	0.0	0.0	2	2	0
fam23402	2	2	2	2.0	0.0	0.0	2	2	0
fam23403	2	2	2	2.0	0.0	0.0	2	2	0
fam23404	2	2	2	2.0	0.0	0.0	2	2	0
fam23405	2	2	2	2.0	0.0	0.0	2	2	0
fam23406	2	2	2	2.0	0.0	0.0	2	2	0
fam23407	2	2	2	2.0	0.0	0.0	2	2	0
fam23408	2	2	2	2.0	0.0	0.0	2	2	0
fam23409	2	2	2	2.0	0.0	0.0	2	2	0
fam23410	2	2	2	2.0	0.0	0.0	2	2	0
fam23411	2	2	2	2.0	0.0	0.0	2	2	0
fam23412	2	2	2	2.0	0.0	0.0	2	2	0
fam23413	2	2	2	2.0	0.0	0.0	2	2	0
fam23414	2	2	2	2.0	0.0	0.0	2	2	0
fam23415	2	2	2	2.0	0.0	0.0	2	2	0
fam23416	2	2	2	2.0	0.0	0.0	2	2	0
fam23417	2	2	2	2.0	0.0	0.0	2	2	0
fam23418	2	2	2	2.0	0.0	0.0	2	2	0
fam23419	2	2	2	2.0	0.0	0.0	2	2	0
fam23420	2	2	2	2.0	0.0	0.0	2	2	0
fam23421	2	2	2	2.0	0.0	0.0	2	2	0
fam23422	2	2	2	2.0	0.0	0.0	2	2	0
fam23423	2	2	2	2.0	0.0	0.0	2	2	0
fam23424	2	2	2	2.0	0.0	0.0	2	2	0
fam23425	2	2	2	2.0	0.0	0.0	2	2	0
fam23426	2	2	2	2.0	0.0	0.0	2	2	0
fam23427	2	2	2	2.0	0.0	0.0	2	2	0
fam23428	2	2	2	2.0	0.0	0.0	2	2	0
fam23429	2	2	2	2.0	0.0	0.0	2	2	0
fam23430	2	2	2	2.0	0.0	0.0	2	2	0
fam23431	2	2	2	2.0	0.0	0.0	2	2	0
fam23432	2	2	2	2.0	0.0	0.0	2	2	0
fam23433	2	2	2	2.0	0.0	0.0	2	2	0
fam23434	2	2	2	2.0	0.0	0.0	2	2	0
fam23435	2	2	2	2.0	0.0	0.0	2	2	0
fam23436	2	2	2	2.0	0.0	0.0	2	2	0
fam23437	2	2	2	2.0	0.0	0.0	2	2	0
fam23438	2	2	2	2.0	0.0	0.0	2	2	0
fam23439	2	2	2	2.0	0.0	0.0	2	2	0
fam23440	2	2	2	2.0	0.0	0.0	2	2	0
fam23441	2	2	2	2.0	0.0	0.0	2	2	0
fam23442	2	2	2	2.0	0.0	0.0	2	2	0
fam23443	2	2	2	2.0	0.0	0.0	2	2	0
fam23444	2	2	2	2.0	0.0	0.0	2	2	0
fam23445	2	2	2	2.0	0.0	0.0	2	2	0
fam23446	2	2	2	2.0	0.0	0.0	2	2	0
fam23447	2	2	2	2.0	0.0	0.0	2	2	0
fam23448	2	2	2	2.0	0.0	0.0	2	2	0
fam23449	2	2	2	2.0	0.0	0.0	2	2	0
fam23450	2	2	2	2.0	0.0	0.0	2	2	0
fam23451	2	2	2	2.0	0.0	0.0	2	2	0
fam23452	2	2	2	2.0	0.0	0.0	2	2	0
fam23453	2	2	2	2.0	0.0	0.0	2	2	0
fam23454	2	2	2	2.0	0.0	0.0	2	2	0
fam23455	2	2	2	2.0	0.0	0.0	2	2	0
fam23456	2	2	2	2.0	0.0	0.0	2	2	0
fam23457	2	2	2	2.0	0.0	0.0	2	2	0
fam23458	2	2	2	2.0	0.0	0.0	2	2	0
fam23459	2	2	2	2.0	0.0	0.0	2	2	0
fam23460	2	2	2	2.0	0.0	0.0	2	2	0
fam23461	2	2	2	2.0	0.0	0.0	2	2	0
fam23462	2	2	2	2.0	0.0	0.0	2	2	0
fam23463	2	2	2	2.0	0.0	0.0	2	2	0
fam23464	2	2	2	2.0	0.0	0.0	2	2	0
fam23465	2	2	2	2.0	0.0	0.0	2	2	0
fam23466	2	2	2	2.0	0.0	0.0	2	2	0
fam23467	2	2	2	2.0	0.0	0.0	2	2	0
fam23468	2	2	2	2.0	0.0	0.0	2	2	0
fam23469	2	2	2	2.0	0.0	0.0	2	2	0
fam23470	2	2	2	2.0	0.0	0.0	2	2	0
fam23471	2	2	2	2.0	0.0	0.0	2	2	0
fam23472	2	2	2	2.0	0.0	0.0	2	2	0
fam23473	2	2	2	2.0	0.0	0.0	2	2	0
fam23474	2	2	2	2.0	0.0	0.0	2	2	0
fam23475	2	2	2	2.0	0.0	0.0	2	2	0
fam23476	2	2	2	2.0	0.0	0.0	2	2	0
fam23477	2	2	2	2.0	0.0	0.0	2	2	0
fam23478	2	2	2	2.0	0.0	0.0	2	2	0
fam23479	2	2	2	2.0	0.0	0.0	2	2	0
fam23480	2	2	2	2.0	0.0	0.0	2	2	0
fam23481	2	2	2	2.0	0.0	0.0	2	2	0
fam23482	2	2	2	2.0	0.0	0.0	2	2	0
fam23483	2	2	2	2.0	0.0	0.0	2	2	0
fam23484	2	2	2	2.0	0.0	0.0	2	2	0
fam23485	2	2	2	2.0	0.0	0.0	2	2	0
fam23486	2	2	2	2.0	0.0	0.0	2	2	0
fam23487	2	2	2	2.0	0.0	0.0	2	2	0
fam23488	2	2	2	2.0	0.0	0.0	2	2	0
fam23489	2	2	2	2.0	0.0	0.0	2	2	0
fam23490	2	2	2	2.0	0.0	0.0	2	2	0
fam23491	2	2	2	2.0	0.0	0.0	2	2	0
fam23492	2	2	2	2.0	0.0	0.0	2	2	0
fam23493	2	2	2	2.0	0.0	0.0	2	2	0
fam23494	2	2	2	2.0	0.0	0.0	2	2	0
fam23495	2	2	2	2.0	0.0	0.0	2	2	0
fam23496	2	2	2	2.0	0.0	0.0	2	2	0
fam23497	2	2	2	2.0	0.0	0.0	2	2	0
fam23498	2	2	2	2.0	0.0	0.0	2	2	0
fam23499	2	2	2	2.0	0.0	0.0	2	2	0
fam23500	2	2	2	2.0	0.0	0.0	2	2	0
fam23501	2	2	2	2.0	0.0	0.0	2	2	0
fam23502	2	2	2	2.0	0.0	0.0	2	2	0
fam23503	2	2	2	2.0	0.0	0.0	2	2	0
fam23504	2	2	2	2.0	0.0	0.0	2	2	0
fam23505	2	2	2	2.0	0.0	0.0	2	2	0
fam23506	2	2	2	2.0	0.0	0.0	2	2	0
fam23507	2	2	2	2.0	0.0	0.0	2	2	0
fam23508	2	2	2	2.0	0.0	0.0	2	2	0
fam23509	2	2	2	2.0	0.0	0.0	2	2	0
fam23510	2	2	2	2.0	0.0	0.0	2	2	0
fam23511	2	2	2	2.0	0.0	0.0	2	2	0
fam23512	2	2	2	2.0	0.0	0.0	2	2	0
fam23513	2	2	2	2.0	0.0	0.0	2	2	0
fam23514	2	2	2	2.0	0.0	0.0	2	2	0
fam23515	2	2	2	2.0	0.0	0.0	2	2	0
fam23516	2	2	2	2.0	0.0	0.0	2	2	0
fam23517	2	2	2	2.0	0.0	0.0	2	2	0
fam23518	2	2	2	2.0	0.0	0.0	2	2	0
fam23519	2	2	2	2.0	0.0	0.0	2	2	0
fam23520	2	2	2	2.0	0.0	0.0	2	2	0
fam23521	2	2	2	2.0	0.0	0.0	2	2	0
fam23522	2	2	2	2.0	0.0	0.0	2	2	0
fam23523	2	2	2	2.0	0.0	0.0	2	2	0
fam23524	2	2	2	2.0	0.0	0.0	2	2	0
fam23525	2	2	2	2.0	0.0	0.0	2	2	0
fam23526	2	2	2	2.0	0.0	0.0	2	2	0
fam23527	2	2	2	2.0	0.0	0.0	2	2	0
fam23528	2	2	2	2.0	0.0	0.0	2	2	0
fam23529	2	2	2	2.0	0.0	0.0	2	2	0
fam23530	2	2	2	2.0	0.0	0.0	2	2	0
fam23531	2	2	2	2.0	0.0	0.0	2	2	0
fam23532	2	2	2	2.0	0.0	0.0	2	2	0
fam23533	2	2	2	2.0	0.0	0.0	2	2	0
fam23534	2	2	2	2.0	0.0	0.0	2	2	0
fam23535	2	2	2	2.0	0.0	0.0	2	2	0
fam23536	2	2	2	2.0	0.0	0.0	2	2	0
fam23537	2	2	2	2.0	0.0	0.0	2	2	0
fam23538	2	2	2	2.0	0.0	0.0	2	2	0
fam23539	2	2	2	2.0	0.0	0.0	2	2	0
fam23540	2	2	2	2.0	0.0	0.0	2	2	0
fam23541	2	2	2	2.0	0.0	0.0	2	2	0
fam23542	2	2	2	2.0	0.0	0.0	2	2	0
fam23543	2	2	2	2.0	0.0	0.0	2	2	0
fam23544	2	2	2	2.0	0.0	0.0	2	2	0
fam23545	2	2	2	2.0	0.0	0.0	2	2	0
fam23546	2	2	2	2.0	0.0	0.0	2	2	0
fam23547	2	2	2	2.0	0.0	0.0	2	2	0
fam23548	2	2	2	2.0	0.0	0.0	2	2	0
fam23549	2	2	2	2.0	0.0	0.0	2	2	0
fam23550	2	2	2	2.0	0.0	0.0	2	2	0
fam23551	2	2	2	2.0	0.0	0.0	2	2	0
fam23552	2	2	2	2.0	0.0	0.0	2	2	0
fam23553	2	2	2	2.0	0.0	0.0	2	2	0
fam23554	2	2	2	2.0	0.0	0.0	2	2	0
fam23555	2	2	2	2.0	0.0	0.0	2	2	0
fam23556	2	2	2	2.0	0.0	0.0	2	2	0
fam23557	2	2	2	2.0	0.0	0.0	2	2	0
fam23558	2	2	2	2.0	0.0	0.0	2	2	0
fam23559	2	2	2	2.0	0.0	0.0	2	2	0
fam23560	2	2	2	2.0	0.0	0.0	2	2	0
fam23561	2	2	2	2.0	0.0	0.0	2	2	0
fam23562	2	2	2	2.0	0.0	0.0	2	2	0
fam23563	2	2	2	2.0	0.0	0.0	2	2	0
fam23564	2	2	2	2.0	0.0	0.0	2	2	0
fam23565	2	2	2	2.0	0.0	0.0	2	2	0
fam23566	2	2	2	2.0	0.0	0.0	2	2	0
fam23567	2	2	2	2.0	0.0	0.0	2	2	0
fam23568	2	2	2	2.0	0.0	0.0	2	2	0
fam23569	2	2	2	2.0	0.0	0.0	2	2	0
fam23570	2	2	2	2.0	0.0	0.0	2	2	0
fam23571	2	2	2	2.0	0.0	0.0	2	2	0
fam23572	2	2	2	2.0	0.0	0.0	2	2	0
fam23573	2	2	2	2.0	0.0	0.0	2	2	0
fam23574	2	2	2	2.0	0.0	0.0	2	2	0
fam23575	2	2	2	2.0	0.0	0.0	2	2	0
fam23576	2	2	2	2.0	0.0	0.0	2	2	0
fam23577	2	2	2	2.0	0.0	0.0	2	2	0
fam23578	2	2	2	2.0	0.0	0.0	2	2	0
fam23579	2	2	2	2.0	0.0	0.0	2	2	0
fam23580	2	2	2	2.0	0.0	0.0	2	2	0
fam23581	2	2	2	2.0	0.0	0.0	2	2	0
fam23582	2	2	2	2.0	0.0	0.0	2	2	0
fam23583	2	2	2	2.0	0.0	0.0	2	2	0
fam23584	2	2	2	2.0	0.0	0.0	2	2	0
fam23585	2	2	2	2.0	0.0	0.0	2	2	0
fam23586	2	2	2	2.0	0.0	0.0	2	2	0
fam23587	2	2	2	2.0	0.0	0.0	2	2	0
fam23588	2	2	2	2.0	0.0	0.0	2	2	0
fam23589	2	2	2	2.0	0.0	0.0	2	2	0
fam23590	2	2	2	2.0	0.0	0.0	2	2	0
fam23591	2	2	2	2.0	0.0	0.0	2	2	0
fam23592	2	2	2	2.0	0.0	0.0	2	2	0
fam23593	2	2	2	2.0	0.0	0.0	2	2	0
fam23594	2	2	2	2.0	0.0	0.0	2	2	0
fam23595	2	2	2	2.0	0.0	0.0	2	2	0
fam23596	2	2	2	2.0	0.0	0.0	2	2	0
fam23597	2	2	2	2.0	0.0	0.0	2	2	0
fam23598	2	2	2	2.0	0.0	0.0	2	2	0
fam23599	2	2	2	2.0	0.0	0.0	2	2	0
fam23600	2	2	2	2.0	0.0	0.0	2	2	0
fam23601	2	2	2	2.0	0.0	0.0	2	2	0
fam23602	2	2	2	2.0	0.0	0.0	2	2	0
fam23603	2	2	2	2.0	0.0	0.0	2	2	0
fam23604	2	2	2	2.0	0.0	0.0	2	2	0
fam23605	2	2	2	2.0	0.0	0.0	2	2	0
fam23606	2	2	2	2.0	0.0	0.0	2	2	0
fam23607	2	2	2	2.0	0.0	0.0	2	2	0
fam23608	2	2	2	2.0	0.0	0.0	2	2	0
fam23609	2	2	2	2.0	0.0	0.0	2	2	0
fam23610	2	2	2	2.0	0.0	0.0	2	2	0
fam23611	2	2	2	2.0	0.0	0.0	2	2	0
fam23612	2	2	2	2.0	0.0	0.0	2	2	0
fam23613	2	2	2	2.0	0.0	0.0	2	2	0
fam23614	2	2	2	2.0	0.0	0.0	2	2	0
fam23615	2	2	2	2.0	0.0	0.0	2	2	0
fam23616	2	2	2	2.0	0.0	0.0	2	2	0
fam23617	2	2	2	2.0	0.0	0.0	2	2	0
fam23618	2	2	2	2.0	0.0	0.0	2	2	0
fam23619	2	2	2	2.0	0.0	0.0	2	2	0
fam23620	2	2	2	2.0	0.0	0.0	2	2	0
fam23621	2	2	2	2.0	0.0	0.0	2	2	0
fam23622	2	2	2	2.0	0.0	0.0	2	2	0
fam23623	2	2	2	2.0	0.0	0.0	2	2	0
fam23624	2	2	2	2.0	0.0	0.0	2	2	0
fam23625	2	2	2	2.0	0.0	0.0	2	2	0
fam23626	2	2	2	2.0	0.0	0.0	2	2	0
fam23627	2	2	2	2.0	0.0	0.0	2	2	0
fam23628	2	2	2	2.0	0.0	0.0	2	2	0
fam23629	2	2	2	2.0	0.0	0.0	2	2	0
fam23630	2	2	2	2.0	0.0	0.0	2	2	0
fam23631	2	2	2	2.0	0.0	0.0	2	2	0
fam23632	2	2	2	2.0	0.0	0.0	2	2	0
fam23633	2	2	2	2.0	0.0	0.0	2	2	0
fam23634	2	2	2	2.0	0.0	0.0	2	2	0
fam23635	2	2	2	2.0	0.0	0.0	2	2	0
fam23636	2	2	2	2.0	0.0	0.0	2	2	0
fam23637	2	2	2	2.0	0.0	0.0	2	2	0
fam23638	2	2	2	2.0	0.0	0.0	2	2	0
fam23639	2	2	2	2.0	0.0	0.0	2	2	0
fam23640	2	2	2	2.0	0.0	0.0	2	2	0
fam23641	2	2	2	2.0	0.0	0.0	2	2	0
fam23642	2	2	2	2.0	0.0	0.0	2	2	0
fam23643	2	2	2	2.0	0.0	0.0	2	2	0
fam23644	2	2	2	2.0	0.0	0.0	2	2	0
fam23645	2	2	2	2.0	0.0	0.0	2	2	0
fam23646	2	2	2	2.0	0.0	0.0	2	2	0
fam23647	2	2	2	2.0	0.0	0.0	2	2	0
fam23648	2	2	2	2.0	0.0	0.0	2	2	0
fam23649	2	2	2	2.0	0.0	0.0	2	2	0
fam23650	2	2	2	2.0	0.0	0.0	2	2	0
fam23651	2	2	2	2.0	0.0	0.0	2	2	0
fam23652	2	2	2	2.0	0.0	0.0	2	2	0
fam23653	2	2	2	2.0	0.0	0.0	2	2	0
fam23654	2	2	2	2.0	0.0	0.0	2	2	0
fam23655	2	2	2	2.0	0.0	0.0	2	2	0
fam23656	2	2	2	2.0	0.0	0.0	2	2	0
fam23657	2	2	2	2.0	0.0	0.0	2	2	0
fam23658	2	2	2	2.0	0.0	0.0	2	2	0
fam23659	2	2	2	2.0	0.0	0.0	2	2	0
fam23660	2	2	2	2.0	0.0	0.0	2	2	0
fam23661	2	2	2	2.0	0.0	0.0	2	2	0
fam23662	2	2	2	2.0	0.0	0.0	2	2	0
fam23663	2	2	2	2.0	0.0	0.0	2	2	0
fam23664	2	2	2	2.0	0.0	0.0	2	2	0
fam23665	2	2	2	2.0	0.0	0.0	2	2	0
fam23666	2	2	2	2.0	0.0	0.0	2	2	0
fam23667	2	2	2	2.0	0.0	0.0	2	2	0
fam23668	2	2	2	2.0	0.0	0.0	2	2	0
fam23669	2	2	2	2.0	0.0	0.0	2	2	0
fam23670	2	2	2	2.0	0.0	0.0	2	2	0
fam23671	2	2	2	2.0	0.0	0.0	2	2	0
fam23672	2	2	2	2.0	0.0	0.0	2	2	0
fam23673	2	2	2	2.0	0.0	0.0	2	2	0
fam23674	2	2	2	2.0	0.0	0.0	2	2	0
fam23675	2	2	2	2.0	0.0	0.0	2	2	0
fam23676	2	2	2	2.0	0.0	0.0	2	2	0
fam23677	2	2	2	2.0	0.0	0.0	2	2	0
fam23678	2	2	2	2.0	0.0	0.0	2	2	0
fam23679	2	2	2	2.0	0.0	0.0	2	2	0
fam23680	2	2	2	2.0	0.0	0.0	2	2	0
fam23681	2	2	2	2.0	0.0	0.0	2	2	0
fam23682	2	2	2	2.0	0.0	0.0	2	2	0
fam23683	2	2	2	2.0	0.0	0.0	2	2	0
fam23684	2	2	2	2.0	0.0	0.0	2	2	0
fam23685	2	2	2	2.0	0.0	0.0	2	2	0
fam23686	2	2	2	2.0	0.0	0.0	2	2	0
fam23687	2	2	2	2.0	0.0	0.0	2	2	0
fam23688	2	2	2	2.0	0.0	0.0	2	2	0
fam23689	2	2	2	2.0	0.0	0.0	2	2	0
fam23690	2	2	2	2.0	0.0	0.0	2	2	0
fam23691	2	2	2	2.0	0.0	0.0	2	2	0
fam23692	2	2	2	2.0	0.0	0.0	2	2	0
fam23693	2	2	2	2.0	0.0	0.0	2	2	0
fam23694	2	2	2	2.0	0.0	0.0	2	2	0
fam23695	2	2	2	2.0	0.0	0.0	2	2	0
fam23696	2	2	2	2.0	0.0	0.0	2	2	0
fam23697	2	2	2	2.0	0.0	0.0	2	2	0
fam23698	2	2	2	2.0	0.0	0.0	2	2	0
fam23699	2	2	2	2.0	0.0	0.0	2	2	0
fam23700	2	2	2	2.0	0.0	0.0	2	2	0
fam23701	2	2	2	2.0	0.0	0.0	2	2	0
fam23702	2	2	2	2.0	0.0	0.0	2	2	0
fam23703	2	2	2	2.0	0.0	0.0	2	2	0
fam23704	2	2	2	2.0	0.0	0.0	2	2	0
fam23705	2	2	2	2.0	0.0	0.0	2	2	0
fam23706	2	2	2	2.0	0.0	0.0	2	2	0
fam23707	2	2	2	2.0	0.0	0.0	2	2	0
fam23708	2	2	2	2.0	0.0	0.0	2	2	0
fam23709	2	2	2	2.0	0.0	0.0	2	2	0
fam23710	2	2	2	2.0	0.0	0.0	2	2	0
fam23711	2	2	2	2.0	0.0	0.0	2	2	0
fam23712	2	2	2	2.0	0.0	0.0	2	2	0
fam23713	2	2	2	2.0	0.0	0.0	2	2	0
fam23714	2	2	2	2.0	0.0	0.0	2	2	0
fam23715	2	2	2	2.0	0.0	0.0	2	2	0
fam23716	2	2	2	2.0	0.0	0.0	2	2	0
fam23717	2	2	2	2.0	0.0	0.0	2	2	0
fam23718	2	2	2	2.0	0.0	0.0	2	2	0
fam23719	2	2	2	2.0	0.0	0.0	2	2	0
fam23720	2	2	2	2.0	0.0	0.0	2	2	0
fam23721	2	2	2	2.0	0.0	0.0	2	2	0
fam23722	2	2	2	2.0	0.0	0.0	2	2	0
fam23723	2	2	2	2.0	0.0	0.0	2	2	0
fam23724	2	2	2	2.0	0.0	0.0	2	2	0
fam23725	2	2	2	2.0	0.0	0.0	2	2	0
fam23726	2	2	2	2.0	0.0	0.0	2	2	0
fam23727	2	2	2	2.0	0.0	0.0	2	2	0
fam23728	2	2	2	2.0	0.0	0.0	2	2	0
fam23729	2	2	2	2.0	0.0	0.0	2	2	0
fam23730	2	2	2	2.0	0.0	0.0	2	2	0
fam23731	2	2	2	2.0	0.0	0.0	2	2	0
fam23732	2	2	2	2.0	0.0	0.0	2	2	0
fam23733	2	2	2	2.0	0.0	0.0	2	2	0
fam23734	2	2	2	2.0	0.0	0.0	2	2	0
fam23735	2	2	2	2.0	0.0	0.0	2	2	0
fam23736	2	2	2	2.0	0.0	0.0	2	2	0
fam23737	2	2	2	2.0	0.0	0.0	2	2	0
fam23738	2	2	2	2.0	0.0	0.0	2	2	0
fam23739	2	2	2	2.0	0.0	0.0	2	2	0
fam23740	2	2	2	2.0	0.0	0.0	2	2	0
fam23741	2	2	2	2.0	0.0	0.0	2	2	0
fam23742	2	2	2	2.0	0.0	0.0	2	2	0
fam23743	2	2	2	2.0	0.0	0.0	2	2	0
fam23744	2	2	2	2.0	0.0	0.0	2	2	0
fam23745	2	2	2	2.0	0.0	0.0	2	2	0
fam23746	2	2	2	2.0	0.0	0.0	2	2	0
fam23747	2	2	2	2.0	0.0	0.0	2	2	0
fam23748	2	2	2	2.0	0.0	0.0	2	2	0
fam23749	2	2	2	2.0	0.0	0.0	2	2	0
fam23750	2	2	2	2.0	0.0	0.0	2	2	0
fam23751	2	2	2	2.0	0.0	0.0	2	2	0
fam23752	2	2	2	2.0	0.0	0.0	2	2	0
fam23753	2	2	2	2.0	0.0	0.0	2	2	0
fam23754	2	2	2	2.0	0.0	0.0	2	2	0
fam23755	2	2	2	2.0	0.0	0.0	2	2	0
fam23756	2	2	2	2.0	0.0	0.0	2	2	0
fam23757	2	2	2	2.0	0.0	0.0	2	2	0
fam23758	2	2	2	2.0	0.0	0.0	2	2	0
fam23759	2	2	2	2.0	0.0	0.0	2	2	0
fam23760	2	2	2	2.0	0.0	0.0	2	2	0
fam23761	2	2	2	2.0	0.0	0.0	2	2	0
fam23762	2	2	2	2.0	0.0	0.0	2	2	0
fam23763	2	2	2	2.0	0.0	0.0	2	2	0
fam23764	2	2	2	2.0	0.0	0.0	2	2	0
fam23765	2	2	2	2.0	0.0	0.0	2	2	0
fam23766	2	2	2	2.0	0.0	0.0	2	2	0
fam23767	2	2	2	2.0	0.0	0.0	2	2	0
fam23768	2	2	2	2.0	0.0	0.0	2	2	0
fam23769	2	2	2	2.0	0.0	0.0	2	2	0
fam23770	2	2	2	2.0	0.0	0.0	2	2	0
fam23771	2	2	2	2.0	0.0	0.0	2	2	0
fam23772	2	2	2	2.0	0.0	0.0	2	2	0
fam23773	2	2	2	2.0	0.0	0.0	2	2	0
fam23774	2	2	2	2.0	0.0	0.0	2	2	0
fam23775	2	2	2	2.0	0.0	0.0	2	2	0
fam23776	2	2	2	2.0	0.0	0.0	2	2	0
fam23777	2	2	2	2.0	0.0	0.0	2	2	0
fam23778	2	2	2	2.0	0.0	0.0	2	2	0
fam23779	2	2	2	2.0	0.0	0.0	2	2	0
fam23780	2	2	2	2.0	0.0	0.0	2	2	0
fam23781	2	2	2	2.0	0.0	0.0	2	2	0
fam23782	2	2	2	2.0	0.0	0.0	2	2	0
fam23783	2	2	2	2.0	0.0	0.0	2	2	0
fam23784	2	2	2	2.0	0.0	0.0	2	2	0
fam23785	2	2	2	2.0	0.0	0.0	2	2	0
fam23786	2	2	2	2.0	0.0	0.0	2	2	0
fam23787	2	2	2	2.0	0.0	0.0	2	2	0
fam23788	2	2	2	2.0	0.0	0.0	2	2	0
fam23789	2	2	2	2.0	0.0	0.0	2	2	0
fam23790	2	2	2	2.0	0.0	0.0	2	2	0
fam23791	2	2	2	2.0	0.0	0.0	2	2	0
fam23792	2	2	2	2.0	0.0	0.0	2	2	0
fam23793	2	2	2	2.0	0.0	0.0	2	2	0
fam23794	2	2	2	2.0	0.0	0.0	2	2	0
fam23795	2	2	2	2.0	0.0	0.0	2	2	0
fam23796	2	2	2	2.0	0.0	0.0	2	2	0
fam23797	2	2	2	2.0	0.0	0.0	2	2	0
fam23798	2	2	2	2.0	0.0	0.0	2	2	0
fam23799	2	2	2	2.0	0.0	0.0	2	2	0
fam23800	2	2	2	2.0	0.0	0.0	2	2	0
fam23801	2	2	2	2.0	0.0	0.0	2	2	0
fam23802	2	2	2	2.0	0.0	0.0	2	2	0
fam23803	2	2	2	2.0	0.0	0.0	2	2	0
fam23804	2	2	2	2.0	0.0	0.0	2	2	0
fam23805	2	2	2	2.0	0.0	0.0	2	2	0
fam23806	2	2	2	2.0	0.0	0.0	2	2	0
fam23807	2	2	2	2.0	0.0	0.0	2	2	0
fam23808	2	2	2	2.0	0.0	0.0	2	2	0
fam23809	2	2	2	2.0	0.0	0.0	2	2	0
fam23810	2	2	2	2.0	0.0	0.0	2	2	0
fam23811	2	2	2	2.0	0.0	0.0	2	2	0
fam23812	2	2	2	2.0	0.0	0.0	2	2	0
fam23813	2	2	2	2.0	0.0	0.0	2	2	0
fam23814	2	2	2	2.0	0.0	0.0	2	2	0
fam23815	2	2	2	2.0	0.0	0.0	2	2	0
fam23816	2	2	2	2.0	0.0	0.0	2	2	0
fam23817	2	2	2	2.0	0.0	0.0	2	2	0
fam23818	2	2	2	2.0	0.0	0.0	2	2	0
fam23819	2	2	2	2.0	0.0	0.0	2	2	0
fam23820	2	2	2	2.0	0.0	0.0	2	2	0
fam23821	2	2	2	2.0	0.0	0.0	2	2	0
fam23822	2	2	2	2.0	0.0	0.0	2	2	0
fam23823	2	2	2	2.0	0.0	0.0	2	2	0
fam23824	2	2	2	2.0	0.0	0.0	2	2	0
fam23825	2	2	2	2.0	0.0	0.0	2	2	0
fam23826	2	2	2	2.0	0.0	0.0	2	2	0
fam23827	2	2	2	2.0	0.0	0.0	2	2	0
fam23828	2	2	2	2.0	0.0	0.0	2	2	0
fam23829	2	2	2	2.0	0.0	0.0	2	2	0
fam23830	2	2	2	2.0	0.0	0.0	2	2	0
fam23831	2	2	2	2.0	0.0	0.0	2	2	0
fam23832	2	2	2	2.0	0.0	0.0	2	2	0
fam23833	2	2	2	2.0	0.0	0.0	2	2	0
fam23834	2	2	2	2.0	0.0	0.0	2	2	0
fam23835	2	2	2	2.0	0.0	0.0	2	2	0
fam23836	2	2	2	2.0	0.0	0.0	2	2	0
fam23837	2	2	2	2.0	0.0	0.0	2	2	0
fam23838	2	2	2	2.0	0.0	0.0	2	2	0
fam23839	2	2	2	2.0	0.0	0.0	2	2	0
fam23840	2	2	2	2.0	0.0	0.0	2	2	0
fam23841	2	2	2	2.0	0.0	0.0	2	2	0
fam23842	2	2	2	2.0	0.0	0.0	2	2	0
fam23843	2	2	2	2.0	0.0	0.0	2	2	0
fam23844	2	2	2	2.0	0.0	0.0	2	2	0
fam23845	2	2	2	2.0	0.0	0.0	2	2	0
fam23846	2	2	2	2.0	0.0	0.0	2	2	0
fam23847	2	2	2	2.0	0.0	0.0	2	2	0
fam23848	2	2	2	2.0	0.0	0.0	2	2	0
fam23849	2	2	2	2.0	0.0	0.0	2	2	0
fam23850	2	2	2	2.0	0.0	0.0	2	2	0
fam23851	2	2	2	2.0	0.0	0.0	2	2	0
fam23852	2	2	2	2.0	0.0	0.0	2	2	0
fam23853	2	2	2	2.0	0.0	0.0	2	2	0
fam23854	2	2	2	2.0	0.0	0.0	2	2	0
fam23855	2	2	2	2.0	0.0	0.0	2	2	0
fam23856	2	2	2	2.0	0.0	0.0	2	2	0
fam23857	2	2	2	2.0	0.0	0.0	2	2	0
fam23858	2	2	2	2.0	0.0	0.0	2	2	0
fam23859	2	2	2	2.0	0.0	0.0	2	2	0
fam23860	2	2	2	2.0	0.0	0.0	2	2	0
fam23861	2	2	2	2.0	0.0	0.0	2	2	0
fam23862	2	2	2	2.0	0.0	0.0	2	2	0
fam23863	2	2	2	2.0	0.0	0.0	2	2	0
fam23864	2	2	2	2.0	0.0	0.0	2	2	0
fam23865	2	2	2	2.0	0.0	0.0	2	2	0
fam23866	2	2	2	2.0	0.0	0.0	2	2	0
fam23867	2	2	2	2.0	0.0	0.0	2	2	0
fam23868	2	2	2	2.0	0.0	0.0	2	2	0
fam23869	2	2	2	2.0	0.0	0.0	2	2	0
fam23870	2	2	2	2.0	0.0	0.0	2	2	0
fam23871	2	2	2	2.0	0.0	0.0	2	2	0
fam23872	2	2	2	2.0	0.0	0.0	2	2	0
fam23873	2	2	2	2.0	0.0	0.0	2	2	0
fam23874	2	2	2	2.0	0.0	0.0	2	2	0
fam23875	2	2	2	2.0	0.0	0.0	2	2	0
fam23876	2	2	2	2.0	0.0	0.0	2	2	0
fam23877	2	2	2	2.0	0.0	0.0	2	2	0
fam23878	2	2	2	2.0	0.0	0.0	2	2	0
fam23879	2	2	2	2.0	0.0	0.0	2	2	0
fam23880	2	2	2	2.0	0.0	0.0	2	2	0
fam23881	2	2	2	2.0	0.0	0.0	2	2	0
fam23882	2	2	2	2.0	0.0	0.0	2	2	0
fam23883	2	2	2	2.0	0.0	0.0	2	2	0
fam23884	2	2	2	2.0	0.0	0.0	2	2	0
fam23885	2	2	2	2.0	0.0	0.0	2	2	0
fam23886	2	2	2	2.0	0.0	0.0	2	2	0
fam23887	2	2	2	2.0	0.0	0.0	2	2	0
fam23888	2	2	2	2.0	0.0	0.0	2	2	0
fam23889	2	2	2	2.0	0.0	0.0	2	2	0
fam23890	2	2	2	2.0	0.0	0.0	2	2	0
fam23891	2	2	2	2.0	0.0	0.0	2	2	0
fam23892	2	2	2	2.0	0.0	0.0	2	2	0
fam23893	2	2	2	2.0	0.0	0.0	2	2	0
fam23894	2	2	2	2.0	0.0	0.0	2	2	0
fam23895	2	2	2	2.0	0.0	0.0	2	2	0
fam23896	2	2	2	2.0	0.0	0.0	2	2	0
fam23897	2	2	2	2.0	0.0	0.0	2	2	0
fam23898	2	2	2	2.0	0.0	0.0	2	2	0
fam23899	2	2	2	2.0	0.0	0.0	2	2	0
fam23900	2	2	2	2.0	0.0	0.0	2	2	0
fam23901	2	2	2	2.0	0.0	0.0	2	2	0
fam23902	2	2	2	2.0	0.0	0.0	2	2	0
fam23903	2	2	2	2.0	0.0	0.0	2	2	0
fam23904	2	2	2	2.0	0.0	0.0	2	2	0
fam23905	2	2	2	2.0	0.0	0.0	2	2	0
fam23906	2	2	2	2.0	0.0	0.0	2	2	0
fam23907	2	2	2	2.0	0.0	0.0	2	2	0
fam23908	2	2	2	2.0	0.0	0.0	2	2	0
fam23909	2	2	2	2.0	0.0	0.0	2	2	0
fam23910	2	2	2	2.0	0.0	0.0	2	2	0
fam23911	2	2	2	2.0	0.0	0.0	2	2	0
fam23912	2	2	2	2.0	0.0	0.0	2	2	0
fam23913	2	2	2	2.0	0.0	0.0	2	2	0
fam23914	2	2	2	2.0	0.0	0.0	2	2	0
fam23915	2	2	2	2.0	0.0	0.0	2	2	0
fam23916	2	2	2	2.0	0.0	0.0	2	2	0
fam23917	2	2	2	2.0	0.0	0.0	2	2	0
fam23918	2	2	2	2.0	0.0	0.0	2	2	0
fam23919	2	2	2	2.0	0.0	0.0	2	2	0
fam23920	2	2	2	2.0	0.0	0.0	2	2	0
fam23921	2	2	2	2.0	0.0	0.0	2	2	0
fam23922	2	2	2	2.0	0.0	0.0	2	2	0
fam23923	2	2	2	2.0	0.0	0.0	2	2	0
fam23924	2	2	2	2.0	0.0	0.0	2	2	0
fam23925	2	2	2	2.0	0.0	0.0	2	2	0
fam23926	2	2	2	2.0	0.0	0.0	2	2	0
fam23927	2	2	2	2.0	0.0	0.0	2	2	0
fam23928	2	2	2	2.0	0.0	0.0	2	2	0
fam23929	2	2	2	2.0	0.0	0.0	2	2	0
fam23930	2	2	2	2.0	0.0	0.0	2	2	0
fam23931	2	2	2	2.0	0.0	0.0	2	2	0
fam23932	2	2	2	2.0	0.0	0.0	2	2	0
fam23933	2	2	2	2.0	0.0	0.0	2	2	0
fam23934	2	2	2	2.0	0.0	0.0	2	2	0
fam23935	2	2	2	2.0	0.0	0.0	2	2	0
fam23936	2	2	2	2.0	0.0	0.0	2	2	0
fam23937	2	2	2	2.0	0.0	0.0	2	2	0
fam23938	2	2	2	2.0	0.0	0.0	2	2	0
fam23939	2	2	2	2.0	0.0	0.0	2	2	0
fam23940	2	2	2	2.0	0.0	0.0	2	2	0
fam23941	2	2	2	2.0	0.0	0.0	2	2	0
fam23942	2	2	2	2.0	0.0	0.0	2	2	0
fam23943	2	2	2	2.0	0.0	0.0	2	2	0
fam23944	2	2	2	2.0	0.0	0.0	2	2	0
fam23945	2	2	2	2.0	0.0	0.0	2	2	0
fam23946	2	2	2	2.0	0.0	0.0	2	2	0
fam23947	2	2	2	2.0	0.0	0.0	2	2	0
fam23948	2	2	2	2.0	0.0	0.0	2	2	0
fam23949	2	2	2	2.0	0.0	0.0	2	2	0
fam23950	2	2	2	2.0	0.0	0.0	2	2	0
fam23951	2	2	2	2.0	0.0	0.0	2	2	0
fam23952	2	2	2	2.0	0.0	0.0	2	2	0
fam23953	2	2	2	2.0	0.0	0.0	2	2	0
fam23954	2	2	2	2.0	0.0	0.0	2	2	0
fam23955	2	2	2	2.0	0.0	0.0	2	2	0
fam23956	2	2	2	2.0	0.0	0.0	2	2	0
fam23957	2	2	2	2.0	0.0	0.0	2	2	0
fam23958	2	2	2	2.0	0.0	0.0	2	2	0
fam23959	2	2	2	2.0	0.0	0.0	2	2	0
fam23960	2	2	2	2.0	0.0	0.0	2	2	0
fam23961	2	2	2	2.0	0.0	0.0	2	2	0
fam23962	2	2	2	2.0	0.0	0.0	2	2	0
fam23963	2	2	2	2.0	0.0	0.0	2	2	0
fam23964	2	2	2	2.0	0.0	0.0	2	2	0
fam23965	2	2	2	2.0	0.0	0.0	2	2	0
fam23966	2	2	2	2.0	0.0	0.0	2	2	0
fam23967	2	2	2	2.0	0.0	0.0	2	2	0
fam23968	2	2	2	2.0	0.0	0.0	2	2	0
fam23969	2	2	2	2.0	0.0	0.0	2	2	0
fam23970	2	2	2	2.0	0.0	0.0	2	2	0
fam23971	2	2	2	2.0	0.0	0.0	2	2	0
fam23972	2	2	2	2.0	0.0	0.0	2	2	0
fam23973	2	2	2	2.0	0.0	0.0	2	2	0
fam23974	2	2	2	2.0	0.0	0.0	2	2	0
fam23975	2	2	2	2.0	0.0	0.0	2	2	0
fam23976	2	2	2	2.0	0.0	0.0	2	2	0
fam23977	2	2	2	2.0	0.0	0.0	2	2	0
fam23978	2	2	2	2.0	0.0	0.0	2	2	0
fam23979	2	2	2	2.0	0.0	0.0	2	2	0
fam23980	2	2	2	2.0	0.0	0.0	2	2	0
fam23981	2	2	2	2.0	0.0	0.0	2	2	0
fam23982	2	2	2	2.0	0.0	0.0	2	2	0
fam23983	2	2	2	2.0	0.0	0.0	2	2	0
fam23984	2	2	2	2.0	0.0	0.0	2	2	0
fam23985	2	2	2	2.0	0.0	0.0	2	2	0
fam23986	2	2	2	2.0	0.0	0.0	2	2	0
fam23987	2	2	2	2.0	0.0	0.0	2	2	0
fam23988	2	2	2	2.0	0.0	0.0	2	2	0
fam23989	2	2	2	2.0	0.0	0.0	2	2	0
fam23990	2	2	2	2.0	0.0	0.0	2	2	0
fam23991	2	2	2	2.0	0.0	0.0	2	2	0
fam23992	2	2	2	2.0	0.0	0.0	2	2	0
fam23993	2	2	2	2.0	0.0	0.0	2	2	0
fam23994	2	2	2	2.0	0.0	0.0	2	2	0
fam23995	2	2	2	2.0	0.0	0.0	2	2	0
fam23996	2	2	2	2.0	0.0	0.0	2	2	0
fam23997	2	2	2	2.0	0.0	0.0	2	2	0
fam23998	2	2	2	2.0	0.0	0.0	2	2	0
fam23999	2	2	2	2.0	0.0	0.0	2	2	0
fam24000	2	2	2	2.0	0.0	0.0	2	2	0
fam24001	2	2	2	2.0	0.0	0.0	2	2	0
fam24002	2	2	2	2.0	0.0	0.0	2	2	0
fam24003	2	2	2	2.0	0.0	0.0	2	2	0
fam24004	2	2	2	2.0	0.0	0.0	2	2	0
fam24005	2	2	2	2.0	0.0	0.0	2	2	0
fam24006	2	2	2	2.0	0.0	0.0	2	2	0
fam24007	2	2	2	2.0	0.0	0.0	2	2	0
fam24008	2	2	2	2.0	0.0	0.0	2	2	0
fam24009	2	2	2	2.0	0.0	0.0	2	2	0
fam24010	2	2	2	2.0	0.0	0.0	2	2	0
fam24011	2	2	2	2.0	0.0	0.0	2	2	0
fam24012	2	2	2	2.0	0.0	0.0	2	2	0
fam24013	2	2	2	2.0	0.0	0.0	2	2	0
fam24014	2	2	2	2.0	0.0	0.0	2	2	0
fam24015	2	2	2	2.0	0.0	0.0	2	2	0
fam24016	2	2	2	2.0	0.0	0.0	2	2	0
fam24017	2	2	2	2.0	0.0	0.0	2	2	0
fam24018	2	2	2	2.0	0.0	0.0	2	2	0
fam24019	2	2	2	2.0	0.0	0.0	2	2	0
fam24020	2	2	2	2.0	0.0	0.0	2	2	0
fam24021	2	2	2	2.0	0.0	0.0	2	2	0
fam24022	2	2	2	2.0	0.0	0.0	2	2	0
fam24023	2	2	2	2.0	0.0	0.0	2	2	0
fam24024	2	2	2	2.0	0.0	0.0	2	2	0
fam24025	2	2	2	2.0	0.0	0.0	2	2	0
fam24026	2	2	2	2.0	0.0	0.0	2	2	0
fam24027	2	2	2	2.0	0.0	0.0	2	2	0
fam24028	2	2	2	2.0	0.0	0.0	2	2	0
fam24029	2	2	2	2.0	0.0	0.0	2	2	0
fam24030	2	2	2	2.0	0.0	0.0	2	2	0
fam24031	2	2	2	2.0	0.0	0.0	2	2	0
fam24032	2	2	2	2.0	0.0	0.0	2	2	0
fam24033	2	2	2	2.0	0.0	0.0	2	2	0
fam24034	2	2	2	2.0	0.0	0.0	2	2	0
fam24035	2	2	2	2.0	0.0	0.0	2	2	0
fam24036	2	2	2	2.0	0.0	0.0	2	2	0
fam24037	2	2	2	2.0	0.0	0.0	2	2	0
fam24038	2	2	2	2.0	0.0	0.0	2	2	0
fam24039	2	2	2	2.0	0.0	0.0	2	2	0
fam24040	2	2	2	2.0	0.0	0.0	2	2	0
fam24041	2	2	2	2.0	0.0	0.0	2	2	0
fam24042	2	2	2	2.0	0.0	0.0	2	2	0
fam24043	2	2	2	2.0	0.0	0.0	2	2	0
fam24044	2	2	2	2.0	0.0	0.0	2	2	0
fam24045	2	2	2	2.0	0.0	0.0	2	2	0
fam24046	2	2	2	2.0	0.0	0.0	2	2	0
fam24047	2	2	2	2.0	0.0	0.0	2	2	0
fam24048	2	2	2	2.0	0.0	0.0	2	2	0
fam24049	2	2	2	2.0	0.0	0.0	2	2	0
fam24050	2	2	2	2.0	0.0	0.0	2	2	0
fam24051	2	2	2	2.0	0.0	0.0	2	2	0
fam24052	2	2	2	2.0	0.0	0.0	2	2	0
fam24053	2	2	2	2.0	0.0	0.0	2	2	0
fam24054	2	2	2	2.0	0.0	0.0	2	2	0
fam24055	2	2	2	2.0	0.0	0.0	2	2	0
fam24056	2	2	2	2.0	0.0	0.0	2	2	0
fam24057	2	2	2	2.0	0.0	0.0	2	2	0
fam24058	2	2	2	2.0	0.0	0.0	2	2	0
fam24059	2	2	2	2.0	0.0	0.0	2	2	0
fam24060	2	2	2	2.0	0.0	0.0	2	2	0
fam24061	2	2	2	2.0	0.0	0.0	2	2	0
fam24062	2	2	2	2.0	0.0	0.0	2	2	0
fam24063	2	2	2	2.0	0.0	0.0	2	2	0
fam24064	2	2	2	2.0	0.0	0.0	2	2	0
fam24065	2	2	2	2.0	0.0	0.0	2	2	0
fam24066	2	2	2	2.0	0.0	0.0	2	2	0
fam24067	2	2	2	2.0	0.0	0.0	2	2	0
fam24068	2	2	2	2.0	0.0	0.0	2	2	0
fam24069	2	2	2	2.0	0.0	0.0	2	2	0
fam24070	2	2	2	2.0	0.0	0.0	2	2	0
fam24071	2	2	2	2.0	0.0	0.0	2	2	0
fam24072	2	2	2	2.0	0.0	0.0	2	2	0
fam24073	2	2	2	2.0	0.0	0.0	2	2	0
fam24074	2	2	2	2.0	0.0	0.0	2	2	0
fam24075	2	2	2	2.0	0.0	0.0	2	2	0
fam24076	2	2	2	2.0	0.0	0.0	2	2	0
fam24077	2	2	2	2.0	0.0	0.0	2	2	0
fam24078	2	2	2	2.0	0.0	0.0	2	2	0
fam24079	2	2	2	2.0	0.0	0.0	2	2	0
fam24080	2	2	2	2.0	0.0	0.0	2	2	0
fam24081	2	2	2	2.0	0.0	0.0	2	2	0
fam24082	2	2	2	2.0	0.0	0.0	2	2	0
fam24083	2	2	2	2.0	0.0	0.0	2	2	0
fam24084	2	2	2	2.0	0.0	0.0	2	2	0
fam24085	2	2	2	2.0	0.0	0.0	2	2	0
fam24086	2	2	2	2.0	0.0	0.0	2	2	0
fam24087	2	2	2	2.0	0.0	0.0	2	2	0
fam24088	2	2	2	2.0	0.0	0.0	2	2	0
fam24089	2	2	2	2.0	0.0	0.0	2	2	0
fam24090	2	2	2	2.0	0.0	0.0	2	2	0
fam24091	2	2	2	2.0	0.0	0.0	2	2	0
fam24092	2	2	2	2.0	0.0	0.0	2	2	0
fam24093	2	2	2	2.0	0.0	0.0	2	2	0
fam24094	2	2	2	2.0	0.0	0.0	2	2	0
fam24095	2	2	2	2.0	0.0	0.0	2	2	0
fam24096	2	2	2	2.0	0.0	0.0	2	2	0
fam24097	2	2	2	2.0	0.0	0.0	2	2	0
fam24098	2	2	2	2.0	0.0	0.0	2	2	0
fam24099	2	2	2	2.0	0.0	0.0	2	2	0
fam24100	2	2	2	2.0	0.0	0.0	2	2	0
fam24101	2	2	2	2.0	0.0	0.0	2	2	0
fam24102	2	2	2	2.0	0.0	0.0	2	2	0
fam24103	2	2	2	2.0	0.0	0.0	2	2	0
fam24104	2	2	2	2.0	0.0	0.0	2	2	0
fam24105	2	2	2	2.0	0.0	0.0	2	2	0
fam24106	2	2	2	2.0	0.0	0.0	2	2	0
fam24107	2	2	2	2.0	0.0	0.0	2	2	0
fam24108	2	2	2	2.0	0.0	0.0	2	2	0
fam24109	2	2	2	2.0	0.0	0.0	2	2	0
fam24110	2	2	2	2.0	0.0	0.0	2	2	0
fam24111	2	2	2	2.0	0.0	0.0	2	2	0
fam24112	2	2	2	2.0	0.0	0.0	2	2	0
fam24113	2	2	2	2.0	0.0	0.0	2	2	0
fam24114	2	2	2	2.0	0.0	0.0	2	2	0
fam24115	2	2	2	2.0	0.0	0.0	2	2	0
fam24116	2	2	2	2.0	0.0	0.0	2	2	0
fam24117	2	2	2	2.0	0.0	0.0	2	2	0
fam24118	2	2	2	2.0	0.0	0.0	2	2	0
fam24119	2	2	2	2.0	0.0	0.0	2	2	0
fam24120	2	2	2	2.0	0.0	0.0	2	2	0
fam24121	2	2	2	2.0	0.0	0.0	2	2	0
fam24122	2	2	2	2.0	0.0	0.0	2	2	0
fam24123	2	2	2	2.0	0.0	0.0	2	2	0
fam24124	2	2	2	2.0	0.0	0.0	2	2	0
fam24125	2	2	2	2.0	0.0	0.0	2	2	0
fam24126	2	2	2	2.0	0.0	0.0	2	2	0
fam24127	2	2	2	2.0	0.0	0.0	2	2	0
fam24128	2	2	2	2.0	0.0	0.0	2	2	0
fam24129	2	2	2	2.0	0.0	0.0	2	2	0
fam24130	2	2	2	2.0	0.0	0.0	2	2	0
fam24131	2	2	2	2.0	0.0	0.0	2	2	0
fam24132	2	2	2	2.0	0.0	0.0	2	2	0
fam24133	2	2	2	2.0	0.0	0.0	2	2	0
fam24134	2	2	2	2.0	0.0	0.0	2	2	0
fam24135	2	2	2	2.0	0.0	0.0	2	2	0
fam24136	2	2	2	2.0	0.0	0.0	2	2	0
fam24137	2	2	2	2.0	0.0	0.0	2	2	0
fam24138	2	2	2	2.0	0.0	0.0	2	2	0
fam24139	2	2	2	2.0	0.0	0.0	2	2	0
fam24140	2	2	2	2.0	0.0	0.0	2	2	0
fam24141	2	2	2	2.0	0.0	0.0	2	2	0
fam24142	2	2	2	2.0	0.0	0.0	2	2	0
fam24143	2	2	2	2.0	0.0	0.0	2	2	0
fam24144	2	2	2	2.0	0.0	0.0	2	2	0
fam24145	2	2	2	2.0	0.0	0.0	2	2	0
fam24146	2	2	2	2.0	0.0	0.0	2	2	0
fam24147	2	2	2	2.0	0.0	0.0	2	2	0
fam24148	2	2	2	2.0	0.0	0.0	2	2	0
fam24149	2	2	2	2.0	0.0	0.0	2	2	0
fam24150	2	2	2	2.0	0.0	0.0	2	2	0
fam24151	2	2	2	2.0	0.0	0.0	2	2	0
fam24152	2	2	2	2.0	0.0	0.0	2	2	0
fam24153	2	2	2	2.0	0.0	0.0	2	2	0
fam24154	2	2	2	2.0	0.0	0.0	2	2	0
fam24155	2	2	2	2.0	0.0	0.0	2	2	0
fam24156	2	2	2	2.0	0.0	0.0	2	2	0
fam24157	2	2	2	2.0	0.0	0.0	2	2	0
fam24158	2	2	2	2.0	0.0	0.0	2	2	0
fam24159	2	2	2	2.0	0.0	0.0	2	2	0
fam24160	2	2	2	2.0	0.0	0.0	2	2	0
fam24161	2	2	2	2.0	0.0	0.0	2	2	0
fam24162	2	2	2	2.0	0.0	0.0	2	2	0
fam24163	2	2	2	2.0	0.0	0.0	2	2	0
fam24164	2	2	2	2.0	0.0	0.0	2	2	0
fam24165	2	2	2	2.0	0.0	0.0	2	2	0
fam24166	2	2	2	2.0	0.0	0.0	2	2	0
fam24167	2	2	2	2.0	0.0	0.0	2	2	0
fam24168	2	2	2	2.0	0.0	0.0	2	2	0
fam24169	2	2	2	2.0	0.0	0.0	2	2	0
fam24170	2	2	2	2.0	0.0	0.0	2	2	0
fam24171	2	2	2	2.0	0.0	0.0	2	2	0
fam24172	2	2	2	2.0	0.0	0.0	2	2	0
fam24173	2	2	2	2.0	0.0	0.0	2	2	0
fam24174	2	2	2	2.0	0.0	0.0	2	2	0
fam24175	2	2	2	2.0	0.0	0.0	2	2	0
fam24176	2	2	2	2.0	0.0	0.0	2	2	0
fam24177	2	2	2	2.0	0.0	0.0	2	2	0
fam24178	2	2	2	2.0	0.0	0.0	2	2	0
fam24179	2	2	2	2.0	0.0	0.0	2	2	0
fam24180	2	2	2	2.0	0.0	0.0	2	2	0
fam24181	2	2	2	2.0	0.0	0.0	2	2	0
fam24182	2	2	2	2.0	0.0	0.0	2	2	0
fam24183	2	2	2	2.0	0.0	0.0	2	2	0
fam24184	2	2	2	2.0	0.0	0.0	2	2	0
fam24185	2	2	2	2.0	0.0	0.0	2	2	0
fam24186	2	2	2	2.0	0.0	0.0	2	2	0
fam24187	2	2	2	2.0	0.0	0.0	2	2	0
fam24188	2	2	2	2.0	0.0	0.0	2	2	0
fam24189	2	2	2	2.0	0.0	0.0	2	2	0
fam24190	2	2	2	2.0	0.0	0.0	2	2	0
fam24191	2	2	2	2.0	0.0	0.0	2	2	0
fam24192	2	2	2	2.0	0.0	0.0	2	2	0
fam24193	2	2	2	2.0	0.0	0.0	2	2	0
fam24194	2	2	2	2.0	0.0	0.0	2	2	0
fam24195	2	2	2	2.0	0.0	0.0	2	2	0
fam24196	2	2	2	2.0	0.0	0.0	2	2	0
fam24197	2	2	2	2.0	0.0	0.0	2	2	0
fam24198	2	2	2	2.0	0.0	0.0	2	2	0
fam24199	2	2	2	2.0	0.0	0.0	2	2	0
fam24200	2	2	2	2.0	0.0	0.0	2	2	0
fam24201	2	2	2	2.0	0.0	0.0	2	2	0
fam24202	2	2	2	2.0	0.0	0.0	2	2	0
fam24203	2	2	2	2.0	0.0	0.0	2	2	0
fam24204	2	2	2	2.0	0.0	0.0	2	2	0
fam24205	2	2	2	2.0	0.0	0.0	2	2	0
fam24206	2	2	2	2.0	0.0	0.0	2	2	0
fam24207	2	2	2	2.0	0.0	0.0	2	2	0
fam24208	2	2	2	2.0	0.0	0.0	2	2	0
fam24209	2	2	2	2.0	0.0	0.0	2	2	0
fam24210	2	2	2	2.0	0.0	0.0	2	2	0
fam24211	2	2	2	2.0	0.0	0.0	2	2	0
fam24212	2	2	2	2.0	0.0	0.0	2	2	0
fam24213	2	2	2	2.0	0.0	0.0	2	2	0
fam24214	2	2	2	2.0	0.0	0.0	2	2	0
fam24215	2	2	2	2.0	0.0	0.0	2	2	0
fam24216	2	2	2	2.0	0.0	0.0	2	2	0
fam24217	2	2	2	2.0	0.0	0.0	2	2	0
fam24218	2	2	2	2.0	0.0	0.0	2	2	0
fam24219	2	2	2	2.0	0.0	0.0	2	2	0
fam24220	2	2	2	2.0	0.0	0.0	2	2	0
fam24221	2	2	2	2.0	0.0	0.0	2	2	0
fam24222	2	2	2	2.0	0.0	0.0	2	2	0
fam24223	2	2	2	2.0	0.0	0.0	2	2	0
fam24224	2	2	2	2.0	0.0	0.0	2	2	0
fam24225	2	2	2	2.0	0.0	0.0	2	2	0
fam24226	2	2	2	2.0	0.0	0.0	2	2	0
fam24227	2	2	2	2.0	0.0	0.0	2	2	0
fam24228	2	2	2	2.0	0.0	0.0	2	2	0
fam24229	2	2	2	2.0	0.0	0.0	2	2	0
fam24230	2	2	2	2.0	0.0	0.0	2	2	0
fam24231	2	2	2	2.0	0.0	0.0	2	2	0
fam24232	2	2	2	2.0	0.0	0.0	2	2	0
fam24233	2	2	2	2.0	0.0	0.0	2	2	0
fam24234	2	2	2	2.0	0.0	0.0	2	2	0
fam24235	2	2	2	2.0	0.0	0.0	2	2	0
fam24236	2	2	2	2.0	0.0	0.0	2	2	0
fam24237	2	2	2	2.0	0.0	0.0	2	2	0
fam24238	2	2	2	2.0	0.0	0.0	2	2	0
fam24239	2	2	2	2.0	0.0	0.0	2	2	0
fam24240	2	2	2	2.0	0.0	0.0	2	2	0
fam24241	2	2	2	2.0	0.0	0.0	2	2	0
fam24242	2	2	2	2.0	0.0	0.0	2	2	0
fam24243	2	2	2	2.0	0.0	0.0	2	2	0
fam24244	2	2	2	2.0	0.0	0.0	2	2	0
fam24245	2	2	2	2.0	0.0	0.0	2	2	0
fam24246	2	2	2	2.0	0.0	0.0	2	2	0
fam24247	2	2	2	2.0	0.0	0.0	2	2	0
fam24248	2	2	2	2.0	0.0	0.0	2	2	0
fam24249	2	2	2	2.0	0.0	0.0	2	2	0
fam24250	2	2	2	2.0	0.0	0.0	2	2	0
fam24251	2	2	2	2.0	0.0	0.0	2	2	0
